,project,prefixes,prefixes_names,main_releases,rapid_releases,trad_releases,patches,releases,time
0,allegro/bigcache,1,v,7,0,4,15,22,0 days 00:00:00.025564
1,robinvdvleuten/vuex-persistedstate,1,v,21,9,7,14,35,0 days 00:00:00.033683
2,lambci/docker-lambda,13,dotnetcore build-python build-dotnetcore python build-provided.al build-nodejs provided.al build-java nodejs ruby v java build-ruby,19,2,3,30,49,0 days 00:00:00.040060
3,mindoc-org/mindoc,1,v,14,10,3,17,31,0 days 00:00:00.048180
4,expressjs/session,1,v,17,7,6,45,62,0 days 00:00:00.060004
5,webpy/webpy,3, webpy- v,15,2,10,2,17,0 days 00:00:00.062380
6,ratchetphp/Ratchet,1,v,4,0,3,23,27,0 days 00:00:00.058304
7,soldair/node-qrcode,3, v issue-,14,3,9,17,31,0 days 00:00:00.028532
8,1adrianb/face-alignment,1,v,5,1,2,5,10,0 days 00:00:00.019377
9,bytedance/IconPark,1,v,4,1,1,32,36,0 days 00:00:00.121302
10,jquense/react-big-calendar,1,v,37,18,12,77,114,0 days 00:00:00.167609
11,telegraf/telegraf,2, v,68,48,5,112,180,0 days 00:00:00.232880
12,VirusTotal/yara,1,v,17,1,12,16,33,0 days 00:00:00.243703
13,FaisalUmair/udemy-downloader-gui,1,v,9,4,2,12,21,0 days 00:00:00.025176
14,googleapis/google-api-python-client,1,v,60,50,6,52,112,0 days 00:00:00.119603
15,infinitered/nsfwjs,1,v,6,0,4,5,11,0 days 00:00:00.038789
16,stevenjoezhang/live2d-widget,1,v,8,5,2,9,17,0 days 00:00:00.014528
17,lokesh/lightbox2,2, v,7,0,6,9,16,0 days 00:00:00.025096
18,microsoft/VFSForGit,1,v,0,0,0,31,31,0 days 00:00:00.144626
19,kickstarter/android-oss,1,v,36,18,6,36,72,0 days 00:00:00.345916
20,midwayjs/midway,3,serverless- v serverless-v,47,32,2,337,384,0 days 00:00:00.439340
21,bblanchon/ArduinoJson,1,v,42,20,11,56,98,0 days 00:00:00.098701
22,Yelp/dumb-init,1,v,8,4,3,14,22,0 days 00:00:00.025088
23,google/gops,1,v,3,2,0,24,27,0 days 00:00:00.020858
24,weolar/miniblink49,1,,5,0,1,27,32,0 days 00:00:00.092771
25,Netflix/metaflow,3, rec_ nflx-,7,1,5,54,61,0 days 00:00:00.051703
26,kubernetes/autoscaler,5,addon-resizer- vertical-pod-autoscaler/v cluster-autoscaler-chart- cluster-autoscaler- vertical-pod-autoscaler-,49,15,21,134,183,0 days 00:00:00.547366
27,kalcaddle/KodExplorer,2, v,31,15,10,3,34,0 days 00:00:00.024517
28,operator-framework/operator-sdk,2,v scorecard-kuttl/v,42,32,0,47,89,0 days 00:00:00.204215
29,apache/zeppelin,1,v,5,0,4,10,15,0 days 00:00:00.348251
30,shaka-project/shaka-player,1,v,18,2,10,119,137,0 days 00:00:00.641240
31,botman/botman,2, v,17,9,6,44,61,0 days 00:00:00.062002
32,vuejs/apollo,2, v,5,1,2,8,13,0 days 00:00:00.041382
33,listen1/listen1_desktop,1,v,26,18,5,40,66,0 days 00:00:00.031094
34,ecrmnn/collect.js,1,,35,24,5,154,189,0 days 00:00:00.109340
35,projectdiscovery/subfinder,2, v,10,5,4,24,34,0 days 00:00:00.084278
36,yzhao062/pyod,3,v. v V,4,0,3,24,28,0 days 00:00:00.076892
37,lets-blade/blade,1,,1,0,0,1,2,0 days 00:00:00.021495
38,substack/tape,1,v,50,23,16,85,135,0 days 00:00:00.087313
39,HashLips/hashlips_art_engine,0,,0,0,0,0,0,0 days 00:00:00.009297
40,go-yaml/yaml,1,v,6,1,3,10,16,0 days 00:00:00.029286
41,capstone-engine/capstone,1,,5,2,2,9,14,0 days 00:00:00.188758
42,bchavez/Bogus,1,v,7,5,1,97,104,0 days 00:00:00.089654
43,encode/apistar,1,,6,2,3,88,94,0 days 00:00:00.088885
44,facebook/facebook-android-sdk,2,sdk-version- v,95,73,5,44,139,0 days 00:00:00.269385
45,eternnoir/pyTelegramBotAPI,1,,15,3,7,37,52,0 days 00:00:00.196013
46,springfox/springfox,6, CI-master- swagger-springmvc- v swagger-springmvc-parent- pre-,21,5,14,54,75,0 days 00:00:00.277915
47,imba/imba,4,v  typescript-imba-plugin@ vsimba@,6,0,4,51,57,0 days 00:00:00.227143
48,joeyespo/grip,1,v,15,3,10,9,24,0 days 00:00:00.035358
49,matthewmueller/x-ray,1,,5,2,2,13,18,0 days 00:00:00.021165
50,neutralinojs/neutralinojs,1,v,26,18,4,4,30,0 days 00:00:00.075281
51,graphql-editor/graphql-editor,2, v,19,15,1,127,146,0 days 00:00:00.069631
52,lightbend/config,1,v,9,1,4,19,28,0 days 00:00:00.055570
53,assaf/zombie,2, v,21,12,7,111,132,0 days 00:00:00.252457
54,docker/docker-py,1,,40,7,11,63,103,0 days 00:00:00.192924
55,ml5js/ml5-library,3, v V,9,3,3,45,54,0 days 00:00:00.148621
56,ory/kratos,0,,0,0,0,0,0,0 days 00:00:00.014318
57,maaslalani/slides,1,v,8,4,1,8,16,0 days 00:00:00.018737
58,lmcinnes/umap,2, v,4,0,3,20,24,0 days 00:00:00.110400
59,xamarin/Xamarin.Forms,4, release- rui- tag-test,9,0,3,9,18,0 days 00:00:00.202177
60,Xhofe/alist,1,v,9,5,2,33,42,0 days 00:00:00.043412
61,arkenfox/user.js,1,,52,30,0,0,52,0 days 00:00:00.111263
62,berty/berty,1,v,390,387,1,579,969,0 days 00:00:01.500292
63,lua/lua,1,v,15,0,13,15,30,0 days 00:00:00.244449
64,Dman95/SASM,1,v,15,4,9,11,26,0 days 00:00:00.024824
65,SixLabors/ImageSharp,1,v,3,1,1,6,9,0 days 00:00:01.103910
66,OpenNMT/OpenNMT-py,2, v,15,6,8,14,29,0 days 00:00:00.211211
67,thephpleague/omnipay,2, v,12,4,5,18,30,0 days 00:00:00.041320
68,Richasy/Bili.Uwp,1,v,1,0,0,23,24,0 days 00:00:00.026040
69,roots/bedrock,1,,21,3,12,82,103,0 days 00:00:00.062340
70,tijsverkoyen/CssToInlineStyles,1,,9,2,5,20,29,0 days 00:00:00.022955
71,datreeio/datree,1,,14,10,2,93,107,0 days 00:00:00.195728
72,golden-layout/golden-layout,2, v,7,1,3,25,32,0 days 00:00:00.048014
73,tipsy/javalin,3,javalin-parent-  javalin-,42,25,4,42,84,0 days 00:00:00.099951
74,MikeMcl/bignumber.js,2, v,20,3,11,27,47,0 days 00:00:00.024679
75,chainer/chainer,1,v,60,46,3,18,78,0 days 00:00:01.880422
76,datahub-project/datahub,2,v RC-v,6,1,3,42,48,0 days 00:00:00.300934
77,doctrine/collections,2, v,7,0,5,9,16,0 days 00:00:00.029315
78,vuejs/vetur,2, v,23,12,7,47,70,0 days 00:00:00.202065
79,kyleconroy/sqlc,2, v,15,6,3,1,16,0 days 00:00:00.051909
80,tilt-dev/tilt,1,v,30,18,5,172,202,0 days 00:00:00.312307
81,dthree/vorpal,1,v,4,2,0,57,61,0 days 00:00:00.026699
82,zaphoyd/websocketpp,1,,6,0,4,3,9,0 days 00:00:00.083124
83,Alluxio/alluxio,2,alluxio-parent- v,26,1,23,28,54,0 days 00:00:01.854155
84,lebab/lebab,1,v,14,8,2,28,42,0 days 00:00:00.057663
85,Lexikos/AutoHotkey_L,2,v L,56,48,2,146,202,0 days 00:00:00.167146
86,Respect/Validation,1,,11,1,8,108,119,0 days 00:00:00.315585
87,graphql-java/graphql-java,2, v,40,13,14,2,42,0 days 00:00:00.148777
88,nodeca/js-yaml,1,,23,2,18,51,74,0 days 00:00:00.088199
89,modulz/stitches,1,v,5,2,1,22,27,0 days 00:00:00.191488
90,aimeos/aimeos-laravel,1,,3,0,1,112,115,0 days 00:00:00.084315
91,documentationjs/documentation,1,v,36,23,7,49,85,0 days 00:00:00.079815
92,haifengl/smile,1,v,12,3,6,10,22,0 days 00:00:00.202344
93,filamentgroup/tablesaw,1,v,5,0,4,27,32,0 days 00:00:00.037896
94,mit-pdos/xv6-public,0,,0,0,0,0,0,0 days 00:00:00.008520
95,carbon-design-system/carbon,8, carbon-components@ @carbon/elements@ @carbon/themes@ @carbon/icons-angular@ carbon-components-react@ v @carbon/sketch@,204,200,0,513,717,0 days 00:00:01.210170
96,doctrine/common,2, v,18,1,16,31,49,0 days 00:00:00.272437
97,tensorflow/serving,2, r,25,6,10,27,52,0 days 00:00:00.316228
98,artilleryio/artillery,2, v,5,0,4,43,48,0 days 00:00:00.087508
99,google/ios-webkit-debug-proxy,2, v,9,2,5,9,18,0 days 00:00:00.018170
100,sockeqwe/mosby,1,,7,3,2,8,15,0 days 00:00:00.032451
101,MinecraftForge/MinecraftForge,2, v,59,30,13,10,69,0 days 00:00:00.560257
102,antonioru/beautiful-react-hooks,1,,5,2,1,6,11,0 days 00:00:00.029762
103,flarum/framework,1,v,4,0,3,6,10,0 days 00:00:00.755063
104,gzu-liyujiang/AndroidPicker,1,,11,3,5,45,56,0 days 00:00:00.046678
105,webiny/webiny-js,82,@webiny/api-forms@ webiny-api-cookie-policy@v @webiny/serverless-aws-cloudfront@ @webiny/app-form-builder-theme@ @webiny/serverless-function@ @webiny/http-handler-ssr@ @webiny/serverless-page-builder@ @webiny/api-plugin-commodo-mongodb@ @webiny/serverless-aws-api-gateway@ @webiny/serverless-apollo-service@ @webiny/api-i18n@ webiny-integration-mailchimp@v @webiny/app-google-tag-manager@ @webiny/http-handler-files@ webiny-app-cookie-policy@v @webiny/app-security@ v webiny-api-google-tag-manager@v @webiny/api-plugin-security-cognito@ @webiny/project-utils@ webiny-api-mailchimp@v @webiny/app-admin@ @webiny/app-plugin-security-cognito-theme@ @webiny/http-handler-index@ @webiny/api-cookie-policy@ @webiny/serverless-api-gateway@ @webiny/commodo-fields-storage-db-proxy@ @webiny/ui@ @webiny/api-plugin-form-builder-resolvers-mongodb@ @webiny/i18n@ @webiny/api-plugin-commodo-db-proxy@ webiny-app-typeform@v @webiny/serverless-apollo-gateway@ @webiny/mongo-http-client@ @webiny/app-typeform@ @webiny/cli@ @webiny/app-plugin-security-cognito@ @webiny/serverless-app@ @webiny/serverless-template@ @webiny/app-cookie-policy@ @webiny/tracking@ @webiny/storybook-utils@ webiny-integration-cookie-policy@v @webiny/api-files@ @webiny/api-plugin-create-apollo-handler@ @webiny/serverless-db-proxy@ webiny-integration-typeform@v @webiny/webpack-externals@ @webiny/commodo-graphql@ @webiny/app-form-builder@ @webiny/i18n-react@ @webiny/app-page-builder-theme@ @webiny/api-security@ @webiny/api-plugin-create-apollo-gateway@ @webiny/api-plugin-files-resolvers-mongodb@ @webiny/api@ @webiny/api-plugin-forms-resolvers-mongodb@ @webiny/validation@ @webiny/serverless-aws-lambda@ @webiny/app-forms@ webiny-app-google-tag-manager@v @webiny/form@ @webiny/react-router@ @webiny/commodo@ @webiny/serverless-files@ @webiny/http-handler@ webiny-integration-google-tag-manager@v @webiny/serverless-aws-cognito-user-pool@ @webiny/api-mailchimp@ @webiny/api-page-builder@ @webiny/serverless-form-builder@ @webiny/api-google-tag-manager@ @webiny/app-i18n@ @webiny/app@ @webiny/app-page-builder@ @webiny/plugins@ @webiny/api-form-builder@ webiny-app-mailchimp@v @webiny/serverless-deploy@ @webiny/app-mailchimp@ @webiny/api-plugin-page-builder-resolvers-mongodb@ @webiny/api-cms@,78,58,2,1147,1225,0 days 00:00:02.292041
106,pagekit/pagekit,1,,4,1,2,31,35,0 days 00:00:00.220528
107,NLog/NLog,5, NLog- V Build- v,24,5,14,67,91,0 days 00:00:00.418661
108,dotnetcore/CAP,1,v,22,5,11,30,52,0 days 00:00:00.100785
109,graphite-project/graphite-web,1,,2,0,1,22,24,0 days 00:00:00.345262
110,swoft-cloud/swoft,1,v,3,0,2,25,28,0 days 00:00:00.071532
111,mledoze/countries,1,v,14,0,9,10,24,0 days 00:00:00.040874
112,benbusby/whoogle-search,2, v,7,1,2,15,22,0 days 00:00:00.040355
113,dinerojs/dinero.js,2, v,13,8,3,17,30,0 days 00:00:00.030922
114,robolectric/robolectric,4,Robolectric robolectric-bazel- robolectric- Release,28,3,19,37,65,0 days 00:00:00.726028
115,LawnchairLauncher/lawnchair,26, android-r-preview- android-n-preview- cm- android-wear-n-preview- android-m-preview- android-n-iot-release-polk-at android-o-mr1-iot-release- android-r-beta- android-n-iot-release-lg-thinq-wk platform-tools- android-wear-o-preview- android-s-preview- android-n-iot-release-smart-display-r android-n-iot-release-ihome-igv android-n-iot-preview- android-l-preview_r android-o-iot-preview- Pixel-v android-q-preview- android-t-preview- android-p-preview- android-o-preview- android-s-beta- android-wear-p-preview- v,66,37,16,90,156,0 days 00:00:02.496664
116,microsoft/reverse-proxy,1,v,2,0,1,1,3,0 days 00:00:00.048047
117,nl8590687/ASRT_SpeechRecognition,1,v,10,4,4,4,14,0 days 00:00:00.020796
118,EasyDarwin/EasyDarwin,1,v,2,0,1,8,10,0 days 00:00:00.101873
119,apache/beam,4,dataflow_runner_v jupyterlab-sidepanel-v sdks/v v,53,20,7,26,79,0 days 00:00:02.133167
120,express-validator/express-validator,1,v,55,24,16,60,115,0 days 00:00:00.081477
121,johnkerl/miller,2, v,29,15,8,23,52,0 days 00:00:00.455529
122,pachyderm/pachyderm,6, debug_rtd_sidebar_ vv gf- debug_rtd_styles v,28,10,13,232,260,0 days 00:00:02.006720
123,octokit/octokit.js,1,v,8,6,0,9,17,0 days 00:00:00.015508
124,brndnmtthws/conky,2, v,7,0,6,21,28,0 days 00:00:00.187518
125,jackc/pgx,1,v,36,11,14,18,54,0 days 00:00:00.294054
126,lutris/lutris,2, v,3,1,1,63,66,0 days 00:00:00.446369
127,hashicorp/serf,1,v,9,3,3,22,31,0 days 00:00:00.093716
128,smacke/ffsubsync,2, v,2,0,0,27,29,0 days 00:00:00.024336
129,expressjs/cors,1,v,11,3,5,23,34,0 days 00:00:00.023153
130,bfenetworks/bfe,1,v,18,10,3,0,18,0 days 00:00:00.057626
131,mikaelbr/node-notifier,1,v,24,4,13,45,69,0 days 00:00:00.050487
132,missive/emoji-mart,1,v,20,8,7,40,60,0 days 00:00:00.048846
133,jrnl-org/jrnl,2, v,13,3,4,24,37,0 days 00:00:00.078317
134,angular-ui/ui-grid,1,v,24,10,11,86,110,0 days 00:00:00.239562
135,persepolisdm/persepolis,1,,5,0,4,6,11,0 days 00:00:00.066255
136,weaveworks/scope,2, v,31,17,5,30,61,0 days 00:00:00.446330
137,nanomsg/nanomsg,1,,3,0,2,5,8,0 days 00:00:00.082637
138,serilog/serilog,1,v,19,3,7,13,32,0 days 00:00:00.092706
139,iovisor/bpftrace,1,v,8,0,6,11,19,0 days 00:00:00.135633
140,jbaysolutions/vue-grid-layout,1,,5,1,1,29,34,0 days 00:00:00.028374
141,SpiderLabs/ModSecurity,1,v,7,0,6,46,53,0 days 00:00:00.305824
142,aws/aws-sdk-php,1,,234,217,7,1228,1462,0 days 00:00:03.823153
143,juicedata/juicefs,2, v,8,5,0,17,25,0 days 00:00:00.056990
144,valor-software/ngx-bootstrap,2, v,31,15,9,81,112,0 days 00:00:00.153229
145,evernote/android-job,1,v,4,1,2,36,40,0 days 00:00:00.045852
146,jaywcjlove/hotkeys,1,v,12,4,7,62,74,0 days 00:00:00.041516
147,trinodb/trino,1,,297,294,0,12,309,0 days 00:00:01.598846
148,jonls/redshift,2, v,17,6,7,2,19,0 days 00:00:00.038899
149,asaskevich/govalidator,2, v,11,0,8,3,14,0 days 00:00:00.035174
150,JesusFreke/smali,2,v smalidea-v,23,8,10,38,61,0 days 00:00:00.102502
151,tidwall/evio,1,v,2,0,1,8,10,0 days 00:00:00.014886
152,algolia/places,1,v,34,26,4,69,103,0 days 00:00:00.108103
153,NVIDIA/TensorRT,2, v,27,17,2,6,33,0 days 00:00:00.027729
154,PX4/PX4-Autopilot,6,FF-v v auterion-v NuttX- fixedwing_ alpha_,14,0,9,41,55,0 days 00:00:02.118140
155,nextapps-de/winbox,1,,2,1,0,17,19,0 days 00:00:00.018234
156,gcanti/io-ts,1,,20,10,3,84,104,0 days 00:00:00.055675
157,sqlalchemy/sqlalchemy,1,rel_,14,0,13,194,208,0 days 00:00:01.214914
158,dotnet/reactive,3,ixnet-v v rxnet-v,8,0,6,17,25,0 days 00:00:00.367838
159,alan-turing-institute/sktime,1,v,10,0,4,14,24,0 days 00:00:00.138677
160,adazzle/react-data-grid,2, v,1,0,0,180,181,0 days 00:00:00.145757
161,anishathalye/dotbot,1,v,20,6,11,28,48,0 days 00:00:00.026959
162,seek-oss/vanilla-extract,14,@vanilla-extract/rollup-plugin@ @vanilla-extract/babel-plugin@ @vanilla-extract/snowpack-plugin@ @vanilla-extract/private@ @vanilla-extract/sprinkles@ @vanilla-extract/webpack-plugin@ @vanilla-extract/esbuild-plugin@ @vanilla-extract/next-plugin@ @vanilla-extract/recipes@ @vanilla-extract/dynamic@ @vanilla-extract/css-utils@ @vanilla-extract/integration@ @vanilla-extract/vite-plugin@ @vanilla-extract/css@,18,4,1,182,200,0 days 00:00:00.086071
163,nathancahill/split,2, v,10,5,3,38,48,0 days 00:00:00.029600
164,log4js-node/log4js-node,1,v,32,19,9,90,122,0 days 00:00:00.179677
165,docker/docker-ce,1,v,2,0,1,24,26,0 days 00:00:02.755660
166,mwouts/jupytext,3, v. v,20,10,7,75,95,0 days 00:00:00.119574
167,jonschlinkert/remarkable,2, v,9,6,2,13,22,0 days 00:00:00.032739
168,samber/lo,1,v,22,21,0,3,25,0 days 00:00:00.022477
169,plopjs/plop,4, plop@ v node-plop@,42,13,21,50,92,0 days 00:00:00.070830
170,FreeTubeApp/FreeTube,1,,1,0,0,0,1,0 days 00:00:00.017985
171,ppoffice/hexo-theme-icarus,2, v,22,9,9,9,31,0 days 00:00:00.033551
172,oatpp/oatpp,1,,4,0,3,10,14,0 days 00:00:00.077321
173,dagger/dagger,1,v,2,0,0,12,14,0 days 00:00:00.319917
174,developit/unfetch,2, isomorphic-,7,1,4,8,15,0 days 00:00:00.026251
175,ly525/luban-h5,1,v,18,12,3,14,32,0 days 00:00:00.042393
176,lucidrains/DALLE2-pytorch,2, v,6,5,0,178,184,0 days 00:00:00.099992
177,fatih/color,1,v,16,4,10,1,17,0 days 00:00:00.022349
178,google/glog,1,v,6,0,3,8,14,0 days 00:00:00.047937
179,chyroc/WechatSogou,1,v,8,1,3,15,23,0 days 00:00:00.026461
180,reach/reach-ui,17,@reach/component-component@ @reach/tabs@ @reach/tooltip@ @reach/utils@ @reach/dialog@ @reach/portal@ @reach/combobox@ @reach/popover@ @reach/alert@ @reach/auto-id@ @reach/rect@ @reach/visually-hidden@ v @reach/window-size@ @reach/menu-button@ @reach/skip-nav@ @reach/alert-dialog@,16,5,5,137,153,0 days 00:00:00.141119
181,agentejo/cockpit,1,,8,1,5,27,35,0 days 00:00:00.159635
182,LSPosed/LSPosed,1,v,6,0,2,41,47,0 days 00:00:00.147795
183,goproxyio/goproxy,1,v,2,0,0,7,9,0 days 00:00:00.016237
184,kaorun343/vue-property-decorator,1,v,24,5,7,16,40,0 days 00:00:00.032824
185,NicolasHug/Surprise,1,v,2,0,1,9,11,0 days 00:00:00.034536
186,containers/buildah,3, v V,42,22,3,70,112,0 days 00:00:00.394558
187,arachnys/cabot,1,,6,4,1,33,39,0 days 00:00:00.046827
188,go-acme/lego,1,v,34,15,7,17,51,0 days 00:00:00.075523
189,mixn/carbon-now-cli,2, v,5,2,1,7,12,0 days 00:00:00.022732
190,redis/hiredis,1,v,7,0,5,11,18,0 days 00:00:00.226893
191,Snapchat/KeyDB,1,v,6,1,2,16,22,0 days 00:00:01.508540
192,go-flutter-desktop/go-flutter,1,v,39,33,3,15,54,0 days 00:00:00.044174
193,gorakhargosh/watchdog,1,v,12,2,6,35,47,0 days 00:00:00.082519
194,micronaut-projects/micronaut-core,1,v,16,0,6,80,96,0 days 00:00:00.676147
195,open-cli-tools/concurrently,2, v,27,7,14,18,45,0 days 00:00:00.041393
196,rappasoft/laravel-boilerplate,4, Laravel_ v update_readme_,65,39,19,242,307,0 days 00:00:00.284902
197,gogo/protobuf,1,v,9,0,8,4,13,0 days 00:00:00.062315
198,kubernetes-sigs/external-dns,2,external-dns-helm-chart- v,20,9,6,41,61,0 days 00:00:00.373253
199,django-oscar/django-oscar,1,,19,0,16,80,99,0 days 00:00:00.735700
200,bytedance/xgplayer,1,v,4,1,2,44,48,0 days 00:00:00.058266
201,ExactTarget/fuelux,1,,25,10,6,59,84,0 days 00:00:00.182730
202,tealeg/xlsx,4,go.go go go.r v,11,4,4,13,24,0 days 00:00:00.069514
203,oauth2-proxy/oauth2-proxy,1,v,18,1,10,9,27,0 days 00:00:00.108155
204,devicons/devicon,1,v,17,6,5,4,21,0 days 00:00:00.062916
205,rectorphp/rector,2, v,13,1,9,351,364,0 days 00:00:01.010031
206,barryvdh/laravel-dompdf,1,v,10,1,8,24,34,0 days 00:00:00.026884
207,jpillora/cloud-torrent,1,,3,1,0,34,37,0 days 00:00:00.019831
208,mapstruct/mapstruct,0,,0,0,0,0,0,0 days 00:00:00.019837
209,PyGithub/PyGithub,2, v,62,40,9,23,85,0 days 00:00:00.118643
210,django/channels,1,,20,9,8,44,64,0 days 00:00:00.077850
211,encode/uvicorn,1,,17,4,4,119,136,0 days 00:00:00.123897
212,ecomfe/zrender,2, v,20,0,13,65,85,0 days 00:00:00.133374
213,scribejava/scribejava,2, scribejava-,41,20,10,41,82,0 days 00:00:00.084189
214,i-tu/Hasklig,2, v,12,5,4,0,12,0 days 00:00:00.066092
215,unicorn-engine/unicorn,1,,2,0,1,3,5,0 days 00:00:00.107019
216,tjanczuk/edge,1,v,11,5,5,23,34,0 days 00:00:00.137766
217,domlysz/BlenderGIS,2, v,3,0,2,0,3,0 days 00:00:00.032256
218,zotero/zotero,1,,7,0,6,246,253,0 days 00:00:00.953862
219,alibaba/transmittable-thread-local,2, v,18,6,8,31,49,0 days 00:00:00.054346
220,arturbien/React95,1,v,13,7,3,6,19,0 days 00:00:00.040901
221,blender/blender,2,softbody-stable-v v,63,6,39,35,98,0 days 00:00:06.126709
222,FastLED/FastLED,4, archive/FastLED v archive/FastSPI_LED,8,1,6,20,28,0 days 00:00:00.205007
223,crossplane/crossplane,1,v,23,11,3,34,57,0 days 00:00:00.290986
224,leongersen/noUiSlider,1,,45,19,16,58,103,0 days 00:00:00.230322
225,frohoff/ysoserial,2, v,0,0,0,10,10,0 days 00:00:00.016452
226,tzapu/WiFiManager,2, v,16,10,4,0,16,0 days 00:00:00.031059
227,moby/buildkit,2,v dockerfile/,13,2,6,32,45,0 days 00:00:00.302332
228,sachinchoolur/lightgallery.js,1,,5,0,3,11,16,0 days 00:00:00.019787
229,phan/phan,1,,33,13,10,127,160,0 days 00:00:00.503706
230,achael/eht-imaging,1,v,3,0,2,7,10,0 days 00:00:00.210157
231,remarkjs/remark,5, remark-parse@ remark-stringify@ remark-cli@ remark@,56,40,9,95,151,0 days 00:00:00.146540
232,crowdsecurity/crowdsec,1,v,7,1,3,39,46,0 days 00:00:00.062304
233,mher/flower,1,v,9,1,6,15,24,0 days 00:00:00.076236
234,graphql-dotnet/graphql-dotnet,2, v,42,24,7,45,87,0 days 00:00:00.130815
235,substack/minimist,1,,6,2,2,20,26,0 days 00:00:00.019595
236,h6ah4i/android-advancedrecyclerview,1,,8,1,6,22,30,0 days 00:00:00.045694
237,wasabeef/Blurry,1,,6,1,4,7,13,0 days 00:00:00.016922
238,mailcow/mailcow-dockerized,0,,0,0,0,0,0,0 days 00:00:00.014635
239,dmlc/gluon-cv,1,v,10,0,8,0,10,0 days 00:00:00.060964
240,crazycodeboy/react-native-splash-screen,1,v,6,0,4,6,12,0 days 00:00:00.024076
241,release-it/release-it,1,,84,66,12,176,260,0 days 00:00:00.173406
242,serialport/node-serialport,18, @serialport/list@ @serialport/parser-regex@ @serialport/parser-slip-encoder@ serialport@ @serialport/binding-mock@ @serialport/parser-cctalk@ @serialport/parser-readline@ @serialport/parser-ready@ @serialport/parser-delimiter@ @serialport/repl@ v @serialport/terminal@ @serialport/parser-inter-byte-timeout@ @serialport/stream@ @serialport/bindings@ @serialport/parser-byte-length@ @serialport/binding-abstract@,24,7,7,180,204,0 days 00:00:00.199675
243,kubernetes-sigs/kubebuilder,5,v1beta v1alpha release- tools- v,15,5,6,22,37,0 days 00:00:00.153542
244,chrisbanes/tivi,2,v build-number-,7,3,3,42,49,0 days 00:00:00.273399
245,liamg/traitor,1,v,0,0,0,14,14,0 days 00:00:00.018688
246,nodegit/nodegit,1,v,27,9,10,67,94,0 days 00:00:00.206479
247,muaz-khan/RecordRTC,1,,5,0,4,38,43,0 days 00:00:00.169623
248,svaarala/duktape,2,convert-makedist-to-python- v,30,7,16,25,55,0 days 00:00:00.633800
249,naver/billboard.js,1,,21,1,13,54,75,0 days 00:00:00.183327
250,StackExchange/StackExchange.Redis,2, v,2,0,1,35,37,0 days 00:00:00.110044
251,kartik-v/bootstrap-fileinput,1,v,26,18,7,61,87,0 days 00:00:00.083718
252,librosa/librosa,2, v,9,0,8,13,22,0 days 00:00:00.302203
253,go-task/task,1,v,26,9,7,26,52,0 days 00:00:00.082706
254,junit-team/junit5,2,r prototype-,11,1,8,17,28,0 days 00:00:00.442256
255,vrana/adminer,1,v,17,4,11,35,52,0 days 00:00:00.176920
256,sachinchoolur/lightGallery,2, v,16,4,8,66,82,0 days 00:00:00.070928
257,onionshare/onionshare,2, v,18,5,11,9,27,0 days 00:00:00.252872
258,arkime/arkime,1,v,32,2,17,70,102,0 days 00:00:00.233815
259,bee-san/pyWhat,1,,13,12,0,6,19,0 days 00:00:00.043395
260,flowable/flowable-engine,1,flowable-,10,0,9,9,19,0 days 00:00:00.786189
261,nhn/tui.image-editor,2, v,21,7,12,17,38,0 days 00:00:00.055997
262,wix/react-native-interactable,2, v,1,0,0,11,12,0 days 00:00:00.028238
263,microsoft/Windows-driver-samples,1,,609,57,1,0,609,0 days 00:00:00.450292
264,snorkel-team/snorkel,1,v,4,1,2,11,15,0 days 00:00:00.133175
265,bestiejs/benchmark.js,1,,5,1,3,19,24,0 days 00:00:00.059221
266,hiroppy/fusuma,1,v,37,32,3,59,96,0 days 00:00:00.090388
267,arwes/arwes,0,,0,0,0,0,0,0 days 00:00:00.014267
268,wangyu-/udp2raw,1,,38,31,2,0,38,0 days 00:00:00.184400
269,standard-things/esm,1,,29,27,1,160,189,0 days 00:00:00.477720
270,share/sharedb,1,v,23,7,9,111,134,0 days 00:00:00.222607
271,davidhalter/jedi,1,v,13,0,10,14,27,0 days 00:00:00.465635
272,GoogleChrome/lighthouse-ci,1,v,9,1,5,24,33,0 days 00:00:00.057079
273,johannesjo/super-productivity,1,v,58,48,3,296,354,0 days 00:00:00.569492
274,windicss/windicss,1,v,13,8,1,81,94,0 days 00:00:00.072840
275,RicoSuter/NSwag,2,v NSwag-Build-,388,352,2,12,400,0 days 00:00:00.521254
276,reviewdog/reviewdog,2, v,6,1,4,21,27,0 days 00:00:00.147703
277,ai/size-limit,1,,45,29,7,101,146,0 days 00:00:00.106053
278,caronc/apprise,1,v,3,0,2,32,35,0 days 00:00:00.045722
279,lancedikson/bowser,2, v,26,11,8,33,59,0 days 00:00:00.066305
280,airbnb/knowledge-repo,1,v,4,0,2,27,31,0 days 00:00:00.061966
281,rmax/scrapy-redis,2, v,6,1,3,12,18,0 days 00:00:00.024322
282,tporadowski/redis,7, msopentech_ win- Win win_ v win,6,0,5,99,105,0 days 00:00:00.581907
283,maximegris/angular-electron,2, angular,47,30,5,52,99,0 days 00:00:00.057503
284,yarnpkg/berry,41,@yarnpkg/libui/ @yarnpkg/core/ @yarnpkg/plugin-exec/ @yarnpkg/builder/ @yarnpkg/plugin-version/ @yarnpkg/plugin-file/ vscode-zipfs/ @yarnpkg/plugin-typescript/ @yarnpkg/plugin-nm/ @yarnpkg/plugin-pack/ @yarnpkg/parsers/ @yarnpkg/plugin-init/ @yarnpkg/plugin-npm-cli/ @yarnpkg/shell/ @yarnpkg/fslib/ @yarnpkg/plugin-stage/ @yarnpkg/plugin-git/ @yarnpkg/plugin-node-modules/ @yarnpkg/plugin-constraints/ @yarnpkg/doctor/ @yarnpkg/plugin-http/ @yarnpkg/plugin-pnpm/ @yarnpkg/pnp/ @yarnpkg/plugin-npm/ @yarnpkg/json-proxy/ @yarnpkg/plugin-essentials/ @yarnpkg/plugin-link/ @yarnpkg/plugin-interactive-tools/ @yarnpkg/plugin-github/ @yarnpkg/plugin-dlx/ @yarnpkg/sdks/ @yarnpkg/pnpify/ @yarnpkg/plugin-pnp/ @yarnpkg/libzip/ @yarnpkg/cli/ @yarnpkg/esbuild-plugin-pnp/ @yarnpkg/eslint-config/ @yarnpkg/plugin-compat/ @yarnpkg/plugin-workspace-tools/ @yarnpkg/nm/ @yarnpkg/plugin-patch/,18,1,1,316,334,0 days 00:00:00.416983
285,vuejs/v2.vuejs.org,1,v,8,4,3,9,17,0 days 00:00:00.034920
286,openpgpjs/openpgpjs,1,v,40,18,13,109,149,0 days 00:00:00.172642
287,nhn/tui.chart,2, v,38,21,8,60,98,0 days 00:00:00.161027
288,timolins/react-hot-toast,1,v,7,3,2,5,12,0 days 00:00:00.025494
289,PrismLibrary/Prism,6,Prism.Windows Prism.v Prismv WPFv v Prism.Formsv,7,0,6,4,11,0 days 00:00:00.153946
290,lesspass/lesspass,6, site-v web-extension-v cli-v pure-v mobile-v,11,4,4,43,54,0 days 00:00:00.144334
291,reactchartjs/react-chartjs-2,3, v. v,24,9,9,51,75,0 days 00:00:00.140637
292,msiemens/tinydb,2, v,34,10,16,26,60,0 days 00:00:00.060319
293,laravel/socialite,1,v,18,2,9,62,80,0 days 00:00:00.169441
294,luraproject/lura,2, v,15,1,11,12,27,0 days 00:00:00.056613
295,reek/anti-adblock-killer,1,v,31,26,2,0,31,0 days 00:00:00.037538
296,healthchecks/healthchecks,2, v,28,10,1,8,36,0 days 00:00:00.139332
297,jarun/buku,2, v,36,18,6,3,39,0 days 00:00:00.235810
298,quartznet/quartznet,1,v,12,0,10,27,39,0 days 00:00:00.084243
299,expressjs/body-parser,1,,21,9,8,47,68,0 days 00:00:00.051355
300,jvm-profiling-tools/async-profiler,1,v,14,2,9,9,23,0 days 00:00:00.042292
301,btraceio/btrace,3, release- v,5,1,2,34,39,0 days 00:00:00.078519
302,duckdb/duckdb,1,v,3,0,2,22,25,0 days 00:00:01.152256
303,TommyLemon/Android-ZBLibrary,1,,21,13,4,4,25,0 days 00:00:00.036183
304,minbrowser/min,2, v,26,4,8,31,57,0 days 00:00:00.236411
305,go-pg/pg,4,extra/pgsegment/v extra/pgotel/v v extra/pgdebug/v,59,35,8,305,364,0 days 00:00:00.345418
306,journeyapps/zxing-android-embedded,1,v,15,3,10,7,22,0 days 00:00:00.073198
307,laravel-mix/laravel-mix,1,v,27,19,3,105,132,0 days 00:00:00.123561
308,pypa/pipx,1,,15,7,5,36,51,0 days 00:00:00.046734
309,espnet/espnet,1,v.,11,1,6,32,43,0 days 00:00:00.819059
310,timber/timber,2, v,32,10,14,96,128,0 days 00:00:00.293625
311,JoeDog/siege,1,v,2,0,1,9,11,0 days 00:00:00.035823
312,flask-admin/flask-admin,2, v,6,0,4,17,23,0 days 00:00:00.202173
313,microsoft/FASTER,2,FASTER_ v,5,1,2,53,58,0 days 00:00:00.070219
314,mautic/mautic,1,,30,6,13,59,89,0 days 00:00:01.634884
315,futurepress/epub.js,3, alpha- v,2,1,0,34,36,0 days 00:00:00.076375
316,spectreconsole/spectre.console,1,,44,38,1,3,47,0 days 00:00:00.055225
317,duo-labs/cloudmapper,1,,5,0,2,21,26,0 days 00:00:00.062918
318,ankidroid/Anki-Android,5, cardCustomize-alpha pull api-v v,24,1,18,64,88,0 days 00:00:00.905349
319,wiremock/wiremock,2, release-,55,28,16,28,83,0 days 00:00:00.135598
320,istanbuljs/nyc,1,v,58,43,4,56,114,0 days 00:00:00.082774
321,microsoft/MixedRealityToolkit-Unity,2, v,10,0,5,26,36,0 days 00:00:01.252531
322,Mailtrain-org/mailtrain,1,v,25,20,2,10,35,0 days 00:00:00.188371
323,SigmaHQ/sigma,1,,19,6,6,10,29,0 days 00:00:00.644929
324,ZipArchive/ZipArchive,2, v,17,4,9,80,97,0 days 00:00:00.066404
325,uber/prototool,1,v,18,13,3,2,20,0 days 00:00:00.033766
326,lukeed/polka,1,v,5,2,2,9,14,0 days 00:00:00.022369
327,zhaojun1998/zfile,1,,32,26,3,11,43,0 days 00:00:00.035457
328,kedacore/keda,1,v,14,3,4,3,17,0 days 00:00:00.093850
329,bitnami-labs/sealed-secrets,3,sealed-secrets- v helm-v,21,9,8,41,62,0 days 00:00:00.170282
330,json5/json5,1,v,10,1,7,8,18,0 days 00:00:00.032265
331,uNetworking/uWebSockets.js,1,v,59,51,3,6,65,0 days 00:00:00.072998
332,ServiceStack/ServiceStack,1,v,17,2,12,41,58,0 days 00:00:00.705724
333,material-shell/material-shell,2, v,11,7,2,0,11,0 days 00:00:00.044803
334,kubeedge/kubeedge,1,v,14,1,10,11,25,0 days 00:00:00.335722
335,ponylang/ponyc,2, release-,51,31,9,56,107,0 days 00:00:00.471001
336,Angel-ML/angel,2,v Release-,14,2,6,4,18,0 days 00:00:00.156319
337,cookieY/Yearning,2, v,0,0,0,3,3,0 days 00:00:00.016739
338,rauchg/slackin,1,,14,8,3,26,40,0 days 00:00:00.029669
339,google/benchmark,1,v,8,0,7,9,17,0 days 00:00:00.076259
340,PaddlePaddle/models,2,v develop-align-v,6,1,2,2,8,0 days 00:00:00.239283
341,panjf2000/gnet,1,v,8,2,5,35,43,0 days 00:00:00.145301
342,docker/machine,2, v,16,2,8,16,32,0 days 00:00:00.192961
343,reactjs/react-rails,2, v,24,9,9,31,55,0 days 00:00:00.080966
344,arrow-kt/arrow,7, arrow-libs-core- arrow-libs-optics- arrow-libs-ank- arrow-site- arrow-libs-fx- v,13,3,8,40,53,0 days 00:00:00.744905
345,canonical/microk8s,2,installer-v v,11,1,8,4,15,0 days 00:00:00.061781
346,pedroslopez/whatsapp-web.js,1,v,18,8,3,39,57,0 days 00:00:00.046082
347,telepresenceio/telepresence,4, rpc/v chart-v v,116,99,7,88,204,0 days 00:00:00.562965
348,universal-ctags/ctags,1,p,0,0,0,86,86,0 days 00:00:00.497325
349,hajimehoshi/ebiten,1,v,17,2,13,66,83,0 days 00:00:00.350877
350,roadrunner-server/roadrunner,2, v,22,7,7,81,103,0 days 00:00:00.190855
351,fengyuanchen/viewerjs,1,v,21,6,10,28,49,0 days 00:00:00.041361
352,greenplum-db/gpdb,4, REL Release_ PG95-,62,27,20,115,177,0 days 00:00:03.133320
353,meetecho/janus-gateway,1,v,11,1,7,53,64,0 days 00:00:00.354783
354,LonamiWebs/Telethon,1,v,44,26,4,91,135,0 days 00:00:00.218509
355,boto/boto,2, v,50,28,10,29,79,0 days 00:00:00.458651
356,vitalets/x-editable,1,,6,4,1,9,15,0 days 00:00:00.047373
357,vmware/clarity,6, release-v clr v v. web,27,7,13,316,343,0 days 00:00:00.437377
358,opencart/opencart,1,,11,4,5,24,35,0 days 00:00:00.818661
359,go-admin-team/go-admin,1,v,6,1,3,27,33,0 days 00:00:00.095032
360,pyeve/eve,1,v,11,0,7,33,44,0 days 00:00:00.161055
361,mobxjs/mobx-state-tree,2, v,38,28,7,64,102,0 days 00:00:00.141308
362,Workiva/go-datastructures,1,v,1,0,0,53,54,0 days 00:00:00.142809
363,google/closure-compiler,5,maven-release-v closure-compiler-parent-v webpack-v v closure-compiler-maven-v,141,112,2,24,165,0 days 00:00:01.131481
364,sghall/react-move,1,v,28,19,7,21,49,0 days 00:00:00.042511
365,ocrmypdf/OCRmyPDF,1,v,63,40,7,115,178,0 days 00:00:00.225381
366,glidejs/glide,1,v,8,1,5,25,33,0 days 00:00:00.044018
367,yugabyte/yugabyte-db,2, v,18,1,11,73,91,0 days 00:00:01.060747
368,li-xiaojun/XPopup,3, dialog- v,19,9,4,159,178,0 days 00:00:00.097694
369,360Controller/360Controller,1,v,1,0,0,11,12,0 days 00:00:00.036792
370,VictoriaMetrics/VictoriaMetrics,2,pmm-6401-v v,75,58,0,189,264,0 days 00:00:00.379241
371,invoiceninja/invoiceninja,1,v,41,21,5,387,428,0 days 00:00:01.456113
372,hotoo/pinyin,1,,13,1,10,28,41,0 days 00:00:00.039619
373,0x7c13/Notepads,1,v,14,9,2,42,56,0 days 00:00:00.072883
374,electerm/electerm,2, v,35,23,5,292,327,0 days 00:00:00.217992
375,php-pm/php-pm,1,,6,0,4,15,21,0 days 00:00:00.032999
376,electronicarts/EASTL,1,,14,1,8,31,45,0 days 00:00:00.042027
377,gocd/gocd,1,,69,48,4,2,71,0 days 00:00:00.968528
378,mltframework/shotcut,1,v,49,45,0,85,134,0 days 00:00:00.372744
379,optuna/optuna,1,v,36,27,2,4,40,0 days 00:00:00.798978
380,AGWA/git-crypt,1,,7,0,4,2,9,0 days 00:00:00.022179
381,wilsonpage/fastdom,2, v,8,5,2,23,31,0 days 00:00:00.027159
382,HospitalRun/hospitalrun-frontend,2, v,3,0,2,25,28,0 days 00:00:00.248815
383,alibaba/lowcode-engine,2,v @alilc/lowcode-code-generator@,1,0,0,12,13,0 days 00:00:00.025451
384,doctrine/annotations,2, v,14,1,9,20,34,0 days 00:00:00.336871
385,mRemoteNG/mRemoteNG,2, v,17,9,7,23,40,0 days 00:00:00.340534
386,baconjs/bacon.js,1,,9,3,3,200,209,0 days 00:00:00.378422
387,mbdavid/LiteDB,2,v. v,8,1,3,27,35,0 days 00:00:00.124048
388,sebastianbergmann/exporter,1,,7,2,4,12,19,0 days 00:00:00.043949
389,zo0r/react-native-push-notification,2, v,16,10,2,19,35,0 days 00:00:00.053754
390,darktable-org/darktable,4, post release- release,32,6,23,59,91,0 days 00:00:02.125117
391,zendesk/android-floating-action-button,1,,11,9,1,4,15,0 days 00:00:00.018742
392,kelektiv/node.bcrypt.js,2, v,11,1,9,39,50,0 days 00:00:00.045362
393,flask-restful/flask-restful,2, v,3,0,2,28,31,0 days 00:00:00.047847
394,houtianze/bypy,1,,5,1,2,69,74,0 days 00:00:00.044367
395,opensearch-project/OpenSearch,1,,5,0,2,6,11,0 days 00:00:03.374243
396,microsoft/playwright-python,1,v,24,20,0,28,52,0 days 00:00:00.049599
397,xournalpp/xournalpp,2, v,2,0,1,13,15,0 days 00:00:00.240543
398,vuelidate/vuelidate,3,test-project@ v @vuelidate/components@,7,1,2,43,50,0 days 00:00:00.056829
399,FreeRDP/FreeRDP,1,,9,2,4,8,17,0 days 00:00:00.820915
400,TechEmpower/FrameworkBenchmarks,3,round- R v,16,1,13,1,17,0 days 00:00:00.675924
401,appleboy/gorush,2, v,16,6,8,15,31,0 days 00:00:00.060843
402,rancher/os,1,v,15,4,6,43,58,0 days 00:00:00.155723
403,rs/zerolog,1,v,27,9,8,16,43,0 days 00:00:00.131936
404,linkedin/css-blocks,2, v,17,9,4,22,39,0 days 00:00:00.090858
405,ValdikSS/GoodbyeDPI,1,,2,0,1,19,21,0 days 00:00:00.020646
406,sindresorhus/caprine,2, v,70,49,3,43,113,0 days 00:00:00.076431
407,GrenderG/Toasty,1,,5,0,4,14,19,0 days 00:00:00.021850
408,sebastianbergmann/environment,1,,11,1,6,27,38,0 days 00:00:00.043086
409,baldurk/renderdoc,1,v,39,4,12,0,39,0 days 00:00:00.830459
410,Squirrel/Squirrel.Windows,1,,17,5,7,48,65,0 days 00:00:00.083772
411,BYVoid/OpenCC,1,ver.,4,0,3,18,22,0 days 00:00:00.073235
412,kpdecker/jsdiff,1,v,15,3,9,24,39,0 days 00:00:00.037681
413,apache/storm,2, v,11,1,9,26,37,0 days 00:00:00.755906
414,mde/ejs,1,v,0,0,0,45,45,0 days 00:00:00.151562
415,conventional-changelog/standard-version,1,v,24,8,13,13,37,0 days 00:00:00.033889
416,isomorphic-git/isomorphic-git,1,v,96,86,3,238,334,0 days 00:00:00.208624
417,ramboxapp/community-edition,1,,7,3,3,36,43,0 days 00:00:00.074500
418,the-benchmarker/web-frameworks,2, v,3,1,1,13,16,0 days 00:00:00.280368
419,openwall/john,2, JOHN_,3,0,2,2,5,0 days 00:00:00.105508
420,NanoHttpd/nanohttpd,3,Release- nanohttpd-project- v,7,2,4,5,12,0 days 00:00:00.037695
421,conventional-changelog/conventional-changelog,33,conventional-changelog-angular-v conventional-changelog-v conventional-changelog-ember@ conventional-changelog-core@ conventional-changelog-writer-v conventional-commits-parser@ @marionebl/conventional-commits-parser@ conventional-changelog-atom@ conventional-changelog-conventionalcommits@ conventional-changelog-eslint@ git-raw-commits@ conventional-recommended-bump-v conventional-changelog-preset-loader-v conventional-changelog-conventionalcommits-v conventional-changelog-core-v conventional-changelog-cli-v conventional-changelog@ conventional-changelog-angular@ gulp-conventional-changelog@ conventional-changelog-express@ conventional-changelog-preset-loader@ conventional-commits-parser-v conventional-changelog-jquery@ conventional-changelog-cli@ conventional-recommended-bump@ standard-changelog@ git-semver-tags@ conventional-changelog-codemirror@ conventional-changelog-jshint@ conventional-commits-filter@ v git-raw-commits-v conventional-changelog-writer@,32,4,5,657,689,0 days 00:00:00.625460
422,getsentry/sentry-javascript,4, raven-node@ v raven-js@,102,78,5,230,332,0 days 00:00:00.408478
423,dylanaraps/pywal,1,,17,10,2,65,82,0 days 00:00:00.068670
424,weaveworks/weave,2,v fast-datapath-preview-,25,8,10,49,74,0 days 00:00:00.455788
425,ElectronNET/Electron.NET,2, v,0,0,0,14,14,0 days 00:00:00.044144
426,vmware-tanzu/velero,1,v,17,2,8,43,60,0 days 00:00:00.178290
427,Radarr/Radarr,2, v,99,64,13,13,112,0 days 00:00:00.695866
428,simeji/jid,2, v,7,4,1,14,21,0 days 00:00:00.018670
429,graphql/express-graphql,1,v,12,3,7,31,43,0 days 00:00:00.057970
430,Uberi/speech_recognition,1,,16,6,6,29,45,0 days 00:00:00.032777
431,miekg/dns,1,v,2,0,1,64,66,0 days 00:00:00.363200
432,automl/auto-sklearn,3, v. v,12,2,6,21,33,0 days 00:00:00.239412
433,bookshelf/bookshelf,2, start-es,17,2,11,68,85,0 days 00:00:00.113432
434,concourse/concourse,1,v,134,117,4,81,215,0 days 00:00:01.594574
435,benbjohnson/litestream,1,v,3,2,0,8,11,0 days 00:00:00.027574
436,gitextensions/gitextensions,3, master_Net v,111,86,15,30,141,0 days 00:00:00.822260
437,NixOS/nix,1,,37,5,23,53,90,0 days 00:00:00.871570
438,PrestaShop/PrestaShop,1,,30,18,4,83,113,0 days 00:00:04.522645
439,feross/simple-peer,1,v,50,34,10,71,121,0 days 00:00:00.089583
440,apache/incubator-shenyu,2, v,2,0,1,8,10,0 days 00:00:00.265105
441,Cyan4973/xxHash,2,r v,12,4,4,11,23,0 days 00:00:00.075860
442,symfony/translation,1,v,26,4,21,462,488,0 days 00:00:00.406362
443,elasticsearch-dump/elasticsearch-dump,2, v,113,92,6,137,250,0 days 00:00:00.177005
444,dotnetcore/FastGithub,1,,5,3,0,31,36,0 days 00:00:00.054432
445,PHPOffice/PHPWord,1,,12,3,7,8,20,0 days 00:00:00.110744
446,JanDeDobbeleer/oh-my-posh,1,v,350,349,0,383,733,0 days 00:00:00.719412
447,arc298/instagram-scraper,2, v,11,3,4,68,79,0 days 00:00:00.041963
448,node-formidable/formidable,2, v,12,8,3,33,45,0 days 00:00:00.050724
449,maxogden/menubar,1,v,18,4,8,47,65,0 days 00:00:00.039447
450,katspaugh/wavesurfer.js,2, v,26,5,10,105,131,0 days 00:00:00.224539
451,pmndrs/use-gesture,6, V @use-gesture/core@ v @use-gesture/vanilla@ @use-gesture/react@,9,1,5,111,120,0 days 00:00:00.103912
452,doccano/doccano,1,v,8,2,3,19,27,0 days 00:00:00.161354
453,eclipse/mosquitto,1,v,4,0,3,55,59,0 days 00:00:00.230578
454,jackocnr/intl-tel-input,2, v,62,41,10,262,324,0 days 00:00:00.237781
455,i18next/i18next,2, v,91,66,9,222,313,0 days 00:00:00.235805
456,tensorpack/tensorpack,3, v doc-v,12,6,4,27,39,0 days 00:00:00.133959
457,imgproxy/imgproxy,2,actionstest v,26,14,5,55,81,0 days 00:00:00.083065
458,albertlauncher/albert,1,v,17,9,5,64,81,0 days 00:00:00.084799
459,hyperopt/hyperopt,1,,2,0,1,9,11,0 days 00:00:00.064644
460,99designs/aws-vault,1,v,34,17,9,32,66,0 days 00:00:00.079653
461,alteryx/featuretools,2,dev_v v,37,25,2,36,73,0 days 00:00:00.090577
462,dtm-labs/dtm,1,v,21,18,1,35,56,0 days 00:00:00.068621
463,sebastianbergmann/global-state,1,,6,0,5,8,14,0 days 00:00:00.033186
464,AirtestProject/Airtest,1,v,2,0,1,17,19,0 days 00:00:00.048395
465,vanhauser-thc/thc-hydra,2, v,10,0,7,1,11,0 days 00:00:00.049458
466,amoffat/sh,1,,34,26,5,17,51,0 days 00:00:00.191521
467,JetBrains/Exposed,1,,8,3,3,78,86,0 days 00:00:00.232247
468,react-native-video/react-native-video,2, v,24,13,7,49,73,0 days 00:00:00.078855
469,techfort/LokiJS,1,v,3,0,2,33,36,0 days 00:00:00.077775
470,citusdata/citus,1,v,25,0,13,82,107,0 days 00:00:00.364294
471,StackExchange/blackbox,1,v,18,6,8,0,18,0 days 00:00:00.034145
472,yocontra/react-responsive,1,v,8,2,4,28,36,0 days 00:00:00.033578
473,RichardKnop/machinery,1,v,11,1,7,86,97,0 days 00:00:00.078888
474,sebastianbergmann/recursion-context,1,,4,0,3,8,12,0 days 00:00:00.021870
475,kubernetes/client-go,2,kubernetes- v,38,2,16,330,368,0 days 00:00:00.581732
476,sebastianbergmann/version,1,,3,0,2,9,12,0 days 00:00:00.012972
477,google/skia,3,pathkit/ canvaskit/ chrome/m,17,8,1,3,20,0 days 00:00:03.778158
478,Zizaco/entrust,1,,10,2,7,8,18,0 days 00:00:00.028188
479,s3fs-fuse/s3fs-fuse,2,v Pre-v,18,2,13,1,19,0 days 00:00:00.109282
480,medialize/URI.js,2,v. v,20,7,11,54,74,0 days 00:00:00.071397
481,jquery/sizzle,1,,11,0,9,43,54,0 days 00:00:00.066415
482,gitalk/gitalk,1,v,5,1,3,16,21,0 days 00:00:00.020956
483,go-resty/resty,1,v,34,14,10,7,41,0 days 00:00:00.039805
484,maxence-charriere/go-app,2, v,37,24,6,69,106,0 days 00:00:00.087890
485,golang/tools,2,gopls/v v,8,0,4,45,53,0 days 00:00:00.454299
486,yagop/node-telegram-bot-api,1,v,26,14,6,13,39,0 days 00:00:00.130376
487,DIYgod/APlayer,2, v,6,3,2,15,21,0 days 00:00:00.028762
488,shentao/vue-multiselect,2, v,5,2,1,20,25,0 days 00:00:00.037537
489,processing/processing,37,processing-0247- processing-0270- processing-0259- processing-0253- processing-0246- processing-0267- processing-0263- mobile- processing-0251- processing-0225- processing-0226- processing-0227- release- processing-0250- processing-0249- processing-0220- processing-0264- processing-0248- processing-0266- processing-0254- processing-0268- processing-0224- processing-0269- processing-0261- processing- processing-0260- processing-0218- processing-0219- processing-0262- processing-0256- processing-0255- processing-0257- processing-0223- processing-0265- processing-0252- processing-0258- processing-0221-,211,164,20,47,258,0 days 00:00:01.448226
490,jiaaro/pydub,1,v,17,3,9,19,36,0 days 00:00:00.049666
491,stanfordnlp/stanza,2, v,6,0,5,7,13,0 days 00:00:00.133695
492,bpmn-io/bpmn-js,2, v,75,45,7,155,230,0 days 00:00:00.229639
493,gruntwork-io/terratest,1,v,39,21,9,296,335,0 days 00:00:00.303072
494,thephpleague/oauth2-server,1,,25,3,11,72,97,0 days 00:00:00.164178
495,snipe/snipe-it,3, v V,30,12,13,130,160,0 days 00:00:00.804948
496,beanstalkd/beanstalkd,3,r v dev,24,11,9,13,37,0 days 00:00:00.055032
497,baskerville/bspwm,1,,9,4,1,15,24,0 days 00:00:00.164413
498,any86/any-rule,1,v,2,1,0,19,21,0 days 00:00:00.034813
499,software-mansion/react-native-reanimated,1,,23,10,2,19,42,0 days 00:00:00.103386
500,dataarts/dat.gui,2, v,6,0,2,18,24,0 days 00:00:00.040875
501,swaggo/swag,2,v. v,9,0,5,23,32,0 days 00:00:00.047990
502,redux-offline/redux-offline,2, v,7,1,4,9,16,0 days 00:00:00.034035
503,vernesong/OpenClash,1,v,5,4,0,7,12,0 days 00:00:00.028342
504,pocoproject/poco,2,pre-C++ pre-cpp,1,0,0,1,2,0 days 00:00:00.429706
505,Graylog2/graylog2-server,1,,25,1,20,124,149,0 days 00:00:01.403724
506,simonw/datasette,1,,55,43,6,39,94,0 days 00:00:00.132171
507,securego/gosec,2, v,16,3,8,8,24,0 days 00:00:00.049386
508,Saul-Mirone/milkdown,29,@milkdown/plugin-menu@ @milkdown/preset-commonmark@ @milkdown/theme-nord@ @milkdown/core@ @milkdown/exception@ @milkdown/prose@ @milkdown/plugin-cursor@ @milkdown/plugin-emoji@ @milkdown/vue@ @milkdown/plugin-slash@ @milkdown/preset-gfm@ @milkdown/plugin-listener@ @milkdown/react@ @milkdown/theme-pack-helper@ @milkdown/plugin-collaborative@ @milkdown/ctx@ @milkdown/plugin-tooltip@ @milkdown/plugin-prism@ @milkdown/plugin-indent@ @milkdown/utils@ @milkdown/plugin-upload@ @milkdown/design-system@ @milkdown/theme-tokyo@ @milkdown/plugin-table@ @milkdown/plugin-math@ @milkdown/transformer@ @milkdown/plugin-clipboard@ @milkdown/plugin-diagram@ @milkdown/plugin-history@,20,18,0,1406,1426,0 days 00:00:02.562091
509,faker-js/faker,1,v,22,10,9,26,48,0 days 00:00:00.124836
510,ArthurHub/Android-Image-Cropper,1,,9,2,6,23,32,0 days 00:00:00.039393
511,garris/BackstopJS,2, v,25,9,8,106,131,0 days 00:00:00.114310
512,fruitcake/laravel-cors,2,v V,16,5,10,33,49,0 days 00:00:00.034725
513,apache/jmeter,2,v rel/v,24,0,17,15,39,0 days 00:00:01.064964
514,PaddlePaddle/Paddle-Lite,3, v release/,15,4,7,6,21,0 days 00:00:00.525425
515,chrismaltby/gb-studio,2, v,6,3,2,6,12,0 days 00:00:00.333170
516,electerious/Lychee,2, v,11,1,6,31,42,0 days 00:00:00.086636
517,marshmallow-code/marshmallow,1,,48,22,11,77,125,0 days 00:00:00.210601
518,centrifugal/centrifugo,1,v,24,5,9,57,81,0 days 00:00:00.094282
519,dylang/npm-check,2, v,12,4,6,33,45,0 days 00:00:00.031768
520,react-native-svg/react-native-svg,2, v,45,30,7,164,209,0 days 00:00:00.204413
521,belluzj/fantasque-sans,2, v,5,1,2,10,15,0 days 00:00:00.024112
522,sebastianbergmann/object-enumerator,1,,4,0,3,9,13,0 days 00:00:00.022387
523,sourcegraph/sourcegraph,2,customer-replica-v v,50,44,1,145,195,0 days 00:00:02.613038
524,lightningnetwork/lnd,9,queue/v clock/v healthcheck/v tlv/v tor/v kvdb/v v ticker/v cert/v,5,0,2,37,42,0 days 00:00:00.907657
525,sandstorm-io/sandstorm,1,v,293,292,0,0,293,0 days 00:00:00.716273
526,pahen/madge,2, v,30,13,11,29,59,0 days 00:00:00.042359
527,QuantConnect/Lean,2, v,1917,1077,4,10,1927,0 days 00:00:05.048594
528,cupy/cupy,1,v,56,48,1,6,62,0 days 00:00:01.637906
529,qemu/qemu,2,release_ v,48,2,42,86,134,0 days 00:00:05.938206
530,uber/cadence,1,v,22,10,6,55,77,0 days 00:00:00.459128
531,xonsh/xonsh,1,,12,1,10,100,112,0 days 00:00:00.662894
532,GoAdminGroup/go-admin,2, v,9,6,0,76,85,0 days 00:00:00.121034
533,facebookresearch/pytorch3d,1,v,6,0,4,4,10,0 days 00:00:00.051660
534,nodejs/http-parser,1,v,14,0,12,12,26,0 days 00:00:00.035531
535,jenssegers/laravel-mongodb,2, v,19,3,12,91,110,0 days 00:00:00.120678
536,jspreadsheet/ce,2, v,7,0,5,17,24,0 days 00:00:00.047341
537,os-js/OS.js,4, alpha- alpha v,85,77,3,28,113,0 days 00:00:00.288533
538,edenhill/librdkafka,7, test-monic-incl ar_test_ confluent-debian- test-tag-arm v confluent-debian-v,18,1,12,35,53,0 days 00:00:00.224127
539,gsoft-inc/craco,1,v,32,24,2,27,59,0 days 00:00:00.044170
540,testcontainers/testcontainers-java,4, testcontainers- tes-containers- test-containers-,19,2,12,63,82,0 days 00:00:00.398823
541,tindy2013/subconverter,1,v,7,3,2,28,35,0 days 00:00:00.047614
542,aws/aws-sam-cli,1,v,96,89,1,36,132,0 days 00:00:00.255658
543,real-logic/aeron,3, publish-test- v,42,16,8,62,104,0 days 00:00:00.857944
544,zephyrproject-rtos/zephyr,2,v zephyr-v,24,4,18,46,70,0 days 00:00:03.488677
545,chancejs/chancejs,2, v,9,3,5,47,56,0 days 00:00:00.073570
546,mcollina/autocannon,1,v,52,36,9,43,95,0 days 00:00:00.056884
547,crater-invoice/crater,1,,11,4,4,19,30,0 days 00:00:00.080027
548,thedevs-network/kutt,1,v,10,6,2,51,61,0 days 00:00:00.046857
549,supertokens/supertokens-core,1,v,22,15,2,17,39,0 days 00:00:00.050539
550,filhodanuvem/gitql,2, v,10,2,6,8,18,0 days 00:00:00.024786
551,google/error-prone,1,v,15,3,5,34,49,0 days 00:00:00.296538
552,flot/flot,2, v,16,6,7,35,51,0 days 00:00:00.069951
553,SocketCluster/socketcluster,3, v. v,17,13,3,26,43,0 days 00:00:00.071713
554,hashicorp/raft,1,v,5,1,3,15,20,0 days 00:00:00.055656
555,facebookresearch/hydra,1,v,3,0,2,10,13,0 days 00:00:00.123638
556,Kenshin/simpread,2, firefox-,2,0,1,14,16,0 days 00:00:00.439517
557,wojtekmaj/react-pdf,1,v,27,13,6,36,63,0 days 00:00:00.073574
558,IntelRealSense/librealsense,4, AutoExposure_Fix_ v ros,55,28,7,75,130,0 days 00:00:00.857413
559,reactiveui/refit,2, v,13,3,6,39,52,0 days 00:00:00.128719
560,apache/tomcat,1,,4,0,3,272,276,0 days 00:00:04.014917
561,onsi/ginkgo,1,v,19,3,11,21,40,0 days 00:00:00.061424
562,karatelabs/karate,1,v,11,1,6,27,38,0 days 00:00:00.192243
563,ProseMirror/prosemirror,1,,9,8,0,8,17,0 days 00:00:00.068599
564,burnash/gspread,2, v,19,9,8,21,40,0 days 00:00:00.067311
565,OrchardCMS/OrchardCore,1,v,4,0,1,6,10,0 days 00:00:00.314732
566,owncast/owncast,1,v,0,0,0,11,11,0 days 00:00:00.104582
567,plantuml/plantuml,1,v,9,2,4,78,87,0 days 00:00:00.209366
568,fabiospampinato/cash,1,,16,8,5,36,52,0 days 00:00:00.054106
569,jazzband/pip-tools,1,,45,22,12,49,94,0 days 00:00:00.115443
570,conan-io/conan,1,,76,65,0,162,238,0 days 00:00:00.389646
571,sindresorhus/query-string,2, v,34,12,12,38,72,0 days 00:00:00.036172
572,npm/cli,27, libnpmsearch-v libnpmpack@ libnpmaccess-v libnpmexec@ libnpmorg@ libnpmteam-v libnpmpublish-v @npmcli/arborist-v libnpmpack-v libnpmdiff@ libnpmorg-v libnpmhook-v libnpmfund-v libnpmfund@ libnpmaccess@ @npmcli/arborist@ libnpmdiff-v libnpmhook@ libnpmversion-v libnpmpublish@ libnpmversion@ arborist-v v libnpmexec-v libnpmsearch@ libnpmteam@,103,71,15,606,709,0 days 00:00:01.324239
573,mozilla-mobile/fenix,2,fennec/nightly/ v,60,53,3,59,119,0 days 00:00:00.644583
574,platformio/platformio-core,3, v. v,43,22,13,72,115,0 days 00:00:00.281039
575,OJ/gobuster,1,v,11,1,7,4,15,0 days 00:00:00.032241
576,blueedgetechno/win11React,2, win11inreact-v,2,0,1,17,19,0 days 00:00:00.082929
577,google/sentencepiece,2, v,1,0,0,19,20,0 days 00:00:00.046483
578,bytedeco/javacv,1,,17,1,14,14,31,0 days 00:00:00.039503
579,spulec/moto,2, v,14,2,8,152,166,0 days 00:00:00.492117
580,perkeep/perkeep,1,,11,5,5,0,11,0 days 00:00:00.478973
581,ckeditor/ckeditor5,2, v,48,30,3,6,54,0 days 00:00:02.756105
582,ractivejs/ractive,1,v,10,1,6,88,98,0 days 00:00:00.148745
583,google/j2objc,1,,14,0,11,25,39,0 days 00:00:00.266578
584,trpc/trpc,2, v,57,54,1,48,105,0 days 00:00:00.253333
585,heroiclabs/nakama,1,v,38,17,5,29,67,0 days 00:00:00.075585
586,HypothesisWorks/hypothesis,7, hypothesis-python- hypothesis-ruby- v conjecture- test-tag conjecture-rust-,270,259,3,1002,1272,0 days 00:00:02.443537
587,angr/angr,1,v,1,0,0,73,74,0 days 00:00:00.630555
588,tensorflow/tensorboard,2,data-server-v ,27,9,11,18,45,0 days 00:00:00.321788
589,rest-assured/rest-assured,1,rest-assured-,32,6,15,40,72,0 days 00:00:00.318905
590,ariakit/ariakit,12,reakit-playground@ reakit-warning@ reakit-system@ reakit-system-bootstrap@ reakit@ v reakit-utils@ reakit-codemods@ reakit-test-utils@ reakit-theme-default@ reakit-system-palette@ website@,24,12,0,352,376,0 days 00:00:00.274389
591,AlaSQL/alasql,2, v,6,0,4,58,64,0 days 00:00:00.098709
592,ianstormtaylor/superstruct,1,v,14,7,4,55,69,0 days 00:00:00.063183
593,gruntwork-io/terragrunt,1,v,37,18,12,337,374,0 days 00:00:00.427220
594,ACRA/acra,3, acra- Acra-,19,1,13,31,50,0 days 00:00:00.108234
595,alibaba/BizCharts,7, bizcharts-plugin/slider/ bizcharts/ publish/ publish- v slider/,7,2,3,55,62,0 days 00:00:00.063995
596,theatre-js/theatre,1,,4,0,2,33,37,0 days 00:00:00.076199
597,File-New-Project/EarTrumpet,1,,9,2,6,29,38,0 days 00:00:00.083200
598,RobinHerbots/Inputmask,1,,12,0,10,88,100,0 days 00:00:00.165138
599,scikit-learn-contrib/imbalanced-learn,1,,8,0,7,21,29,0 days 00:00:00.063011
600,webslides/WebSlides,1,,7,4,1,7,14,0 days 00:00:00.034935
601,remoteinterview/zero,1,v,1,0,0,36,37,0 days 00:00:00.050755
602,DouyinFE/semi-design,1,v,12,11,0,25,37,0 days 00:00:00.058314
603,leiurayer/downkyi,1,v,2,0,1,8,10,0 days 00:00:00.017361
604,b-ryan/powerline-shell,1,v,0,0,0,12,12,0 days 00:00:00.035908
605,sparklemotion/nokogiri,2,v REL_,15,2,10,89,104,0 days 00:00:00.358167
606,keystonejs/keystone,195,@keystonejs/logger@ @keystone-alpha/app-static@ @voussoir/keystone@ @keystonejs/app-static@ @keystone-next/fields-datetime-utc-legacy@ @keystone-alpha/adapter-mongoose@ @keystone-alpha/fields@ @keystone-alpha/logger@ @keystone-next/session-store-redis@ @keystonejs/field-views-loader@ @keystone-next/utils@ @keystone-next/app-admin-ui-legacy@ @keystonejs/field-content@ @keystonejs/adapter-knex@ @keystone-alpha/app-admin-ui@ @keystonejs/fields-location-google@ @keystonejs/fields-oembed@ @keystone-alpha/auth-password@ @keystonejs/fields-wysiwyg-tinymce@ @voussoir/access-control@ @keystone-next/fields@ @arch-ui/dropdown@ @arch-ui/pill@ @keystone-next/access-control-legacy@ @voussoir/ui@ @keystonejs/app-graphql@ @keystone-alpha/field-content@ @keystone-alpha/apollo-helpers@ @keystone-alpha/app-graphql-playground@ @keystone-next/app-schema-router-legacy@ @arch-ui/loading@ @keystone-ui/core@ @arch-ui/card@ @keystone-next/fields-color-legacy@ @keystone-6/fields-document@ @arch-ui/popout@ @voussoir/file-adapters@ @arch-ui/navbar@ @keystone-next/email-legacy@ @keystone-alpha/fields-datetime-utc@ @keystone-alpha/server@ @arch-ui/typography@ @keystone-next/adapter-prisma-legacy@ @voussoir/email@ v @voussoir/adapter-knex@ @keystonejs/app-admin-ui@ @keystonejs/app-version@ @keystone-next/cloudinary@ @keystone-alpha/list-plugins@ @keystone-alpha/test-utils@ @keystonejs/server-side-graphql-client@ @keystonejs/apollo-helpers@ @keystone-ui/popover@ @keystone-next/fields-oembed-legacy@ @keystone-alpha/fields-auto-increment@ @keystone-ui/fields@ @keystone-alpha/email@ @keystone-alpha/fields-markdown@ @voussoir/core@ @voussoir/adapter-mongoose@ @keystone-alpha/mongo-join-builder@ @keystone-ui/toast@ @voussoir/server@ @keystonejs/fields-authed-relationship@ @voussoir/field-views-loader@ @keystone-alpha/fields-wysiwyg-tinymce@ @keystone-6/core@ @keystone-next/list-plugins-legacy@ @keystone-next/auth@ @arch-ui/drawer@ @keystone-alpha/admin-ui@ @keystone-next/fields-authed-relationship-legacy@ @arch-ui/color-utils@ create-keystone-app@ @keystone-next/keystone@ @keystone-alpha/app-next@ @keystone-next/app-static-legacy@ @keystone-alpha/build-field-types@ @arch-ui/confirm@ @arch-ui/pagination@ @voussoir/test-utils@ @keystonejs/app-graphql-playground@ @keystone-ui/modals@ @keystone-next/admin-ui@ @keystone-alpha/file-adapters@ @keystone-next/utils-legacy@ @keystonejs/app-nuxt@ @arch-ui/badge@ @keystone-alpha/session@ @arch-ui/tooltip@ @arch-ui/layout@ @keystone-next/field-views-loader-legacy@ @keystone-next/fields-cloudinary-image-legacy@ @arch-ui/theme@ @keystone-alpha/passport-auth@ @arch-ui/filters@ @keystone-alpha/keystone@ @keystone-next/testing@ @arch-ui/icons@ @voussoir/fields@ @keystone-ui/pill@ @keystonejs/app-schema-router@ @keystone-alpha/app-schema-router@ @keystone-next/file-adapters-legacy@ @keystone-next/fields-unsplash-legacy@ @keystone-next/fields-content-legacy@ @voussoir/apollo-helpers@ @keystonejs/test-utils@ @keystone-next/keystone-legacy@ @arch-ui/day-picker@ @keystone-next/app-graphql-playground-legacy@ @keystonejs/fields@ @arch-ui/modal-utils@ @keystone-ui/notice@ @arch-ui/options@ @keystone-alpha/core@ @keystone-next/session-legacy@ @keystonejs/auth-password@ @arch-ui/lozenge@ @keystone-ui/button@ @keystonejs/mongo-join-builder@ @keystone-next/fields-location-google-legacy@ @keystone-6/session-store-redis@ @arch-ui/fields@ @keystone-ui/loading@ @keystonejs/fields-content@ @keystone-next/test-utils-legacy@ @keystonejs/list-plugins@ @keystonejs/auth-passport@ @keystone-next/fields-wysiwyg-tinymce-legacy@ @keystone-ui/tooltip@ @arch-ui/input@ @keystone-ui/icons@ @voussoir/mongo-join-builder@ @keystone-next/fields-auto-increment-legacy@ @keystone-next/adapter-mongoose-legacy@ @keystonejs/fields-unsplash@ @keystonejs/keystone@ @keystone-6/document-renderer@ @keystone-ui/options@ @keystonejs/adapter-prisma@ @arch-ui/alert@ @keystone-next/app-nuxt-legacy@ @keystonejs/fields-cloudinary-image@ @keystonejs/build-field-types@ @keystone-next/app-version-legacy@ @keystone-alpha/utils@ @arch-ui/select@ @voussoir/utils@ @keystonejs/email@ @keystone-next/fields-legacy@ @keystone-next/admin-ui-utils@ @keystonejs/oembed-adapters@ @keystonejs/fields-markdown@ @keystone-next/fields-markdown-legacy@ @keystone-alpha/access-control@ @keystone-next/app-graphql-legacy@ @voussoir/admin-ui@ @arch-ui/controls@ @keystone-alpha/field-views-loader@ @arch-ui/common@ @keystonejs/app-next@ @keystone-next/app-next-legacy@ @keystone-next/document-renderer@ @keystonejs/access-control@ @keystone-alpha/fields-mongoid@ @keystone-next/fields-document@ @keystone-next/server-side-graphql-client-legacy@ @arch-ui/dialog@ @keystone-next/auth-password-legacy@ @arch-ui/hooks@ @voussoir/icons@ @keystonejs/fields-mongoid@ @keystonejs/fields-color@ @keystone-alpha/app-graphql@ @keystonejs/fields-datetime-utc@ @keystone-alpha/oembed-adapters@ @keystonejs/file-adapters@ @keystonejs/fields-auto-increment@ @keystone-6/auth@ @keystone-next/adapter-knex-legacy@ @keystonejs/adapter-mongoose@ @keystone-alpha/auth-passport@ @keystone-next/types@ @voussoir/logger@ @keystone-next/fields-mongoid-legacy@ @keystonejs/utils@ @arch-ui/button@ @keystonejs/session@ @keystone-next/auth-passport-legacy@ @keystone-next/apollo-helpers-legacy@ @keystone-alpha/adapter-knex@ @keystone-6/cloudinary@ @keystone-ui/segmented-control@,118,7,5,2534,2652,0 days 00:00:13.510907
607,pyroscope-io/pyroscope,6,@pyroscope/flamegraph@ @pyroscope/models@ @pyroscope/webapp@ @pyroscope/panel-plugin@ v @pyroscope/datasource-plugin@,25,20,0,146,171,0 days 00:00:00.127730
608,ethereum-mining/ethminer,1,v,10,1,5,3,13,0 days 00:00:00.775925
609,byt3bl33d3r/CrackMapExec,2, v,7,3,0,14,21,0 days 00:00:00.046316
610,moroshko/react-autosuggest,1,v,41,30,6,54,95,0 days 00:00:00.178674
611,Unleash/unleash,2, v,34,19,7,132,166,0 days 00:00:00.467759
612,mgcrea/angular-strap,1,v,6,0,4,46,52,0 days 00:00:00.188033
613,LMMS/lmms,1,v,6,0,5,47,53,0 days 00:00:00.482240
614,kulshekhar/ts-jest,2, v,30,14,8,88,118,0 days 00:00:00.242741
615,guardicore/monkey,3, zero-trust-demo- v,11,0,8,6,17,0 days 00:00:00.333263
616,geerlingguy/ansible-for-devops,1,,32,16,9,1,33,0 days 00:00:00.039322
617,angular/flex-layout,0,,0,0,0,0,0,0 days 00:00:00.025452
618,Shougo/deoplete.nvim,1,,14,1,11,0,14,0 days 00:00:00.101968
619,humhub/humhub,2,v. v,17,0,14,67,84,0 days 00:00:00.492935
620,twitchtv/twirp,1,v,18,8,8,10,28,0 days 00:00:00.041017
621,phpmyadmin/phpmyadmin,2, RELEASE_,37,8,23,300,337,0 days 00:00:07.084750
622,yuliskov/SmartTubeNext,1,,73,54,1,0,73,0 days 00:00:00.232813
623,neuecc/UniRx,1,,18,8,5,7,25,0 days 00:00:00.059357
624,airbnb/hypernova,1,v,9,1,4,8,17,0 days 00:00:00.021129
625,postmanlabs/newman,3, v. v,26,8,8,80,106,0 days 00:00:00.372797
626,mahmoud/boltons,1,,24,9,9,21,45,0 days 00:00:00.095529
627,pentaho/pentaho-kettle,1,,31,11,16,37,68,0 days 00:00:01.002919
628,dataease/dataease,1,v,11,9,0,12,23,0 days 00:00:00.362607
629,davidjbradshaw/iframe-resizer,2, v,26,16,7,96,122,0 days 00:00:00.104132
630,Airblader/i3,3, tree-pr AnyEvent-,41,10,25,22,63,0 days 00:00:00.418265
631,dragonflyoss/Dragonfly,1,v,5,0,3,13,18,0 days 00:00:00.109586
632,diasurgical/devilutionX,4, works v broken,19,6,7,15,34,0 days 00:00:00.500538
633,gonum/gonum,1,v,5,0,4,7,12,0 days 00:00:00.294372
634,imbushuo/mac-precision-touchpad,1,univ-b,1,0,0,0,1,0 days 00:00:00.016774
635,vmware-tanzu/octant,1,v,25,15,3,15,40,0 days 00:00:00.222341
636,mitchellh/mapstructure,1,v,6,2,3,11,17,0 days 00:00:00.028567
637,armosec/kubescape,2,betav v,0,0,0,117,117,0 days 00:00:00.098626
638,django-extensions/django-extensions,1,,21,0,19,104,125,0 days 00:00:00.201379
639,weibocom/motan,1,,5,1,3,17,22,0 days 00:00:00.040288
640,gorse-io/gorse,1,v,3,0,2,15,18,0 days 00:00:00.062086
641,valinet/ExplorerPatcher,1,,19,18,0,10,29,0 days 00:00:00.183563
642,ben-rogerson/twin.macro,1,,22,16,0,32,54,0 days 00:00:00.050264
643,dotnet/wpf,1,v,0,0,0,47,47,0 days 00:00:00.267580
644,gcc-mirror/gcc,12,prereleases/gcc- misc/first-auto-changelog- prereleases/libstdc++- releases/libgcj- misc/cutover-egcs- misc/gccgo-go prereleases/libgcj- releases/egcs- releases/g77- releases/libf2c- basepoints/gcc- releases/gcc-,63,1,52,90,153,0 days 00:00:14.761487
645,TypeStrong/typedoc,2, v,22,3,13,127,149,0 days 00:00:00.130013
646,react-native-device-info/react-native-device-info,1,v,57,43,7,114,171,0 days 00:00:00.127945
647,travist/jsencrypt,2, v,7,2,3,3,10,0 days 00:00:00.023553
648,joelittlejohn/jsonschema2pojo,2,jsonschema2pojo- jsonschema2pojo-jdk-annotation-,6,0,5,54,60,0 days 00:00:00.073015
649,Jrohy/multi-v2ray,1,v,18,10,4,79,97,0 days 00:00:00.137143
650,Financial-Times/polyfill-service,2, v,87,65,5,87,174,0 days 00:00:00.262656
651,gevent/gevent,2, v,19,4,12,35,54,0 days 00:00:00.431121
652,voidcosmos/npkill,1,v,8,5,2,19,27,0 days 00:00:00.035277
653,deepmipt/DeepPavlov,1,,17,6,4,28,45,0 days 00:00:00.139966
654,mamedev/mame,1,mame,124,89,11,0,124,0 days 00:00:05.015762
655,HMBSbige/ShadowsocksR-Windows,1,,28,12,13,127,155,0 days 00:00:00.150620
656,python-visualization/folium,1,v,11,1,7,10,21,0 days 00:00:00.084955
657,mattn/go-sqlite3,1,v,16,4,7,19,35,0 days 00:00:00.058782
658,vuejs/vue-class-component,1,v,10,2,5,15,25,0 days 00:00:00.024545
659,plasma-umass/scalene,2, v,3,1,1,22,25,0 days 00:00:00.127188
660,mikefarah/yq,4, draft- releaseTest-manpage v,45,25,10,79,124,0 days 00:00:00.114404
661,betaflight/betaflight,7, CLFL_v INAV- flight-tested- flight-ready- v v.,34,15,12,98,132,0 days 00:00:01.254099
662,jsx-eslint/eslint-plugin-react,1,v,81,55,6,88,169,0 days 00:00:00.214342
663,brython-dev/brython,1,,12,1,9,46,58,0 days 00:00:00.321320
664,redux-observable/redux-observable,2, v,23,13,7,8,31,0 days 00:00:00.052520
665,taigaio/taiga-back,1,,24,7,9,74,98,0 days 00:00:00.344424
666,kelseyhightower/confd,1,v,15,3,8,7,22,0 days 00:00:00.072224
667,vercel/serve,2, v,49,34,7,96,145,0 days 00:00:00.111558
668,shirou/gopsutil,2, v,3,0,1,67,70,0 days 00:00:00.128503
669,spesmilo/electrum,3, password_v seed_v,34,11,16,105,139,0 days 00:00:00.782742
670,edgedb/edgedb,1,v,5,4,0,0,5,0 days 00:00:00.490084
671,assimp/assimp,2, v,8,0,6,15,23,0 days 00:00:00.973433
672,hoffstadt/DearPyGui,1,v,8,4,1,10,18,0 days 00:00:00.265637
673,carla-simulator/carla,1,,9,4,3,38,47,0 days 00:00:00.354624
674,zeromq/libzmq,1,v,2,0,1,9,11,0 days 00:00:00.492220
675,oguzhaninan/Stacer,1,v,2,0,1,9,11,0 days 00:00:00.033848
676,gcanti/fp-ts,1,,38,23,8,115,153,0 days 00:00:00.158567
677,mozilla/nunjucks,3, v. v,14,1,7,37,51,0 days 00:00:00.072364
678,Yelp/elastalert,1,v,2,0,1,123,125,0 days 00:00:00.130911
679,cortexlabs/cortex,1,v,42,36,1,20,62,0 days 00:00:00.133786
680,hybridgroup/gobot,3, v. v,29,10,11,16,45,0 days 00:00:00.442459
681,adnanh/webhook,1,,9,5,3,21,30,0 days 00:00:00.142832
682,react-icons/react-icons,3, v example,17,6,7,12,29,0 days 00:00:00.039585
683,typestack/class-validator,2, v,6,0,4,13,19,0 days 00:00:00.040069
684,metalsmith/metalsmith,2, v,24,15,3,60,84,0 days 00:00:00.045713
685,SFML/SFML,1,,6,0,5,5,11,0 days 00:00:00.099365
686,remix-run/history,1,v,38,24,7,40,78,0 days 00:00:00.069134
687,BeyondDimension/SteamTools,1,,10,6,3,28,38,0 days 00:00:00.143007
688,miguelgrinberg/flasky,0,,0,0,0,0,0,0 days 00:00:00.014178
689,ffmpegwasm/ffmpeg.wasm,1,v,10,6,2,18,28,0 days 00:00:00.023744
690,sindresorhus/type-fest,1,v,40,29,3,34,74,0 days 00:00:00.035614
691,UKPLab/sentence-transformers,1,v,10,3,5,20,30,0 days 00:00:00.865655
692,alibaba/formily,1,v,9,1,4,85,94,0 days 00:00:00.169350
693,vercel/turborepo,1,v,3,0,0,54,57,0 days 00:00:00.075459
694,colinhacks/zod,2, v,20,15,2,23,43,0 days 00:00:00.087937
695,rebassjs/rebass,1,v,11,3,5,42,53,0 days 00:00:00.093214
696,beautify-web/js-beautify,1,v,13,3,7,74,87,0 days 00:00:00.241499
697,probot/probot,2, v,71,58,3,124,195,0 days 00:00:00.166486
698,prompt-toolkit/python-prompt-toolkit,1,,5,1,1,51,56,0 days 00:00:00.117817
699,tailscale/tailscale,1,v,19,8,2,54,73,0 days 00:00:00.200278
700,top-think/think,2, v,3,0,2,65,68,0 days 00:00:00.217186
701,yjs/yjs,1,v,19,9,8,151,170,0 days 00:00:00.147299
702,antvis/F2,8, @antv/f2-graphic@ @antv/f2@ @antv/f2-wx@ @antv/f2-my@ @antv/f2-react@ @antv/f2-site@ @antv/f2-vue@,7,0,5,167,174,0 days 00:00:00.177306
703,freebsd/freebsd-src,1,release/,62,3,58,16,78,0 days 00:00:19.433478
704,mrdoob/stats.js,1,r,16,5,9,0,16,0 days 00:00:00.019046
705,uber/baseweb,1,v,210,206,0,161,371,0 days 00:00:00.613556
706,jonobr1/two.js,1,v,7,0,6,20,27,0 days 00:00:00.104275
707,mvt-project/mvt,1,v,4,2,1,36,40,0 days 00:00:00.457729
708,zhukov/webogram,1,v,3,0,0,11,14,0 days 00:00:00.074757
709,nodegui/nodegui,1,v,48,42,1,45,93,0 days 00:00:00.097316
710,OwlCarousel2/OwlCarousel2,1,,2,0,1,11,13,0 days 00:00:00.034762
711,sindresorhus/ora,1,v,24,9,9,13,37,0 days 00:00:00.121327
712,paramiko/paramiko,3, release- v,23,3,13,152,175,0 days 00:00:00.231122
713,Maximus5/ConEmu,7,dbg-test clink i common- Issue v old-i,15,5,5,320,335,0 days 00:00:00.629615
714,dotnet/BenchmarkDotNet,1,v,7,0,5,40,47,0 days 00:00:00.107147
715,chromedp/chromedp,1,v,8,1,5,33,41,0 days 00:00:00.043914
716,node-fetch/node-fetch,3, v fix-chunked-transfer-premature-close-,15,4,7,25,40,0 days 00:00:00.049616
717,symfony/http-kernel,1,v,26,4,21,489,515,0 days 00:00:00.579148
718,theonedev/onedev,2, v,26,17,2,131,157,0 days 00:00:00.233250
719,go-swagger/go-swagger,2, v,29,8,11,26,55,0 days 00:00:00.145599
720,qgis/QGIS,6,version ltr- version_ final- Release- archive/master_,34,2,29,168,202,0 days 00:00:06.229365
721,signalapp/Signal-Server,1,v,215,206,2,18,233,0 days 00:00:00.287843
722,yiminghe/async-validator,2, v,18,4,11,59,77,0 days 00:00:00.034787
723,kubernetes/kompose,1,v,34,22,6,3,37,0 days 00:00:00.086353
724,Tencent/xLua,1,v,0,0,0,12,12,0 days 00:00:00.191432
725,swagger-api/swagger-editor,3, v/ v,27,11,11,364,391,0 days 00:00:00.412680
726,bottlepy/bottle,1,,3,0,2,72,75,0 days 00:00:00.453315
727,sindresorhus/ky,1,v,29,15,2,18,47,0 days 00:00:00.031653
728,owncloud/core,1,v,23,0,21,147,170,0 days 00:00:03.442637
729,99designs/gqlgen,2, v,16,7,6,35,51,0 days 00:00:00.149249
730,metersphere/metersphere,1,v,20,17,0,61,81,0 days 00:00:00.652022
731,developit/htm,3, v babel-plugin-transform-jsx-to-htm-v,8,2,4,14,22,0 days 00:00:00.034923
732,developit/mitt,2, v,6,1,3,5,11,0 days 00:00:00.018594
733,konvajs/konva,1,,41,18,8,131,172,0 days 00:00:00.224854
734,secdev/scapy,1,v,80,71,8,432,512,0 days 00:00:00.623606
735,react-native-image-picker/react-native-image-picker,2, v,37,22,8,86,123,0 days 00:00:00.086326
736,react-grid-layout/react-draggable,1,v,24,9,7,57,81,0 days 00:00:00.048396
737,hilongjw/vue-lazyload,2, v,2,0,1,14,16,0 days 00:00:00.023669
738,microsoft/wslg,1,v,1,0,0,30,31,0 days 00:00:00.036923
739,chaijs/chai,2, v,30,11,9,48,78,0 days 00:00:00.087586
740,trustedsec/social-engineer-toolkit,1,,17,4,9,87,104,0 days 00:00:00.780104
741,laravel/lumen,1,v,14,0,11,10,24,0 days 00:00:00.031314
742,dropwizard/metrics,1,v,10,1,8,77,87,0 days 00:00:00.209822
743,codenotary/immudb,2,cnlc- v,9,1,5,12,21,0 days 00:00:00.170757
744,akveo/nebular,1,v,23,9,4,23,46,0 days 00:00:00.357592
745,apache/shardingsphere-elasticjob,1,,4,0,3,20,24,0 days 00:00:00.124829
746,retejs/rete,2, v,12,4,3,35,47,0 days 00:00:00.041555
747,nteract/nteract,72,@nteract/transforms@ @nteract/notebook-preview-demo@ @nteract/nbextension@ @nteract/epics@ @nteract/transform-geojson@ @nteract/gatsby-transformer-ipynb@ @nteract/outputs@ @nteract/vega-embed2@ enchannel@ @nteract/mockument@ @nteract/fixtures@ @nteract/fs-kernels@ fs-observable@ @nteract/core@ @nteract/commutable-v @nteract/transform-plotly@ @nteract/commutable@ @nteract/notebook-preview@ @nteract/mythic-notifications@ @nteract/styled-blueprintjsx@ @nteract/iron-icons@ @nteract/styleguide-components@ @nteract/records@ @nteract/notebook-render@ @mybinder/host-cache@ rx-binder@ @nteract/transform-vega@ @nteract/markdown@ @nteract/kernel-relay@ @nteract/commuter@ ansi-to-react@ @nteract/presentational-components@ @nteract/logos@ @nteract/timeago@ @nteract/transform-vdom@ enchannel-zmq-backend@ @nteract/selectors@ @nteract/mythic-windowing@ @nteract/webpack-configurator@ @nteract/play@ @nteract/mathjax@ @nteract/actions@ nteract@ @nteract/reducers@ @nteract/data-explorer@ nteract-on-jupyter@ @nteract/mythic-multiselect@ @nteract/dropdown-menu@ @nteract/monaco-editor@ @nteract/stateful-components@ @nteract/jupyter-widgets@ @nteract/myths@ @nteract/messaging@ @nteract/directory-listing@ @nteract/transform-model-debug@ @nteract/mythic-configuration@ rx-jupyter@ @nteract/octicons@ @nteract/display-area@ @nteract/transforms-full@ @nteract/editor@ @nteract/transform-dataresource@ @nteract/commuter-frontend@ @nteract/styles@ @nteract/types@ @nteract/notebook-on-next@ @nteract/notebook-app-component@ v @nteract/web@ @nteract/showcase@ @nteract/dev-scripts@ @nteract/connected-components@,121,7,4,2353,2474,0 days 00:00:08.311994
748,go-vgo/robotgo,2, v,21,4,9,24,45,0 days 00:00:00.068927
749,aws/aws-sdk-go,4, v. v vrelease-v,48,22,11,1288,1336,0 days 00:00:02.064113
750,wix/react-native-calendars,2, v,1248,222,2,59,1307,0 days 00:00:02.877871
751,streamlink/streamlink,1,,30,9,7,17,47,0 days 00:00:00.218344
752,NginxProxyManager/nginx-proxy-manager,2, v,10,4,2,48,58,0 days 00:00:00.076050
753,isaacs/node-glob,2, v,18,5,10,102,120,0 days 00:00:00.068364
754,tldraw/tldraw,3,@tldraw/core@ @tldraw/tldraw@ v,8,7,0,172,180,0 days 00:00:00.137352
755,google/tsunami-security-scanner,2, v,0,0,0,11,11,0 days 00:00:00.016348
756,HangfireIO/Hangfire,2,v. v,13,4,4,92,105,0 days 00:00:00.256936
757,opencv/opencv_contrib,1,,11,0,10,26,37,0 days 00:00:00.176350
758,webdriverio/webdriverio,1,v,91,65,12,415,506,0 days 00:00:01.075915
759,visionmedia/page.js,2, v,10,3,4,29,39,0 days 00:00:00.054424
760,xupefei/Locale-Emulator,2, v,13,7,5,14,27,0 days 00:00:00.030877
761,audacity/audacity,2,split- Audacity-,7,0,6,28,35,0 days 00:00:01.066638
762,twigphp/Twig,1,v,66,29,23,139,205,0 days 00:00:00.594232
763,numba/numba,2, v,54,9,8,51,105,0 days 00:00:01.298321
764,facebook/proxygen,1,v,14,13,0,270,284,0 days 00:00:00.818180
765,prometheus/node_exporter,2, v,17,2,12,11,28,0 days 00:00:00.097886
766,vesoft-inc/nebula,1,v,7,0,4,6,13,0 days 00:00:00.214609
767,GoogleCloudPlatform/terraformer,1,,2,0,1,29,31,0 days 00:00:00.097797
768,DaveGamble/cJSON,1,v,9,5,1,36,45,0 days 00:00:00.060543
769,wappalyzer/wappalyzer,4, firefox- v Firefox-,13,1,9,100,113,0 days 00:00:00.823490
770,guzzle/psr7,1,,12,1,9,17,29,0 days 00:00:00.047361
771,vuejs/pinia,5, @pinia/testing@ @pinia/nuxt@ v pinia@,6,3,2,62,68,0 days 00:00:00.240291
772,ionic-team/capacitor,2, v,18,6,3,138,156,0 days 00:00:00.317925
773,InsertKoinIO/koin,1,,13,5,6,33,46,0 days 00:00:00.108835
774,doctrine/cache,2, v,17,3,10,27,44,0 days 00:00:00.054446
775,metricsgraphics/metrics-graphics,3,v. v V,25,12,5,10,35,0 days 00:00:00.212198
776,symfony/polyfill-mbstring,1,v,25,3,13,9,34,0 days 00:00:00.019565
777,FormidableLabs/radium,1,v,17,6,6,46,63,0 days 00:00:00.082153
778,react-cosmos/react-cosmos,2, v,33,18,8,41,74,0 days 00:00:00.300401
779,gogf/gf,1,v,14,2,4,106,120,0 days 00:00:00.259998
780,pyro-ppl/pyro,2, pytorch-,14,3,7,15,29,0 days 00:00:00.121868
781,duplicati/duplicati,1,,0,0,0,3,3,0 days 00:00:00.100658
782,altair-viz/altair,2, v,13,3,7,8,21,0 days 00:00:00.153434
783,modin-project/modin,3, v Modin-v,14,1,8,33,47,0 days 00:00:00.126462
784,Z3Prover/z3,2,Z3- z3-,4,0,3,21,25,0 days 00:00:00.936962
785,api-platform/api-platform,2, v,8,0,7,54,62,0 days 00:00:00.059675
786,openspug/spug,2,v V,8,3,3,34,42,0 days 00:00:00.072830
787,TykTechnologies/tyk,3, v certs/v,23,4,9,90,113,0 days 00:00:00.267141
788,webpack/webpack-dev-server,1,v,42,25,9,70,112,0 days 00:00:00.148811
789,oclif/oclif,1,v,59,50,5,261,320,0 days 00:00:00.310861
790,cryptomator/cryptomator,1,,18,7,6,73,91,0 days 00:00:00.425727
791,kelektiv/node-cron,2, v,12,2,8,23,35,0 days 00:00:00.048183
792,mopidy/mopidy,1,v,29,6,16,38,67,0 days 00:00:00.509444
793,PointCloudLibrary/pcl,1,pcl-,13,2,8,12,25,0 days 00:00:00.756218
794,gotify/server,1,v,5,1,3,41,46,0 days 00:00:00.036762
795,playcanvas/engine,4, b v. v,258,236,4,521,779,0 days 00:00:01.281036
796,krallin/tini,1,v,19,6,6,14,33,0 days 00:00:00.026737
797,facebook/litho,1,v,41,26,2,157,198,0 days 00:00:01.137353
798,statsmodels/statsmodels,1,v,10,0,9,12,22,0 days 00:00:00.778058
799,golang/mock,2, v,7,0,6,8,15,0 days 00:00:00.037921
800,lanpa/tensorboardX,1,v,15,2,9,1,16,0 days 00:00:00.048135
801,Sonarr/Sonarr,1,v,44,27,5,8,52,0 days 00:00:00.540043
802,lib/pq,1,v,11,3,5,10,21,0 days 00:00:00.060695
803,facebook/jscodeshift,2, v,11,1,8,45,56,0 days 00:00:00.141369
804,LeetCode-OpenSource/vscode-leetcode,1,v,17,10,3,26,43,0 days 00:00:00.039100
805,Supervisor/supervisor,1,,8,1,6,22,30,0 days 00:00:00.139693
806,drogonframework/drogon,1,v,8,5,0,7,15,0 days 00:00:00.090560
807,tinacms/tinacms,66,@tinacms/next-tinacms-git@ @tinacms/icons@ react-tinacms-inline@ @tinacms/react-screens@ gatsby-tinacms-remark@ demo-gatsby@ react-tinacms@ @tinacms/api-git@ @tinacms/tinacms@ @tinacms/scripts@ gatsby-tinacms-teams@ next-tinacms-github@ @tinacms/datalayer@ demo-next@ @tinacms/sharedctx@ next-tinacms-markdown@ @tinacms/gatsby-plugin-tinacms@ @tinacms/react-tinacms@ @tinacms/gatsby-tinacms-git@ @tinacms/schema-tools@ react-dismissible@ @tinacms/webpack-helpers@ @tinacms/metrics@ @tinacms/cli@ @tinacms/starter@ @tinacms/react-sidebar@ @tinacms/alerts@ react-tinacms-github@ @tinacms/browser-storage-client@ @tinacms/react-alerts@ @tinacms/react-tinacms-remark@ @tinacms/core@ tina-tailwind-sidebar-demo@ @tinacms/toolkit@ gatsby-tinacms-git@ tina-cloud-starter@ gatsby-tinacms-json@ @tinacms/media@ @tinacms/react-toolbar@ gatsby-plugin-tinacms@ gatsby-tinacms-mdx@ react-tinacms-blocks@ react-tinacms-date@ @tinacms/react-forms@ @tinacms/fields@ nextjs-blog-starter@ @tinacms/gatsby-tinacms-json@ @tinacms/auth@ cms-scripts@ @tinacms/next-tinacms-markdown@ react-tinacms-editor@ @tinacms/react-core@ tinacms@ @tinacms/styles@ next-tinacms-cloudinary@ @tinacms/teams@ demo-cra@ next-tinacms-json@ v @tinacms/graphql@ create-tina-app@ @tinacms/git-client@ @tinacms/form-builder@ @tinacms/forms@ @tinacms/react-modals@ react-tinacms-strapi@,72,21,1,1089,1161,0 days 00:00:01.927428
808,sosedoff/pgweb,1,v,11,6,3,31,42,0 days 00:00:00.066582
809,dc-js/dc.js,4, mks_patch_v v temporary_filter_fix_v,26,12,9,63,89,0 days 00:00:00.209448
810,bigbluebutton/bigbluebutton,1,v,10,0,9,62,72,0 days 00:00:03.225728
811,sandboxie-plus/Sandboxie,2, v,11,3,4,58,69,0 days 00:00:00.120148
812,symfony/debug,1,v,16,2,13,354,370,0 days 00:00:00.333668
813,amplication/amplication,1,v,12,6,0,43,55,0 days 00:00:00.608078
814,JeffreySu/WeiXinMPSDK,2, v,4,1,2,40,44,0 days 00:00:00.775217
815,cerebroapp/cerebro,2, v,5,1,3,16,21,0 days 00:00:00.065469
816,primer/octicons,6, octicons_helper@ octicons@ octicons_gem@ jekyll-octicons@ v,59,31,9,47,106,0 days 00:00:00.329831
817,snowie2000/mactype,1,v,0,0,0,6,6,0 days 00:00:00.014728
818,TrinityCore/TrinityCore,1,TDB,74,41,22,6,80,0 days 00:00:02.471860
819,mysql/mysql-server,2,mysql-cluster- mysql-,6,1,4,559,565,0 days 00:00:10.838268
820,google/agera,1,v,4,0,3,0,4,0 days 00:00:00.208113
821,i18next/react-i18next,2, v,84,68,6,164,248,0 days 00:00:00.179330
822,winsw/winsw,1,v,21,6,12,10,31,0 days 00:00:00.052415
823,fideloper/TrustedProxy,1,,13,1,11,11,24,0 days 00:00:00.026569
824,davemorrissey/subsampling-scale-image-view,1,v,13,7,5,8,21,0 days 00:00:00.028406
825,aristocratos/btop,1,v,3,0,0,35,38,0 days 00:00:00.041852
826,styled-system/styled-system,2,styled-system@ v,14,6,2,90,104,0 days 00:00:00.155090
827,AlessandroZ/LaZagne,2, v,14,6,5,6,20,0 days 00:00:00.058798
828,FluentValidation/FluentValidation,1,,49,15,20,60,109,0 days 00:00:00.143294
829,apache/cassandra,1,cassandra-,23,8,13,183,206,0 days 00:00:01.705357
830,boto/boto3,1,,24,8,11,1045,1069,0 days 00:00:01.488200
831,hrydgard/ppsspp,1,v,20,3,14,46,66,0 days 00:00:01.648747
832,be5invis/Sarasa-Gothic,1,v,25,12,8,93,118,0 days 00:00:00.073155
833,zserge/lorca,1,v,1,0,0,10,11,0 days 00:00:00.017056
834,TeamVanced/VancedManager,2, v,11,7,0,8,19,0 days 00:00:00.129255
835,AppImage/AppImageKit,1,,13,4,8,0,13,0 days 00:00:00.114780
836,kedro-org/kedro,1,,5,0,4,26,31,0 days 00:00:00.121459
837,rocksdanister/lively,1,v,18,15,2,29,47,0 days 00:00:00.040276
838,gedoor/MyBookshelf,1,,0,0,0,172,172,0 days 00:00:00.329038
839,facebook/hermes,1,v,10,0,5,13,23,0 days 00:00:00.391140
840,flannel-io/flannel,1,v,18,0,11,18,36,0 days 00:00:00.079796
841,xo/usql,1,v,10,4,5,22,32,0 days 00:00:00.044776
842,terkelg/prompts,1,v,9,2,4,24,33,0 days 00:00:00.027268
843,sebastianbergmann/php-timer,1,,7,1,3,19,26,0 days 00:00:00.034013
844,hashicorp/terraform-provider-aws,1,v,226,223,1,33,259,0 days 00:00:03.068190
845,beefproject/beef,2,beef- v,1,0,0,32,33,0 days 00:00:00.189902
846,evilsocket/opensnitch,1,v,4,1,2,7,11,0 days 00:00:00.068446
847,cjbassi/gotop,1,,9,5,1,24,33,0 days 00:00:00.035271
848,MichalLytek/type-graphql,1,v,19,13,1,18,37,0 days 00:00:00.051813
849,smartystreets/goconvey,2, v,7,3,3,20,27,0 days 00:00:00.063344
850,styled-components/polished,2,v. v,22,12,6,56,78,0 days 00:00:00.067515
851,pennersr/django-allauth,1,,42,13,18,13,55,0 days 00:00:00.329306
852,ngrx/platform,2, v,35,19,5,25,60,0 days 00:00:00.100770
853,pytube/pytube,2, v,31,18,9,78,109,0 days 00:00:00.181130
854,nopSolutions/nopCommerce,1,release-,29,4,20,6,35,0 days 00:00:00.834035
855,fancyapps/fancybox,3, v V,5,1,3,30,35,0 days 00:00:00.032915
856,sveltejs/sapper,1,v,29,23,4,149,178,0 days 00:00:00.139104
857,rui314/mold,1,v,5,0,1,13,18,0 days 00:00:00.171348
858,inorganik/countUp.js,2, v,13,3,8,26,39,0 days 00:00:00.035780
859,i3/i3,3, tree-pr AnyEvent-,40,9,25,22,62,0 days 00:00:00.538225
860,graphql-python/graphene,2,v. v,16,7,5,29,45,0 days 00:00:00.100414
861,chrisvfritz/prerender-spa-plugin,2, v,10,4,3,1,11,0 days 00:00:00.018261
862,angular/angularfire,2, v,11,2,5,28,39,0 days 00:00:00.077794
863,barteksc/AndroidPdfViewer,1,,14,8,1,8,22,0 days 00:00:00.017182
864,ArduPilot/ardupilot,26,phoenix-good-thermal- ArduSub- Plane- AP_Periph- AntennaTracker- AC_ ft solo- APMrover2- test-tag yuma-may yuma-may-flight ArduCopter-stable-apm ArduPlane- AION-Orca-Alpha Copter- V kraus/LastFlights_ CanberraUAV-OBC- ArduCopter- ArduCopter-beta-apm cellular-modem- test-release v Rover- -,59,23,25,254,313,0 days 00:00:03.871404
865,OWASP/Amass,2, v,37,25,6,123,160,0 days 00:00:00.142972
866,alibaba/otter,2,v otter-,0,0,0,10,10,0 days 00:00:00.019416
867,Jackett/Jackett,1,v,5,3,0,1800,1805,0 days 00:00:06.613296
868,jpillora/chisel,2, v,8,2,4,21,29,0 days 00:00:00.023818
869,FormidableLabs/urql,20,@urql/exchange-graphcache@ @urql/storybook-addon@ urql@ @urql/exchange-multipart-fetch@ @urql/exchange-auth@ @urql/exchange-refocus@ @urql/exchange-retry@ next-urql@ @urql/vue@ @urql/storage-rn@ @urql/exchange-execute@ @urql/exchange-populate@ @urql/exchange-request-policy@ @urql/introspection@ @urql/svelte@ @urql/preact@ @urql/exchange-suspense@ @urql/exchange-persisted-fetch@ v @urql/core@,39,7,4,352,391,0 days 00:00:00.414708
870,lz4/lz4,2,r v,18,11,2,11,29,0 days 00:00:00.119432
871,OpenVPN/openvpn,1,v,5,0,4,43,48,0 days 00:00:00.237004
872,symfony/routing,1,v,26,2,21,441,467,0 days 00:00:00.393629
873,mps-youtube/mps-youtube,1,v,1,0,0,26,27,0 days 00:00:00.091599
874,offensive-security/exploitdb,0,,0,0,0,0,0,0 days 00:00:00.370410
875,java-native-access/jna,2, v,26,3,18,32,58,0 days 00:00:00.223439
876,lbryio/lbry-sdk,5,test-release- test-appveyor-deployment- test-daemon-release- v v.,102,84,7,152,254,0 days 00:00:00.681147
877,leeoniya/uPlot,1,,7,3,1,44,51,0 days 00:00:00.071794
878,marionettejs/backbone.marionette,1,v,32,14,10,93,125,0 days 00:00:00.200428
879,tektoncd/pipeline,2, v,35,31,0,55,90,0 days 00:00:00.470483
880,fail2ban/fail2ban,5, sdist/ debian/python debian/PREPATCH_TO_UPSTREAM_ upstream/,10,0,7,110,120,0 days 00:00:00.498372
881,es-shims/es5-shim,1,v,19,8,7,77,96,0 days 00:00:00.076182
882,predis/predis,1,v,6,0,5,31,37,0 days 00:00:00.128535
883,ImageMagick/ImageMagick,1,,0,0,0,1,1,0 days 00:00:00.669895
884,kekingcn/kkFileView,2, v,5,1,2,5,10,0 days 00:00:00.025682
885,tenacityteam/tenacity,1,Audacity-,6,0,5,13,19,0 days 00:00:00.791193
886,Zettlr/Zettlr,3, v. v,28,14,6,49,77,0 days 00:00:00.298588
887,webmozarts/assert,1,,11,0,7,3,14,0 days 00:00:00.020858
888,sebastianbergmann/diff,1,,7,1,5,11,18,0 days 00:00:00.112629
889,minetest/minetest,2, sapier-,10,1,7,28,38,0 days 00:00:00.583021
890,vaexio/vaex,16, meta-v core-v hdf5-v contrib-v astro-v ml-v graphql-v server-v arrow-v distributed-v viz-v v jupyter-v vaexpaper_v ui-v,41,14,12,177,218,0 days 00:00:00.351534
891,pillarjs/path-to-regexp,2, v,24,9,11,28,52,0 days 00:00:00.033169
892,earthly/earthly,2,vscode-syntax-highlighting-v v,6,1,3,79,85,0 days 00:00:00.112254
893,metafizzy/flickity,1,v,10,3,6,24,34,0 days 00:00:00.039567
894,AmruthPillai/Reactive-Resume,1,v,7,4,2,24,31,0 days 00:00:00.167027
895,surmon-china/vue-quill-editor,1,v,6,2,2,21,27,0 days 00:00:00.019057
896,dexidp/dex,2,v api/v,38,15,9,25,63,0 days 00:00:00.151381
897,nodemcu/nodemcu-firmware,3, dev dev_json_,4,3,0,1,5,0 days 00:00:00.039817
898,vercel/styled-jsx,2, v,15,5,8,78,93,0 days 00:00:00.051492
899,yhirose/cpp-httplib,1,v,9,3,5,75,84,0 days 00:00:00.077813
900,musescore/MuseScore,1,v,11,1,9,24,35,0 days 00:00:01.209753
901,ljharb/qs,1,v,25,11,10,49,74,0 days 00:00:00.068816
902,checkstyle/checkstyle,2,checkstyle- release,108,76,19,29,137,0 days 00:00:00.804153
903,laravel/tinker,1,v,9,3,4,17,26,0 days 00:00:00.024817
904,google/android-classyshark,1,,15,9,3,0,15,0 days 00:00:00.037757
905,readthedocs/readthedocs.org,1,,76,55,5,152,228,0 days 00:00:01.219241
906,terser/terser,3, harmony-v v,49,20,12,318,367,0 days 00:00:00.445996
907,RT-Thread/rt-thread,1,v,7,0,6,21,28,0 days 00:00:00.823215
908,mindsdb/mindsdb,3, v. v,48,44,0,71,119,0 days 00:00:00.457863
909,jazzband/django-debug-toolbar,2, v,25,4,15,24,49,0 days 00:00:00.137961
910,gitkraken/vscode-gitlens,2, v,45,33,4,91,136,0 days 00:00:00.207501
911,symfony/css-selector,1,v,26,4,19,434,460,0 days 00:00:00.327984
912,jemalloc/jemalloc,1,,22,4,14,24,46,0 days 00:00:00.185793
913,smallnest/rpcx,1,v,3,0,1,22,25,0 days 00:00:00.066823
914,sebastianbergmann/php-file-iterator,1,,7,1,5,27,34,0 days 00:00:00.033095
915,prometheus-operator/prometheus-operator,3,pkg/apis/monitoring/v pkg/client/v v,56,37,0,97,153,0 days 00:00:00.332805
916,raineorshine/npm-check-updates,2, v,56,34,11,194,250,0 days 00:00:00.280546
917,symfony/process,1,v,26,4,20,450,476,0 days 00:00:00.471020
918,cython/cython,1,,19,0,16,71,90,0 days 00:00:00.810131
919,mqttjs/MQTT.js,2, v,42,22,7,109,151,0 days 00:00:00.114327
920,phar-io/version,1,,5,0,4,8,13,0 days 00:00:00.018193
921,encode/starlette,1,,19,8,5,94,113,0 days 00:00:00.276045
922,wallabag/wallabag,1,,20,6,10,40,60,0 days 00:00:00.428032
923,OlafenwaMoses/ImageAI,5, essential-v essentials-v models-v v,8,2,2,6,14,0 days 00:00:00.027260
924,ThreeMammals/Ocelot,1,,31,19,6,110,141,0 days 00:00:00.226107
925,tensorlayer/TensorLayer,2, v,13,0,6,52,65,0 days 00:00:00.307967
926,cloudflare/cfssl,2, v,7,0,6,6,13,0 days 00:00:00.079500
927,developit/microbundle,2, v,15,7,6,24,39,0 days 00:00:00.059851
928,kivy/python-for-android,2, v,2,0,1,10,12,0 days 00:00:00.195519
929,deepstreamIO/deepstream.io,2, v,25,7,8,98,123,0 days 00:00:00.129198
930,swagger-api/swagger-core,2,v swagger-project-,7,0,6,58,65,0 days 00:00:00.220291
931,Turfjs/turf,2, v,23,15,5,65,88,0 days 00:00:00.199534
932,xmrig/xmrig,1,v,46,34,7,73,119,0 days 00:00:00.177813
933,Qihoo360/RePlugin,1,v,3,0,1,14,17,0 days 00:00:00.036711
934,fission/fission,5, alpha buildmgr-preview- nightly v,32,9,7,30,62,0 days 00:00:00.205336
935,monero-project/monero,1,v,19,8,7,34,53,0 days 00:00:00.734428
936,sebastianbergmann/php-text-template,1,,4,0,3,9,13,0 days 00:00:00.017235
937,DevinVinson/WordPress-Plugin-Boilerplate,1,,9,5,2,5,14,0 days 00:00:00.031495
938,fullstorydev/grpcurl,1,v,9,0,5,11,20,0 days 00:00:00.019796
939,json-path/JsonPath,3, json-path-parent- json-path-,14,3,10,9,23,0 days 00:00:00.061579
940,FullHuman/purgecss,2, v,23,11,7,20,43,0 days 00:00:00.083261
941,dotansimha/graphql-yoga,10, @graphql-yoga/subscription@ @graphql-yoga/render-graphiql@ @graphql-yoga/common@ @graphql-yoga/core@ graphql-yoga@ @graphql-yoga/graphiql@ @graphql-yoga/handler@ v @graphql-yoga/node@,39,25,3,136,175,0 days 00:00:00.126468
942,robotframework/robotframework,2, v,13,0,12,49,62,0 days 00:00:00.715625
943,Jigsaw-Code/outline-client,9,android- windows- macos-v linux-v ios-v windows-v android-v ios-test-xcode daily-travisintegrationtest,10,0,4,126,136,0 days 00:00:00.142948
944,final-form/react-final-form,2,v. v,23,16,3,47,70,0 days 00:00:00.051410
945,reach/router,1,v,5,2,2,13,18,0 days 00:00:00.026591
946,jsplumb/jsplumb,1,,28,5,18,188,216,0 days 00:00:00.548012
947,google/trax,1,v,3,0,2,15,18,0 days 00:00:00.088884
948,projectstorm/react-diagrams,2, v,16,6,6,23,39,0 days 00:00:00.059517
949,symfony/var-dumper,1,v,20,4,15,355,375,0 days 00:00:00.351907
950,matthew-andrews/isomorphic-fetch,1,v,12,7,3,14,26,0 days 00:00:00.020314
951,fsnotify/fsnotify,1,v,7,0,5,31,38,0 days 00:00:00.035645
952,uber/RIBs,2, v,5,0,3,9,14,0 days 00:00:00.037460
953,aws/aws-sdk-js,1,v,1089,1078,5,301,1390,0 days 00:00:02.421936
954,reactjs/react-modal,1,v,19,7,6,91,110,0 days 00:00:00.061822
955,gophish/gophish,2, v,11,0,10,4,15,0 days 00:00:00.048034
956,PyMySQL/PyMySQL,3, pymysql- v,9,0,8,32,41,0 days 00:00:00.065972
957,orbitdb/orbit-db,3, v dc,7,1,4,12,19,0 days 00:00:00.078583
958,google/re2,0,,0,0,0,0,0,0 days 00:00:00.019125
959,jsfiddle/togetherjs,2, v,1,0,0,12,13,0 days 00:00:00.228503
960,spyder-ide/spyder,1,v,16,0,15,79,95,0 days 00:00:01.500798
961,reactiveui/ReactiveUI,2, v,41,21,7,181,222,0 days 00:00:00.807049
962,ffuf/ffuf,1,v,18,8,5,6,24,0 days 00:00:00.028255
963,airbytehq/airbyte,1,v,2,0,0,2,4,0 days 00:00:00.226837
964,lowlighter/metrics,1,v,44,40,0,0,44,0 days 00:00:00.134427
965,visualfc/liteide,2,x X,64,38,15,2,66,0 days 00:00:00.138308
966,rr-debugger/rr,1,,28,9,14,6,34,0 days 00:00:00.384503
967,faisalman/ua-parser-js,2, v,6,0,3,44,50,0 days 00:00:00.061058
968,daybrush/moveable,11, ngx-moveable@ moveable@ vue3-moveable@ preact-moveable@ moveable-storybook@ lit-moveable@ svelte-moveable@ ngx-moveable-app@ react-compat-moveable@ react-moveable@,23,15,4,117,140,0 days 00:00:00.094300
969,abel533/Mapper,1,,18,9,4,33,51,0 days 00:00:00.060486
970,sundowndev/phoneinfoga,1,v,4,0,3,29,33,0 days 00:00:00.229517
971,fluxcd/flux,4, chart- helm- v,42,16,8,124,166,0 days 00:00:00.316431
972,trentm/node-bunyan,1,,33,18,7,81,114,0 days 00:00:00.070428
973,cosmtrek/air,1,v,5,1,2,18,23,0 days 00:00:00.025288
974,kennethreitz/records,1,v,5,3,1,6,11,0 days 00:00:00.026034
975,verlok/vanilla-lazyload,2, v,81,56,15,77,158,0 days 00:00:00.129887
976,cockpit-project/cockpit,2, v,314,303,7,1,315,0 days 00:00:01.282059
977,taskflow/taskflow,1,v,13,3,8,1,14,0 days 00:00:00.104267
978,transmission/transmission,1,,99,69,12,1,100,0 days 00:00:00.771651
979,laramies/theHarvester,3, v V,5,0,4,11,16,0 days 00:00:00.146505
980,Humanizr/Humanizer,3, v V,16,9,4,49,65,0 days 00:00:00.144053
981,spring-projects/spring-security,1,,6,0,5,35,41,0 days 00:00:00.719623
982,brunch/brunch,1,,24,11,8,107,131,0 days 00:00:00.178237
983,gperftools/gperftools,3,gperftools- perftools- google-perftools-,38,16,17,27,65,0 days 00:00:00.065822
984,bigskysoftware/htmx,2, v,12,6,1,18,30,0 days 00:00:00.095692
985,microsoft/botframework-sdk,6, NugGet v botbuilder@ NuGet Nuget,32,14,4,67,99,0 days 00:00:00.180055
986,olivere/elastic,1,v,8,1,6,317,325,0 days 00:00:00.356875
987,monkeytypegame/monkeytype,1,v,16,6,1,111,127,0 days 00:00:00.503329
988,guess-js/guess,2, v,4,1,2,42,46,0 days 00:00:00.045768
989,microsoft/DeepSpeed,1,v,6,1,3,36,42,0 days 00:00:00.076938
990,Nuitka/Nuitka,1,,13,8,4,238,251,0 days 00:00:00.648845
991,Sylius/Sylius,1,v,30,4,17,151,181,0 days 00:00:01.757514
992,isl-org/Open3D,1,v,15,0,7,5,20,0 days 00:00:00.297080
993,microsoft/azuredatastudio,2, v,40,28,2,89,129,0 days 00:00:00.744110
994,barry-ran/QtScrcpy,1,v,9,3,3,15,24,0 days 00:00:00.048170
995,juice-shop/juice-shop,2, v,91,67,8,101,192,0 days 00:00:01.166536
996,debezium/debezium,1,v,7,0,3,21,28,0 days 00:00:00.112592
997,gobuffalo/buffalo,2, v,15,3,9,107,122,0 days 00:00:00.203123
998,IvanGoncharov/graphql-voyager,0,,0,0,0,0,0,0 days 00:00:00.014048
999,filamentgroup/loadCSS,2, v,9,2,6,14,23,0 days 00:00:00.028741
1000,ajenti/ajenti,2, v,5,2,2,123,128,0 days 00:00:00.192463
1001,DylanVann/react-native-fast-image,1,v,20,8,7,90,110,0 days 00:00:00.064431
1002,ds300/patch-package,1,v,17,9,3,40,57,0 days 00:00:00.047305
1003,SonarSource/sonarqube,2, latest-silver-master-#,63,13,11,74,137,0 days 00:00:01.891574
1004,AaronFeng753/Waifu2x-Extension-GUI,1,v,6,5,0,70,76,0 days 00:00:00.141325
1005,vercel/ncc,1,,31,21,4,46,77,0 days 00:00:00.054902
1006,microsoft/fast,65, @microsoft/fast-figma-plugin-msft@ @microsoft/fast-animation_v @microsoft/fast-foundation_v @microsoft/fast-jss-manager-react@ @microsoft/fast-components-react-msft@ @microsoft/fast-color-explorer@ @microsoft/fast-tslint-rules@ fast-website@ @microsoft/fast-components-msft@ @microsoft/fast-colors_v @microsoft/eslint-config-fast-dna_v fast-site@ @microsoft/fast-tooling@ @microsoft/fast-breakpoint-tracker-react@ @microsoft/fast-jest-snapshots-react@ @microsoft/fast-tooling-react_v @microsoft/fast-components-styles-msft@ @microsoft/fast-jss-utilities@ @microsoft/fast-data-utilities-react@ @microsoft/fast-colors@ @microsoft/fast-development-site-react@ @microsoft/fast-navigation-generator-react@ @microsoft/fast-router_v @microsoft/fast-router@ @microsoft/fast-component-explorer@ @microsoft/fast-glyphs-msft@ @fluentui/web-components@ @microsoft/fast-element_v @microsoft/fast-css-editor-react@ @microsoft/fast-react-wrapper_v @microsoft/fast-storybook-presets@ @microsoft/fast-components-class-name-contracts-base@ @microsoft/fast-web-utilities@ @microsoft/fast-permutator@ @microsoft/site-utilities@ @microsoft/fast-tooling-examples@ @microsoft/fast-components_v @microsoft/eslint-config-fast-dna@ @microsoft/fast-foundation@ @microsoft/fast-components-class-name-contracts-msft@ @microsoft/fast-creator@ @microsoft/fast-components@ @microsoft/fast-markdown-msft-react@ @microsoft/fast-viewer-react@ @microsoft/fast-storybook-design-system-addon@ @microsoft/fast-components-react-base@ @microsoft/fast-tooling_v @microsoft/fast-web-utilities_v @microsoft/fast-tooling-react@ @microsoft/fast-tooling-wasm@ @microsoft/fast-animation@ @microsoft/fast-browser-extensions@ @microsoft/fast-sketch-library@ @microsoft/fast-layouts-react@ @microsoft/fast-components-foundation-react@ @microsoft/fast-jss-manager@ @microsoft/fast-jss-manager-angular@ @microsoft/fast-element@ @microsoft/fast-react-utilities@ v @microsoft/fast-form-generator-react@ fast-tagged-templates_v @microsoft/fast-website@ @microsoft/fast-application-utilities@,172,31,2,2307,2479,0 days 00:00:07.736774
1007,BloodHoundAD/BloodHound,2, v,12,0,10,20,32,0 days 00:00:00.075637
1008,ssssssss-team/spider-flow,1,v,5,3,1,6,11,0 days 00:00:00.031836
1009,shoelace-style/shoelace,0,,0,0,0,0,0,0 days 00:00:00.026841
1010,microsoft/onnxruntime,2,v orttraining_rc,17,2,6,17,34,0 days 00:00:00.600880
1011,bup/bup,2, bup-,32,19,8,6,38,0 days 00:00:00.213564
1012,Jermolene/TiddlyWiki5,1,v,2,0,1,26,28,0 days 00:00:00.609732
1013,kkroening/ffmpeg-python,2, v,1,0,0,12,13,0 days 00:00:00.032782
1014,needim/noty,1,v,10,2,5,37,47,0 days 00:00:00.034973
1015,distribution/distribution,1,v,9,0,6,11,20,0 days 00:00:00.299891
1016,cssinjs/jss,2, v,60,41,8,86,146,0 days 00:00:00.144382
1017,fontello/fontello,1,,11,0,8,7,18,0 days 00:00:00.114078
1018,whyour/qinglong,1,v,5,0,1,14,19,0 days 00:00:00.093837
1019,rsuite/rsuite,3, v github-actions.,38,19,5,114,152,0 days 00:00:00.301071
1020,twpayne/chezmoi,1,v,27,16,4,106,133,0 days 00:00:00.232389
1021,mongodb/mongo-go-driver,2, v,13,4,7,60,73,0 days 00:00:00.138324
1022,tgalal/yowsup,1,v,8,3,4,20,28,0 days 00:00:00.118354
1023,jupyterhub/jupyterhub,1,,19,2,11,20,39,0 days 00:00:00.322741
1024,SigNoz/signoz,2, v,7,1,2,28,35,0 days 00:00:00.084773
1025,lucas-clemente/quic-go,2,v. v,24,5,10,33,57,0 days 00:00:00.302033
1026,noisetorch/NoiseTorch,1,,3,0,1,10,13,0 days 00:00:00.033051
1027,microsoft/mimalloc,3,win-m v M,11,5,2,28,39,0 days 00:00:00.259623
1028,alibaba/MNN,1,,13,9,3,36,49,0 days 00:00:00.140471
1029,kazupon/vue-i18n,1,v,64,37,7,83,147,0 days 00:00:00.131303
1030,NLPchina/elasticsearch-sql,1,,46,21,13,144,190,0 days 00:00:00.175630
1031,infracost/infracost,2, v,10,6,3,62,72,0 days 00:00:00.202924
1032,SirVer/ultisnips,1,,11,2,7,0,11,0 days 00:00:00.117500
1033,skypjack/entt,2,cpp v,22,7,9,17,39,0 days 00:00:00.191388
1034,serverless-stack/serverless-stack,10,@serverless-stack/docs@ create-sst@ @serverless-stack/static-site-env@ @serverless-stack/core@ @serverless-stack/cli@ @serverless-stack/web@ v @serverless-stack/console@ @serverless-stack/resources@ @serverless-stack/node@,72,69,1,309,381,0 days 00:00:00.309433
1035,k9mail/k-9,2, build_,430,393,11,1,431,0 days 00:00:00.994663
1036,Vincit/objection.js,1,,19,3,10,101,120,0 days 00:00:00.136453
1037,ActivityWatch/activitywatch,1,v,8,4,3,11,19,0 days 00:00:00.047854
1038,open-policy-agent/opa,1,v,40,22,6,80,120,0 days 00:00:00.367663
1039,eclipse/che,1,,100,95,2,126,226,0 days 00:00:00.753906
1040,wildfirechat/im-server,1,,72,68,0,1,73,0 days 00:00:00.109683
1041,PCSX2/pcsx2,1,v,4,0,3,831,835,0 days 00:00:01.976348
1042,Laravel-Lang/lang,1,,20,12,6,174,194,0 days 00:00:00.385017
1043,kanboard/kanboard,1,v,3,1,1,71,74,0 days 00:00:00.338743
1044,great-expectations/great_expectations,3, v O.,16,3,8,139,155,0 days 00:00:00.669481
1045,lcobucci/jwt,1,,11,3,6,34,45,0 days 00:00:00.087153
1046,sindresorhus/fkill-cli,2, v,23,9,10,3,26,0 days 00:00:00.018171
1047,OctoPrint/OctoPrint,1,,9,0,7,42,51,0 days 00:00:00.417298
1048,aheckmann/gm,2, v,31,13,12,35,66,0 days 00:00:00.147387
1049,libvips/libvips,1,v,11,0,9,41,52,0 days 00:00:00.486581
1050,ElemeFE/v-charts,1,v,14,9,2,72,86,0 days 00:00:00.049411
1051,BoyceLig/Clash_Chinese_Patch,1,,7,1,3,57,64,0 days 00:00:00.031451
1052,schollz/howmanypeoplearearound,1,v,4,2,1,11,15,0 days 00:00:00.017768
1053,sindresorhus/np,1,v,42,24,10,34,76,0 days 00:00:00.046915
1054,ipfs/js-ipfs,59, ipfs-v ipfs-core-v example-js-ipfs-in-electron@ ipfs-http-gateway@ ipfs-http-client-v ipfs-core@ ipfs-message-port-client@ ipfs-cli-v ipfs-grpc-protocol@ example-browser-vue@ ipfs-message-port-server@ ipfs-core-config@ ipfs-http-response@ example-browser-script-tag@ example-running-multiple-nodes@ example-browser-create-react-app@ interface-ipfs-core@ ipfs-message-port-protocol@ example-traverse-ipld-graphs@ ipfs-daemon-v ipfs-core-types-v example-explore-ethereum-blockchain@ ipfs-core-config-v example-exchange-files-in-browser@ ipfs-grpc-client@ ipfs-message-port-client-v example-browser-parceljs@ ipfs-core-types@ ipfs-client@ ipfs-grpc-client-v example-browser-browserify@ example-circuit-relaying@ ipfs-grpc-server-v ipfs@ ipfs-core-utils-v example-custom-libp2p@ ipfs-http-response-v ipfs-http-client@ example-browser-video-streaming@ example-custom-ipfs-repo@ example-browser-mfs@ ipfs-core-utils@ ipfs-grpc-server@ example-browser-add-readable-stream@ ipfs-message-port-protocol-v ipfs-client-v example-browser-readablestream@ ipfs-cli@ ipfs-daemon@ interface-ipfs-core-v ipfs-http-server-v v test-ipfs-example@ ipfs-message-port-server-v example-ipfs-101@ example-browser-webpack@ ipfs-http-server@ ipfs-http-gateway-v,256,177,7,1038,1294,0 days 00:00:02.043581
1055,Rob--W/cors-anywhere,2, v,3,1,1,18,21,0 days 00:00:00.021352
1056,grpc/grpc-web,1,,7,4,2,9,16,0 days 00:00:00.060284
1057,sebastianbergmann/comparator,1,,7,0,6,21,28,0 days 00:00:00.023303
1058,kornia/kornia,2, v,6,0,5,27,33,0 days 00:00:00.127881
1059,gregberge/loadable-components,1,v,30,19,6,35,65,0 days 00:00:00.044934
1060,xojs/xo,1,v,43,24,8,43,86,0 days 00:00:00.068282
1061,yanzhenjie/AndPermission,1,,2,0,1,13,15,0 days 00:00:00.023407
1062,nextui-org/nextui,0,,0,0,0,0,0,0 days 00:00:00.018933
1063,hugapi/hug,1,,18,11,5,44,62,0 days 00:00:00.283802
1064,Tencent/Hippy,2, qb-androidx-,14,6,1,66,80,0 days 00:00:00.092532
1065,JetBrains/ideavim,2, EAP-,43,22,15,4,47,0 days 00:00:00.215415
1066,visgl/react-map-gl,2, v,22,10,9,143,165,0 days 00:00:00.141692
1067,pymc-devs/pymc,1,v,11,0,9,9,20,0 days 00:00:00.378291
1068,Hacker0x01/react-datepicker,2, v,107,85,2,73,180,0 days 00:00:00.257597
1069,electron/fiddle,2, v,29,14,3,22,51,0 days 00:00:00.103594
1070,shidenggui/easytrader,1,,2,0,0,11,13,0 days 00:00:00.031014
1071,janeczku/calibre-web,1,,1,0,0,17,18,0 days 00:00:00.180845
1072,enquirer/enquirer,1,,6,3,2,27,33,0 days 00:00:00.034781
1073,QUANTAXIS/QUANTAXIS,2, V,15,4,5,44,59,0 days 00:00:00.359208
1074,flyway/flyway,1,flyway-,40,20,13,101,141,0 days 00:00:00.271277
1075,migueldeicaza/gui.cs,1,v,13,6,4,9,22,0 days 00:00:00.167546
1076,php-fig/http-message,1,,12,8,0,5,17,0 days 00:00:00.017784
1077,wailsapp/wails,1,v,19,10,2,44,63,0 days 00:00:00.263200
1078,google/auto,5,auto-common- auto-service- auto-parent- auto-factory- auto-value-,26,2,18,28,54,0 days 00:00:00.098346
1079,yargs/yargs,3, v yargs-v,88,62,11,95,183,0 days 00:00:00.277356
1080,jaredpalmer/tsdx,1,v,13,6,3,40,53,0 days 00:00:00.056289
1081,grpc/grpc-java,1,v,52,22,4,58,110,0 days 00:00:00.423723
1082,iterative/dvc,1,,92,83,3,258,350,0 days 00:00:00.579204
1083,unoplatform/uno,3, hr-pre v,23,10,3,27,50,0 days 00:00:00.981858
1084,Netflix/pollyjs,14,@pollyjs/persister@ @pollyjs/utils@ @pollyjs/ember@ @pollyjs/persister-local-storage@ @pollyjs/adapter-xhr@ @pollyjs/cli@ @pollyjs/persister-rest@ @pollyjs/persister-fs@ @pollyjs/node-server@ @pollyjs/adapter@ v @pollyjs/adapter-fetch@ @pollyjs/core@ @pollyjs/adapter-puppeteer@,26,14,4,127,153,0 days 00:00:00.069726
1085,raysan5/raylib,1,,13,0,11,4,17,0 days 00:00:00.268573
1086,matthieua/WOW,1,,3,0,2,26,29,0 days 00:00:00.023508
1087,catboost/catboost,3, v. v,25,7,3,57,82,0 days 00:00:01.449171
1088,dmlc/dgl,2, v,7,0,6,15,22,0 days 00:00:00.153880
1089,barbajs/barba,5, @barba/prefetch@ @barba/core@ @barba/css@ @barba/router@,10,2,1,74,84,0 days 00:00:00.067705
1090,dbader/schedule,1,,7,0,5,17,24,0 days 00:00:00.035252
1091,wasabeef/glide-transformations,1,,9,3,5,10,19,0 days 00:00:00.024065
1092,botpress/botpress,2, v,88,76,4,234,322,0 days 00:00:00.804087
1093,stylelint/stylelint,2, v,97,78,4,88,185,0 days 00:00:00.499911
1094,josdejong/jsoneditor,1,v,71,48,11,125,196,0 days 00:00:00.192184
1095,JakeWharton/timber,2, timber-parent-,21,8,10,16,37,0 days 00:00:00.043266
1096,haiwen/seafile,10, client- HorizonBase- Horizonbase- pafile- lianyou- server- v datadupe- mac-v,19,1,11,113,132,0 days 00:00:00.143365
1097,square/javapoet,2,javapoet- javawriter-,20,3,9,16,36,0 days 00:00:00.055276
1098,svgdotjs/svg.js,1,,50,38,8,48,98,0 days 00:00:00.126159
1099,libretro/RetroArch,2, v,15,3,7,77,92,0 days 00:00:03.285807
1100,languagetool-org/languagetool,2,v languagetool-parent-,35,0,34,11,46,0 days 00:00:02.699055
1101,react-native-camera/react-native-camera,1,v,84,69,5,96,180,0 days 00:00:00.145353
1102,FormidableLabs/victory,1,v,65,43,8,156,221,0 days 00:00:00.480640
1103,snapappointments/bootstrap-select,2, v,13,3,7,52,65,0 days 00:00:00.092854
1104,scipy/scipy,1,v,27,0,26,45,72,0 days 00:00:01.482310
1105,acidanthera/OpenCorePkg,1,,4,0,3,31,35,0 days 00:00:00.283491
1106,lvgl/lvgl,2, v,26,10,7,20,46,0 days 00:00:00.644745
1107,zealdocs/zeal,1,v,6,0,4,4,10,0 days 00:00:00.064257
1108,TranslucentTB/TranslucentTB,1,,14,7,6,0,14,0 days 00:00:00.075599
1109,zaproxy/zaproxy,3, svn_ v,16,1,13,18,34,0 days 00:00:00.808624
1110,apache/arrow,5,apache-arrow-js- apache-arrow- go/parquet/v go/v go/arrow/v,25,3,16,20,45,0 days 00:00:00.922016
1111,mdbootstrap/material-design-for-bootstrap,1,,18,11,5,46,64,0 days 00:00:00.031044
1112,jhy/jsoup,2, jsoup-,1,0,0,39,40,0 days 00:00:00.104288
1113,wix/Detox,5, detox@ detox-server@ v detox-cli@,117,101,6,275,392,0 days 00:00:00.522505
1114,addyosmani/critical,2, v,17,4,9,44,61,0 days 00:00:00.211297
1115,clojure/clojure,2, clojure-,12,0,11,6,18,0 days 00:00:00.345316
1116,pockethub/PocketHub,2, v,11,5,3,9,20,0 days 00:00:00.149847
1117,mwaskom/seaborn,1,v,11,0,8,9,20,0 days 00:00:00.148017
1118,sindresorhus/pageres,2, v,24,8,7,23,47,0 days 00:00:00.041939
1119,mongodb/node-mongodb-native,3,v. v V,25,4,18,387,412,0 days 00:00:00.734992
1120,senchalabs/connect,1,,52,27,11,174,226,0 days 00:00:00.308504
1121,meliorence/react-native-snap-carousel,2,v V,22,15,2,29,51,0 days 00:00:00.036507
1122,TarsCloud/Tars,2, v,15,6,4,32,47,0 days 00:00:00.059523
1123,matrix-org/synapse,9, hhs- 2017-05- 2017-06- dinsic_2018-07- dinsic_2019-06- v dinsic_2019-04- shhs-v,115,88,11,136,251,0 days 00:00:01.467004
1124,vuestorefront/vue-storefront,14,@vue-storefront/theme-starter@ @vue-storefront/i18n@ @vue-storefront/core@ @vue-storefront/extension-droppoint-shipping@ @vue-storefront/extension-payment-backend-methods@ @vue-storefront/theme-default@ @vue-storefront/store@ @vue-storefront/extension-mailchimp-subscribe@ v @vue-storefront/extension-template@ cms@ @vue-storefront/extension-payment-cash-on-delivery@ @vue-storefront/extension-magento2-cms@ @vue-storefront/extension-google-analytics@,15,8,5,62,77,0 days 00:00:00.697825
1125,adobe/react-spectrum,148, @spectrum-icons/illustrations@ @react-stately/overlays@ @react-spectrum/switch@ @react-spectrum/slider@ @react-aria/separator@ @react-aria/grid@ @react-spectrum/layout@ @react-spectrum/numberfield@ @react-stately/tabs@ @react-spectrum/utils@ @react-stately/toggle@ @react-stately/table@ @react-spectrum/divider@ @react-spectrum/actiongroup@ @react-aria/aria-modal-polyfill@ @react-types/tabs@ @react-spectrum/image@ @react-spectrum/picker@ @react-aria/numberfield@ @react-aria/interactions@ @react-spectrum/icon@ @react-spectrum/theme-dark@ @react-spectrum/checkbox@ @spectrum-icons/ui@ @react-aria/button@ @react-types/grid@ @react-aria/label@ @react-stately/utils@ react-aria@ @react-spectrum/view@ @react-aria/meter@ @react-spectrum/illustratedmessage@ @react-spectrum/theme-default@ v @react-types/view@ @react-stately/tooltip@ @react/react-spectrum@ @react-types/dialog@ @react-aria/utils@ @react-types/shared@ @react-spectrum/searchfield@ @react-spectrum/combobox@ @adobe/react-spectrum@ @react-aria/radio@ @react-aria/link@ @react-types/progress@ @react-types/meter@ @react-aria/visually-hidden@ @react-aria/ssr@ @react-stately/selection@ @react-spectrum/statuslight@ @react-spectrum/radio@ @react-stately/combobox@ @react-spectrum/listbox@ @react-spectrum/overlays@ @react-types/statuslight@ @react-aria/live-announcer@ @react-spectrum/link@ @react-spectrum/dialog@ @react-spectrum/form@ @react-types/tooltip@ @react-types/numberfield@ @react-aria/select@ @react-types/provider@ @react-stately/grid@ @react-aria/dialog@ @react-aria/tabs@ @react-types/table@ @react-types/slider@ @react-types/image@ @react-aria/textfield@ @react-types/actiongroup@ @react-stately/virtualizer@ @react-types/well@ @internationalized/message@ @react-aria/menu@ @react-aria/breadcrumbs@ @react-aria/progress@ @react-aria/toggle@ @react-types/contextualhelp@ @react-aria/overlays@ @react-stately/layout@ @react-stately/collections@ @react-types/overlays@ @react-types/illustratedmessage@ @react-spectrum/menu@ @react-spectrum/meter@ @react-spectrum/tabs@ @react-stately/select@ @react-types/layout@ @react-types/link@ @react-types/radio@ @react-stately/radio@ @react-aria/focus@ @spectrum-icons/color@ @react-aria/table@ @react-aria/checkbox@ @react-aria/switch@ @react-types/select@ @react-stately/tree@ @react-aria/i18n@ @react-types/divider@ @react-stately/slider@ @react-types/breadcrumbs@ @react-spectrum/tooltip@ @react-types/searchfield@ @react-stately/menu@ @react-spectrum/textfield@ @react-types/menu@ @react-aria/selection@ @react-types/buttongroup@ @react-stately/checkbox@ @react-stately/numberfield@ @react-aria/listbox@ @react-spectrum/provider@ @react-aria/actiongroup@ @react-aria/tooltip@ @react-spectrum/button@ @react-aria/slider@ @react-aria/virtualizer@ @react-types/button@ @react-aria/combobox@ @react-spectrum/well@ @react-spectrum/theme-light@ @react-spectrum/buttongroup@ @react-stately/searchfield@ @react-spectrum/contextualhelp@ @react-spectrum/progress@ @react-types/checkbox@ @react-types/switch@ @react-spectrum/text@ @react-spectrum/breadcrumbs@ react-stately@ @react-types/label@ @react-stately/data@ @react-spectrum/table@ @react-types/combobox@ @react-stately/list@ @react-types/listbox@ @internationalized/number@ @react-spectrum/label@ @react-types/textfield@ @react-types/text@ @react-aria/searchfield@ @react-aria/spinbutton@ @react-types/form@ @spectrum-icons/workflow@,50,29,2,1829,1879,0 days 00:00:04.132766
1126,BookStackApp/BookStack,3, v. v,36,10,9,113,149,0 days 00:00:00.375725
1127,argoproj/argo-cd,1,v,25,9,4,115,140,0 days 00:00:00.394113
1128,mswjs/msw,2, v,38,31,1,90,128,0 days 00:00:00.100000
1129,darknessomi/musicbox,1,,1,0,0,11,12,0 days 00:00:00.039358
1130,jhen0409/react-native-debugger,1,v,12,3,7,74,86,0 days 00:00:00.071352
1131,cookiecutter/cookiecutter-django,1,,1,0,0,129,130,0 days 00:00:00.329308
1132,pion/webrtc,1,v,8,0,6,145,153,0 days 00:00:00.133098
1133,phpredis/phpredis,1,,14,0,13,44,58,0 days 00:00:00.154975
1134,apidoc/apidoc,1,,27,7,10,19,46,0 days 00:00:00.060391
1135,Automattic/kue,2, v,10,2,7,47,57,0 days 00:00:00.062951
1136,mamoe/mirai,10, test-doc- special- japt- mirai- conosle- v wrapper- console- core-,53,43,4,102,155,0 days 00:00:00.544187
1137,charmbracelet/glow,1,v,7,4,1,10,17,0 days 00:00:00.040636
1138,squizlabs/PHP_CodeSniffer,1,,19,5,12,51,70,0 days 00:00:00.525600
1139,DevExpress/testcafe,17,debug-T spawn-browser- sync-selector- debug-convergence- element-screenshot-rc experimental-razor- disable-page-cache-alpha- gh- code-steps- dq- v element-screenshot-alpha status_bar-redisign- build-gh- no-reload-demo- role-defs- edge-error-,42,15,9,85,127,0 days 00:00:00.214097
1140,gabrielbull/react-desktop,2, v,2,0,1,27,29,0 days 00:00:00.037474
1141,vnotex/vnote,2, v,47,34,4,13,60,0 days 00:00:00.096558
1142,upx/upx,1,v,31,7,18,0,31,0 days 00:00:00.154064
1143,Atmosphere-NX/Atmosphere,1,,18,7,6,48,66,0 days 00:00:00.193461
1144,pinojs/pino,2, v,90,69,7,150,240,0 days 00:00:00.297871
1145,r-spacex/SpaceX-API,2, v,15,9,3,8,23,0 days 00:00:00.107048
1146,deepmind/sonnet,1,v,35,24,1,0,35,0 days 00:00:00.058723
1147,MyCATApache/Mycat-Server,1,,1,0,0,0,1,0 days 00:00:00.028954
1148,JamesNK/Newtonsoft.Json,1,,0,0,0,63,63,0 days 00:00:00.222199
1149,bulletphysics/bullet3,1,,18,5,9,6,24,0 days 00:00:00.588534
1150,bobthecow/psysh,1,v,11,0,9,72,83,0 days 00:00:00.123354
1151,future-architect/vuls,1,v,19,4,6,64,83,0 days 00:00:00.091350
1152,dingo/api,2, v,16,9,5,41,57,0 days 00:00:00.089779
1153,FormidableLabs/spectacle,2, v,35,12,11,77,112,0 days 00:00:00.095987
1154,Zulko/moviepy,1,v,1,0,0,11,12,0 days 00:00:00.046313
1155,openedx/edx-platform,1182, release-2018-01-18- release-2021-06-22- release-2022-04-01- release-2020-01-07- release-2017-09-12- release-2019-08-06- release-2021-06-11- release-2021-10-08- release-2020-04-15- release-2022-03-25- release-2021-12-22- release-2019-01-03- release-2022-03-01- release-2022-05-13- release-2018-08-07- release-2019-01-16- release-2020-04-17- release-2022-05-04- release-2017-08-18- release-2021-09-03- release-2019-10-11- release-2021-03-25- release-2017-12-20- release-2019-03-01- release-2019-03-20- release-2019-12-19- release-2021-05-19- release-2021-08-06- named-release/cypress.rc release-2017-02-07- release-2020-02-27- release-2019-04-18- release-2021-03-31- release-2020-09-29- release-2021-09-15- release-2021-03-03- release-2019-03-05- release-2018-05-15- release-2022-04-04- release-2019-09-10- release-2021-09-02- release-2017-12-11- release-2017-08-02- release-2018-05-08- release-2017-04-13- release-2018-12-18- release-2019-02-06- release-2022-05-25- release-2021-11-17- release-2020-09-02- release-2021-09-21- release-2021-06-07- release-2020-09-09- release-2021-11-01- release-2021-02-09- release-2020-11-12- release-2022-04-18- release-2017-03-06- release-2019-11-04- release-2017-08-07- release-2020-06-11- release-2022-02-04- release-2018-10-09- release-2022-02-15- release-2020-09-28- release-2018-01-19- release-2021-04-09- release-2020-08-21- release-2018-03-09- release-2017-07-13- release-2018-07-24- release-2021-01-20- release-2021-12-16- release-2018-09-25- release-2020-07-07- release-2019-07-02- release-2018-01-25- release-2020-02-10- release-2017-10-10- release-2021-05-07- release-2020-05-13- release-2019-03-27- release-2017-05-31- release-2022-01-27- release-2019-02-05- release-2020-08-10- release-2021-11-04- release-2017-07-27- proctor-hotfix- release-2020-10-15- release-2021-12-29- release-2021-10-28- release-2021-08-05- release-2021-12-01- release-2017-06-14- release-2019-05-16- release-2017-12-21- release-2019-01-25- release-2017-04-12- release-2018-05-25- release-2019-12-09- release-2018-09-27- release-2017-09-19- release-2017-07-28- release-2021-12-26- release-2018-10-02- release-2021-02-17- release-2017-11-15- release-2018-11-06- release-2020-01-09- release-2019-10-15- release-2019-02-27- release-2021-06-08- release-2017-03-28- release-2020-06-17- release-2019-11-25- release-2018-04-18- release-2018-02-15- release-2021-12-15- release-2019-09-27- release-2018-07-03- release-2018-06-27- release-2021-07-16- release-2017-12-14- release-2020-02-08- release-2020-06-25- release-2020-05-31- release-2018-06-28- release-2017-03-29- release-2022-01-11- release-2019-09-19- release-2021-03-29- release-2020-12-23- release-2017-04-19- release-2022-03-07- release-2020-08-20- release-2019-08-22- release-2019-11-05- release-2017-03-24- release-2019-12-04- release-2018-02-12- release-2017-06-19- release-2017-09-15- release-2021-06-04- release-2020-12-01- release-2022-01-07- release-2019-10-29- release-2022-04-28- release-2019-10-09- release-2018-12-16- release-2018-11-08- named-release/birch. release-2017-07-25- release-2019-03-19- release-2018-03-26- release-2019-07-03- release-2019-08-28- release-2017-05-23- release-2017-03-23- release-2017-06-07- release-2020-07-19- release-2020-04-10- release-2017-11-09- release-2018-10-12- release-2017-10-20- release-2020-01-22- release-2018-06-22- release-2018-04-03- release-2020-05-04- release-2021-03-22- release-2017-06-09- release-2018-12-21- release-2021-08-20- release-2021-04-26- release-2020-10-28- release-2019-04-26- release-2017-02-27- release-2022-01-26- release-2021-01-11- release-2016-07- release-2022-01-06- release-2020-08-25- release-2020-10-23- release-2018-02-27- release-2018-08-14- release-2017-09-20- release-2020-10-07- release-2021-10-04- release-2021-12-19- release-2020-01-06- release-2018-11-28- release-2018-07-27- release-2017-08-21- release-2017-10-30- release-2017-04-28- release-2017-12-05- release-2020-08-28- release-2020-01-29- release-2022-05-10- release-2021-05-04- release-2021-02-22- release-2022-03-04- release-2019-12-18- release-2019-01-15- release-2019-02-25- release-2020-07-01- release-2021-04-02- release-2020-12-18- release-2019-04-29- release-2021-05-11- release-2021-09-08- release-2020-08-17- release-2018-06-20- release-2020-09-16- release-2018-10-04- release-2020-03-13- release-2020-03-09- release-2020-12-17- release-2020-06-23- release-2021-07-08- release-2018-04-19- release-2021-05-10- release-2020-07-13- release-2018-07-10- release-2019-07-24- release-2021-10-29- release-2020-08-22- release-2022-03-16- release-2018-10-26- release-2022-03-31- release-2017-11-06- release-2019-08-15- release-2021-03-19- release-2022-04-12- release-2021-11-30- release-2019-08-08- release-2021-10-19- release-2021-11-18- release-2019-03-22- release-2021-06-14- open-release/koa. release-2020-07-22- release-2017-04-14- release-2021-11-12- release-2018-07-02- release-2020-08-24- release-2021-11-24- release-2020-02-28- release-2020-02-26- release-2019-10-16- release-2020-02-21- release-2021-09-27- release-2019-03-15- release-2020-12-03- release-2017-05-10- release-2019-06-27- release-2018-01-11- release-2020-09-17- release-2019-11-14- release-2021-02-25- release-2022-05-09- release-2020-03-16- release-2018-11-02- release-2020-05-10- release-2017-02-15- release-2017-10-12- release-2021-01-15- release-2017-05-24- release-2019-09-12- release-2019-10-18- release-2018-02-26- named-release/dogwood.rc release-2017-04-06- release-2021-08-24- release-2022-03-29- release-2019-11-01- release-2021-07-30- release-2019-05-31- release-2020-03-02- release-2017-08-28- release-2017-03-10- release-2022-04-20- release-2018-01-30- release-2020-06-30- release-2017-08-17- release-2021-07-13- release-2020-12-11- release-2021-02-19- release-2021-06-25- release-2019-07-29- release-2021-10-27- release-2021-11-15- release-2021-05-25- release-2021-07-12- release-2018-04-12- release-2018-06-21- release-2019-07-18- release-2020-02-07- release-2017-06-06- release-2019-03-04- release-2017-07-10- release-2018-08-09- release-2021-03-11- release-2022-05-26- release-2020-04-13- release-2020-07-26- release-2021-03-08- release-2022-01-19- release-2020-12-22- release-2019-04-11- release-2017-10-16- release-2018-03-07- release-2018-05-11- release-2021-05-12- release-2019-08-05- release-2021-07-29- release-2017-06-27- release-2022-02-23- release-2021-11-11- release-2018-09-26- release-2022-05-12- release-2018-07-23- release-2021-04-07- release-2017-09-26- release-2020-07-02- release-2017-09-25- release-2022-01-04- release-2021-03-16- release-2018-09-17- release-2022-01-05- release-2021-09-22- release-2020-08-12- release-2020-07-30- release-2018-09-11- release-2021-06-01- release-2020-10-30- release-2022-01-18- release-2017-08-10- release-2020-02-06- release-2017-11-13- release-2018-03-20- aspen. release-2018-04-17- release-2020-05-21- release-2020-05-27- release-2021-01-06- release-2021-05-17- release-2018-12-14- release-2018-09-06- release-2021-10-26- release-2019-01-31- release-2017-04-20- release-2018-12-10- release-2019-03-11- release-2021-07-20- release-2021-07-22- release-2021-02-16- release-2020-04-29- release-2021-04-12- release-2022-04-29- release-2018-11-19- release-2021-07-09- release-2020-08-03- release-2020-09-18- release-2019-03-21- release-2021-12-06- release-2021-03-24- release-2017-03-02- edx-west-release- release-2019-05-28- release-2018-09-05- release-2020-01-31- release-2022-02-28- release-2018-02-05- release-2020-08-11- release-2020-04-06- release-2022-01-31- release-2017-03-07- release-2017-10-25- release-2021-08-27- nedbat/test/h. release-2021-03-10- release-2017-12-04- release-2020-01-27- release-2021-12-31- release-2017-10-26- release-2019-03-26- release-2020-04-09- release-2017-03-16- release-2018-04-10- release-2018-01-17- release-2017-11-03- nedbat/test/ficus. release-2019-04-02- release-2021-10-20- release-2021-02-11- release-2019-11-22- release-2021-08-25- release-2019-12-20- release-2021-05-09- release-2018-02-02- release-2020-04-16- release-2017-08-09- release-2020-03-27- release-2021-07-19- release-2021-04-06- release-2019-12-12- release-2019-07-30- release-2020-08-14- release-2019-02-26- release-2020-03-24- release-2021-04-29- release-2017-11-14- release-2022-01-28- release-2017-05-08- release-2017-05-19- release-2019-07-23- release-2018-07-25- release-2021-09-09- release-2021-11-23- release-2020-05-22- release-2017-08-22- sprint- release-2020-06-10- release-2018-10-01- release-2021-02-26- release-2019-06-20- release-2021-02-02- release-2017-07-21- release-2020-02-20- release-2020-02-24- release-2017-06-05- release-2018-02-22- release-2018-07-12- release-2020-03-11- release-2018-04-09- release-2019-09-30- release-2017-10-04- release-2020-07-09- release-2018-10-30- release-2021-10-14- release-2020-02-19- release-2017-12-12- release-2021-06-16- release-2018-06-26- release-2017-09-08- release-2019-04-04- release-2017-08-04- release-2020-03-18- release-2022-02-11- release-2017-03-20- release-2019-02-14- release-2020-09-25- release-2019-05-24- release-2019-07-12- release-2019-09-16- ned/test-ficus. release-2020-08-06- release-2020-07-08- release-2019-04-03- release-2019-06-28- release-2021-12-23- release-2021-09-23- release-2019-03-08- release-2017-06-28- release-2021-11-28- release-2019-09-09- release-2021-10-06- release-2021-03-04- release-2021-06-17- release-2018-08-17- release-2019-01-04- release-2019-05-07- release-2017-09-07- release-2018-04-24- release-2018-05-03- release-2019-06-05- open-release/maple. release-2018-05-17- open-release/ginkgo. release-2020-10-21- release-2020-08-09- release-2017-07-31- release-2021-02-03- release-2021-07-06- release-2017-01-24- release-2021-11-19- release-2020-10-14- release-2019-08-02- release-2021-11-10- release-2017-08-25- release-2021-05-06- release-2018-05-31- release-2020-05-16- release-2018-09-19- release-2018-07-26- release-2019-08-23- release-2020-08-19- release-2020-05-11- release-2022-02-17- release-2021-12-20- release-2021-07-07- release-2020-09-04- release-2018-07-13- release-2019-06-14- release-2020-06-24- release-2021-11-09- release-2020-11-09- release-2020-10-25- release-2019-08-12- release-2020-10-06- release-2017-02-21- release-2017-10-05- release-2022-02-02- release-2019-08-01- release-2017-07-11- release-2020-07-17- release-2020-01-10- release-2018-08-15- release-2018-10-17- release-2021-03-26- release-2019-12-16- release-2017-07-20- release-2020-09-15- release-2017-09-29- jan- release-2017-08-23- release-2021-01-25- release-2017-04-25- release-2020-03-04- release-2017-01-27- release-2017-08-30- release-2018-01-31- release-2017-09-14- release-2021-12-03- release-2020-11-03- release-2019-06-17- release-2020-11-22- release-2021-11-02- release-2019-03-25- release-2021-05-03- release-2020-05-01- release-2019-06-25- release-2020-02-03- release-2017-10-03- release-2020-11-25- release-2021-01-19- release-2021-05-14- release-2019-12-17- release-2018-03-29- release-2019-01-08- release-2021-09-20- release-2021-06-02- release-2019-01-18- release-2019-08-20- release-2018-08-13- release-2017-03-17- release-2017-06-23- release-2022-04-27- release-2020-11-23- release-2017-03-03- release-2017-07-14- release-2021-02-18- release-2019-06-24- release-2021-10-25- release-2018-01-10- release-2019-08-13- release-2021-10-01- release-2019-11-08- release-2022-05-19- release-2021-01-28- hotfix- release-2017-03-08- release-2019-01-02- release-2022-03-30- release-2021-03-15- release-2020-06-16- release-2018-08-23- release-2021-12-21- release-2018-06-05- release-2020-11-02- release-2017-12-13- release-2019-09-23- release-2022-05-05- release-2017-01-31- release-2021-10-22- amc- release-2022-02-22- release-2018-04-23- release-2018-10-23- release-2019-09-11- release-2018-07-18- release-2019-08-30- release-2020-05-29- release-2019-03-13- release-2020-01-03- release-2022-03-14- release-2020-07-14- release-2021-12-02- release-2019-01-07- release-2017-06-30- release-2020-05-19- release-2017-02-16- release-2021-02-06- release-2019-12-05- release-2018-10-29- release-2017-09-18- release-2017-05-04- release-2017-04-27- release-2020-12-16- release-2022-01-20- release-2017-01-26- release-2017-02-28- release-2019-09-05- release-2017-05-16- release-2020-10-29- release-2020-05-06- release-2022-02-24- release-2018-04-02- release-2017-03-27- release-2020-03-17- release-2019-10-30- release-2018-11-30- release-2019-04-19- release-2020-07-20- release-2020-11-19- release-2017-03-31- release-2018-05-21- release-2022-04-21- release-2019-06-19- release-2019-08-26- release-2021-10-05- release-2021-05-27- release-2018-08-29- release-2018-07-17- release-2020-11-16- release-2019-11-19- release-2021-06-10- release-2020-12-02- release-2017-06-22- release-2018-05-23- appsembler/intersystems/release/dogwood.rc-SSO- release-2019-05-03- release-2021-02-10- release-2020-06-15- release-2019-01-22- release-2020-11-17- release-2020-02-13- release-2019-05-21- v release-2020-10-01- release-2018-12-05- release-2022-03-23- release-2021-10-15- release-2021-01-07- release-2020-03-06- release-2018-06-01- release-2021-08-03- release-2022-04-11- release-2019-03-14- release-2021-10-21- release-2018-04-05- release-2021-10-13- release-2021-02-05- release-2021-10-07- release-2021-08-18- release-2018-02-08- release-2017-05-12- release-2017-07-05- release-2021-08-09- release-2019-08-29- release-2021-03-17- release-2021-02-08- release-2021-12-28- release-2021-10-18- release-2020-05-08- release-2022-03-11- release-2020-02-18- release-2022-03-08- release-2022-02-14- release-2018-01-26- release-2017-08-24- release-2020-02-14- release-2018-07-06- release-2017-02-23- release-2021-01-05- release-2022-03-10- release-2017-03-13- release-2018-10-11- release-2019-05-09- release-2018-11-21- release-2018-08-16- release-2021-03-01- release-2021-09-07- release-2022-02-08- release-2021-09-16- release-2018-10-18- release-2022-05-02- release-2017-10-02- release-2018-01-24- release-2018-03-01- release-2018-04-11- release-2018-03-14- release-2021-02-04- release-2018-04-06- release-2021-01-27- release-2018-04-27- release-2019-09-06- release-2019-08-07- open-release/hawthorn. release-2017-08-03- release-2020-06-02- release-2019-09-20- release-2020-07-24- release-2018-10-19- release-2021-01-13- release-2020-01-14- release-2017-11-28- nedbat/test-ficus.1rc release-2021-07-01- release-2021-09-24- release-2019-12-06- release-2017-02-24- release-2021-01-14- open-release/lilac. release-2020-07-31- release-2018-08-21- release-2021-01-08- release-2021-07-21- release-2022-05-17- release-2021-03-02- open-release/juniper. release-2022-02-21- release-2020-11-13- release-2019-02-21- release-2020-10-20- release-2019-04-08- release-2020-04-23- release-2020-06-26- release-2021-06-30- release-2022-05-27- release-2017-06-16- release-2020-05-14- release-2018-11-26- release-2021-05-18- release-2022-01-10- release-2018-12-12- release-2017-05-09- release-2017-05-01- release-2017-02-06- release-2018-11-07- release-2022-01-21- release-2021-02-12- release-2018-08-24- release-2019-02-04- release-2017-02-10- release-2022-03-17- release-2018-01-03- release-2021-02-01- release-2020-09-23- release-2019-10-21- release-2022-02-25- release-2020-04-14- release-2018-05-22- release-2018-12-13- release-2022-05-24- release-2021-12-08- release-2020-09-08- release-2017-11-07- release-2020-04-03- release-2020-02-17- release-2017-11-22- release-2022-04-06- release-2019-01-17- release-2021-01-29- release-2018-03-27- release-2019-01-20- release-2019-09-26- open-release/eucalyptus. release-2020-06-05- release-2020-10-26- release-2019-04-16- release-2021-06-29- release-2022-03-24- release-2019-02-20- release-2018-08-27- release-2022-03-15- release-2020-11-06- release-2018-08-08- release-2020-03-10- release-2020-05-28- release-2018-03-06- release-2021-08-30- release-2019-10-03- release-2021-03-23- release-2020-08-27- release-2017-03-09- release-2021-08-12- release-2018-03-21- release-2022-04-05- release-2020-09-21- release-2021-09-28- release-2021-04-28- release-2017-06-29- release-2020-11-20- release-2021-07-26- release-2019-01-10- release-2020-08-26- release-2021-01-26- release-2021-08-29- release-2020-04-24- release-2018-04-04- release-2021-03-30- release-2017-04-18- release-2021-09-17- release-2019-07-10- release-2021-05-21- release-2021-07-02- release-2019-08-21- release-2018-08-28- release-2018-08-10- release-2022-03-22- release-2018-06-08- edx-west/releas- release-2017-02-03- release-2021-07-23- release-2022-05-11- release-2022-05-23- release-2019-06-18- release-2021-08-17- release- release-2020-08-05- release-2017-07-19- release-2020-02-11- release-2018-10-22- release-2019-08-09- release-2019-06-13- release-2021-08-16- release-2021-07-15- release-2020-09-30- release-2022-02-10- release-2020-01-30- release-2020-02-25- release-2017-04-26- release-2020-09-03- release-2020-07-15- release-2018-06-06- release-2019-11-11- open-release/ironwood. release-2018-05-29- release-2017-05-02- release-2021-05-28- release-2021-07-14- release-2017-06-13- release-2022-05-16- release-2019-06-06- release-2018-06-19- release-2022-03-09- dogwood-first- release-2020-11-05- release-2021-11-26- release-2017-05-17- release-2020-12-10- release-2018-11-29- release-2022-04-26- release-2020-01-28- release-2021-05-20- release-2018-02-13- release-2021-05-05- release-2018-03-16- release-2020-06-09- release-2018-03-28- release-2020-05-15- release-2019-09-18- release-2021-01-12- release-2020-10-13- release-2019-02-15- release-2020-12-07- release-2018-12-03- release-2019-06-10- release-2018-03-02- nedbat/test/ficus.2rc release-2021-08-02- release-2019-05-15- release-2021-06-23- release-2017-08-31- release-2020-03-19- release-2018-08-31- release-2017-12-07- release-2020-05-05- release-2020-01-21- release-2019-10-23- release-2021-04-15- release-2018-02-07- release-2018-10-05- release-2020-01-08- release-2020-05-26- release-2018-11-01- release-2022-02-09- release-2022-04-25- release-2021-08-11- release-2017-11-30- release-2021-11-05- release-2019-07-17- release-2019-10-07- release-2021-07-27- release-2020-03-25- release-2020-06-03- release-2022-03-02- release-2019-09-17- release-2021-06-09- release-2021-04-08- release-2018-06-12- release-2018-11-27- release-2018-02-01- release-2017-05-25- release-2019-12-13- release-2019-10-17- release-2021-06-24- release-2018-03-15- release-2022-02-01- release-2020-04-07- release-2018-11-16- release-2021-04-16- release-2019-03-06- release-2020-03-12- release-2019-05-10- release-2018-09-07- release-2018-04-26- release-2019-02-12- release-2022-02-16- release-2020-02-05- release-2021-05-26- release-2020-06-19- release-2018-02-16- release-2018-05-09- release-2017-11-08- release-2019-02-07- release-2017-06-20- aspen- release-2018-05-10- release-2020-02-04- release-2020-09-14- release-2017-07-24- release-2021-09-30- release-2021-03-18- release-2018-08-22- release-2018-06-25- release-2020-09-27- release-2020-11-11- release-2021-08-31- release-2018-09-18- release-2021-04-27- release-2020-01-13- release-2022-05-03- release-2020-03-31- release-2017-02-02- release-2019-04-22- release-2020-11-24- release-2020-01-02- release-2019-07-15- release-2019-03-18- release-2020-10-19- release-2019-10-02- release-2019-07-31- release-2018-11-14- release-2021-07-28- release-2018-10-31- release-2020-10-02- release-2017-08-01- release-2017-12-22- named-release/birch.rc release-2019-01-24- release-2022-02-18- release-2022-04-15- release-2022-03-03- release-2018-05-04- release-2017-06-21- release-2021-04-01- release-2019-03-28- release-2020-06-04- release-2017-05-30- release-2020-06-28- release-2021-08-19- release-2018-08-30- release-2019-12-10- release-2019-01-30- release-2018-01-08- release-2020-12-04- release-2018-05-02- release-2022-04-13- release-2017-09-13- named-release/dogwood. release-2021-09-01- release-2020-06-08- release-2019-04-01- release-2020-11-04- release-2020-08-23- release-2017-05-18- release-2018-06-11- release-2019-02-13- release-2019-05-20- release-2018-05-14- release-2017-01-30- release-2022-04-07- release-2019-10-25- release-2018-03-08- release-2017-09-01- release-2018-07-20- release-2022-05-06- release-2022-01-12- release-2018-02-14- release-2019-02-22- release-2021-12-13- release-2020-06-12- release-2021-01-21- release-2022-01-24- release-2017-10-18- release-2021-02-24- release-2017-09-05- release-2022-02-07- release-2019-02-19- release-2019-11-15- release-2021-08-13- release-2017-07-12- release-2021-06-15- release-2021-12-17- release-2018-12-04- release-2017-06-01- release-2021-09-10- release-2020-08-31- release-2017-06-26- release-2020-07-10- release-2017-06-15- release-2019-01-09- release-2017-04-11- release-2021-11-29- release-2020-04-30- release-2019-04-23- release-2020-03-20- release-2020-04-01- release-2017-07-06- release-2019-07-01- release-2021-04-05- release-2018-07-31- release-2018-02-28- release-2021-09-29- release-2022-05-20- nedbat/test/ficus.1rc release-2020-07-28- release-2018-09-14- open-release/ficus. release-2022-04-14- release-2020-06-01- release-2020-12-14- release-2021-12-10- release-2019-10-01- release-2021-03-12- release-2019-11-18- release-2019-07-25- release-2019-04-25- release-2018-09-21- release-2018-12-20- release-2020-09-22- release-2018-11-20- release-2019-07-26- release-2022-01-25- release-2018-08-03- edx-west/release- release-2019-06-12- release-2018-09-20- release-2020-01-23- release-2022-03-18- release-2020-06-21- release-2018-06-14- release-2018-05-16- release-2021-04-13- release-2019-11-06- release-2022-05-18- release-2018-07-05- release-2020-03-30- release-2020-01-24- release-2019-11-21- release-2018-07-19- release-2022-03-28- release-2020-12-15- release-2019-06-21- release-2018-07-30- release-2021-11-03- release-2021-08-04- release-2018-09-10- release-2020-04-21- release-2021-03-05- release-2018-04-13- release-2021-04-14- release-2022-04-08- release-2020-09-10- release-2017-11-02- release-2021-04-30- release-2017-05-05- archived-branch/arjun/pre_push_ release-2022-04-22- release-2021-12-09- release-2019-10-10- release-2017-04-04- release-2020-02-12- release-2021-12-14- release-2019-05-08- release-2022-04-19- release-2017-11-16- release-2020-11-10- release-2019-01-14- release-2020-06-29- release-2018-01-29- release-2019-05-29- release-2021-06-03- release-2020-07-16- release-2021-11-22- release-2020-04-22- release-2021-08-23- release-2021-06-21- release-2020-04-25- release-2017-09-06- release-2020-03-26- release-2021-11-08- release-2021-03-09- release-2020-04-27- release-2019-04-10- release-2018-05-30- release-2020-09-11- release-2019-04-09- release-2021-05-13- release-2020-05-12- release-2017-03-30- release-2020-08-07- release-2021-09-14- release-2020-04-02- release-2021-08-26- release-2020-06-22- proctor-release- release-2020-12-09- release-2021-11-16- release-2022-03-21- release-2020-08-13- release-2022-02-03- release-2020-09-01- release-2017-08-11- release-2020-07-29- release-2022-01-13- release-2020-10-22- release-2018-05-24- release-2019-08-19- release-2017-02-08- release-2019-04-17- release-2021-12-07- release-2018-05-01- release-2017-07-18- release-2018-12-07- release-2017-04-07- release-2019-01-23- release-2018-10-03- release-2020-05-07- release-2020-10-16- release-2019-05-02- mitx-release-fa release-2020-07-27- release-2019-10-08- release-2019-05-30- release-2019-11-07- release-2021-08-10- release-2017-05-03- release-2018-08-20- release-2020-10-05- release-2018-02-20- release-2020-08-18- release-2020-08-04- release-2018-06-15- release-2020-03-03- release-2020-09-24- release-2017-10-13- release-2020-06-18-,2040,1152,704,2491,4531,0 days 00:00:34.836404
1156,exceljs/exceljs,2, v,41,28,7,180,221,0 days 00:00:00.211066
1157,uncss/uncss,1,,9,2,5,9,18,0 days 00:00:00.038841
1158,reactjs/react-transition-group,1,v,19,9,7,19,38,0 days 00:00:00.030472
1159,systemd/systemd,3, v239- v,242,161,27,43,285,0 days 00:00:03.343912
1160,adamwdraper/Numeral-js,1,,3,0,2,12,15,0 days 00:00:00.034995
1161,oblador/react-native-animatable,1,v,10,4,4,13,23,0 days 00:00:00.021528
1162,apereo/cas,1,v,20,0,19,159,179,0 days 00:00:02.612928
1163,deployphp/deployer,1,v,20,6,9,47,67,0 days 00:00:00.122167
1164,acaudwell/Gource,1,gource-,20,5,11,0,20,0 days 00:00:00.052810
1165,davatorium/rofi,1,,8,0,5,26,34,0 days 00:00:00.174524
1166,opencontainers/runc,1,v,3,0,2,16,19,0 days 00:00:00.441510
1167,c3js/c3,2, v,6,0,4,108,114,0 days 00:00:00.212753
1168,coredns/coredns,1,v,20,7,7,42,62,0 days 00:00:00.295222
1169,arasatasaygin/is.js,1,v,8,5,2,13,21,0 days 00:00:00.028026
1170,cheat/cheat,1,,18,10,4,67,85,0 days 00:00:00.088410
1171,crimx/ext-saladict,3, v V,59,47,6,139,198,0 days 00:00:00.215425
1172,callstack/react-native-paper,2, v,53,40,5,61,114,0 days 00:00:00.122277
1173,docmirror/dev-sidecar,2, v,7,3,2,16,23,0 days 00:00:00.044016
1174,hackware1993/MagicIndicator,1,,8,4,2,5,13,0 days 00:00:00.022474
1175,coleifer/peewee,1,,35,12,13,139,174,0 days 00:00:00.220477
1176,boardgameio/boardgame.io,1,v,39,28,4,111,150,0 days 00:00:00.141095
1177,doctrine/orm,2, v,13,0,12,77,90,0 days 00:00:00.800624
1178,alibaba/hooks,7,ahooks-v2@ @ahooksjs/use-request@ @ahooksjs/use-url-state@ @umijs/use-request@ v @umijs/hooks@ ahooks@,29,18,2,156,185,0 days 00:00:00.191589
1179,Unity-Technologies/UnityCsReference,0,,0,0,0,0,0,0 days 00:00:00.059669
1180,gomodule/redigo,1,v,3,0,1,10,13,0 days 00:00:00.025684
1181,aksakalli/gtop,1,v,3,0,2,9,12,0 days 00:00:00.015551
1182,pyinstaller/pyinstaller,2, v,28,5,19,6,34,0 days 00:00:00.616918
1183,chimurai/http-proxy-middleware,1,v,26,19,6,30,56,0 days 00:00:00.037536
1184,direnv/direnv,2, v,33,8,16,42,75,0 days 00:00:00.070640
1185,javascript-obfuscator/javascript-obfuscator,1,,63,47,4,122,185,0 days 00:00:00.188308
1186,streamaserver/streama,1,v,6,0,5,47,53,0 days 00:00:00.107595
1187,symfony/console,1,v,26,4,21,466,492,0 days 00:00:00.512620
1188,koral--/android-gif-drawable,1,v,3,0,2,53,56,0 days 00:00:00.075836
1189,apache/thrift,3, thrift- v,15,0,11,16,31,0 days 00:00:00.385339
1190,hacksalot/HackMyResume,1,v,20,19,0,19,39,0 days 00:00:00.040964
1191,phpDocumentor/ReflectionDocBlock,1,,14,4,8,24,38,0 days 00:00:00.059957
1192,TooTallNate/Java-WebSocket,2,v Java-WebSocket-,13,4,6,14,27,0 days 00:00:00.059393
1193,akveo/react-native-ui-kitten,1,v,8,0,4,16,24,0 days 00:00:00.202142
1194,sonic-pi-net/sonic-pi,1,v,16,5,7,9,25,0 days 00:00:00.538499
1195,logaretm/vee-validate,5, @vee-validate/i18n@ vee-validate@ @vee-validate/rules@ v,14,3,7,151,165,0 days 00:00:00.401516
1196,glfw/glfw,1,,4,0,3,14,18,0 days 00:00:00.203635
1197,rough-stuff/wired-elements,1,v,9,2,4,26,35,0 days 00:00:00.033901
1198,Gallopsled/pwntools,1,,26,5,8,35,61,0 days 00:00:00.338793
1199,typecho/typecho,1,v,1,0,0,0,1,0 days 00:00:00.068315
1200,PrefectHQ/prefect,1,,17,5,6,102,119,0 days 00:00:01.098166
1201,ydataai/pandas-profiling,2,v. v,20,10,7,14,34,0 days 00:00:00.062727
1202,alexfoxy/lax.js,2, v,3,2,0,14,17,0 days 00:00:00.023904
1203,aksonov/react-native-router-flux,2, v,13,3,6,34,47,0 days 00:00:00.090037
1204,timarney/react-app-rewired,10, react-app-rewire-less@ react-app-rewire-polyfills@ react-app-rewired@ react-app-rewire-eslint@ v react-app-rewire-mobx@ react-app-rewire-sass@ react-app-rewire-relay@ react-app-rewire-preact@,10,2,2,41,51,0 days 00:00:00.040597
1205,cure53/DOMPurify,2, v,12,3,8,68,80,0 days 00:00:00.206122
1206,sinonjs/sinon,2, v,57,26,18,121,178,0 days 00:00:00.400160
1207,OWASP/owasp-mstg,2, v,5,1,3,7,12,0 days 00:00:00.362956
1208,didi/cube-ui,2, v,13,10,1,69,82,0 days 00:00:00.136463
1209,react-dropzone/react-dropzone,2, v,55,34,12,120,175,0 days 00:00:00.110567
1210,thumbor/thumbor,1,,61,33,14,178,239,0 days 00:00:00.206030
1211,paulmillr/chokidar,1,,28,10,13,70,98,0 days 00:00:00.105760
1212,capnproto/capnproto,1,v,9,1,6,12,21,0 days 00:00:00.301345
1213,SoftEtherVPN/SoftEtherVPN,1,,1,0,0,18,19,0 days 00:00:00.085814
1214,ginuerzh/gost,2, v,21,11,7,11,32,0 days 00:00:00.044168
1215,helmetjs/helmet,1,v,51,23,8,34,85,0 days 00:00:00.083482
1216,inversify/InversifyJS,2, v,25,15,7,22,47,0 days 00:00:00.097342
1217,openlayers/openlayers,4,release- docs- v backport-,63,26,19,53,116,0 days 00:00:01.563243
1218,sympy/sympy,1,sympy-,14,0,12,34,48,0 days 00:00:02.861850
1219,SecureAuthCorp/impacket,1,impacket_,1,0,0,17,18,0 days 00:00:00.162904
1220,symless/synergy-core,2, release-,6,0,4,38,44,0 days 00:00:00.230308
1221,Studio3T/robomongo,1,v,5,0,3,24,29,0 days 00:00:00.266081
1222,TuSimple/naive-ui,2, v,26,24,1,70,96,0 days 00:00:00.479382
1223,zuiidea/antd-admin,1,,8,0,5,11,19,0 days 00:00:00.049762
1224,nukeop/nuclear,3,e eac v,5,0,4,21,26,0 days 00:00:00.147254
1225,mayswind/AriaNg,1,,9,1,6,14,23,0 days 00:00:00.034810
1226,callstack/linaria,1,v,14,9,4,24,38,0 days 00:00:00.142633
1227,aws/chalice,1,,38,17,8,43,81,0 days 00:00:00.142287
1228,dromara/Sa-Token,1,v,23,18,2,1,24,0 days 00:00:00.057811
1229,didi/chameleon,2, v,4,1,1,19,23,0 days 00:00:00.073981
1230,labring/sealos,2,kubeadm v,6,1,2,17,23,0 days 00:00:00.062981
1231,marmelab/gremlins.js,2, v,5,1,3,2,7,0 days 00:00:00.027852
1232,antvis/G6,1,,9,2,3,64,73,0 days 00:00:00.291028
1233,gka/chroma.js,2, v,9,3,5,26,35,0 days 00:00:00.045123
1234,phpDocumentor/TypeResolver,1,,14,2,9,18,32,0 days 00:00:00.036707
1235,cert-manager/cert-manager,1,v,25,3,3,49,74,0 days 00:00:00.491741
1236,nasa/fprime,2,NASA-v v,10,1,7,5,15,0 days 00:00:00.237689
1237,CleverRaven/Cataclysm-DDA,4, v experimental- cdda-jenkins-b,2705,2650,1,2,2707,0 days 00:00:15.054814
1238,fkhadra/react-toastify,1,v,33,16,8,60,93,0 days 00:00:00.103560
1239,crawlab-team/crawlab,1,v,6,1,3,21,27,0 days 00:00:00.123037
1240,react-page/react-page,2, v,58,45,6,214,272,0 days 00:00:00.187189
1241,HabitRPG/habitica,2, v,351,348,2,612,963,0 days 00:00:02.910784
1242,facebookresearch/ParlAI,2, v,10,5,2,10,20,0 days 00:00:00.223490
1243,heartexlabs/label-studio,2,v. v,14,4,2,24,38,0 days 00:00:00.115693
1244,webtorrent/webtorrent-desktop,1,v,25,18,5,13,38,0 days 00:00:00.264391
1245,dompdf/dompdf,1,v,6,0,4,14,20,0 days 00:00:00.075176
1246,libevent/libevent,1,release-,1,0,0,1,2,0 days 00:00:00.029823
1247,JetBrains/compose-jb,2, v,4,0,3,5,9,0 days 00:00:00.087295
1248,carlospolop/PEASS-ng,1,,40,22,0,0,40,0 days 00:00:00.077950
1249,openframeworks/openFrameworks,1,,10,1,6,16,26,0 days 00:00:00.984162
1250,tweepy/tweepy,2, v,40,17,15,4,44,0 days 00:00:00.175762
1251,tinode/chat,1,v,6,1,4,45,51,0 days 00:00:00.186158
1252,facebook/chisel,1,,10,1,6,3,13,0 days 00:00:00.033334
1253,OpenRefine/OpenRefine,2, v,13,1,10,9,22,0 days 00:00:00.457234
1254,amueller/word_cloud,1,,5,0,4,6,11,0 days 00:00:00.038446
1255,remarkjs/react-markdown,2, v,22,7,11,46,68,0 days 00:00:00.042754
1256,angular/protractor,3, fv v,47,34,7,44,91,0 days 00:00:00.105877
1257,encode/httpx,1,,23,10,4,47,70,0 days 00:00:00.085583
1258,falconry/falcon,1,,11,0,9,11,22,0 days 00:00:00.107625
1259,DNSCrypt/dnscrypt-proxy,1,,2,0,1,45,47,0 days 00:00:00.270165
1260,phpDocumentor/ReflectionCommon,1,,7,0,3,1,8,0 days 00:00:00.016385
1261,quay/clair,2,config/v v,10,2,6,52,62,0 days 00:00:00.108249
1262,golang-migrate/migrate,1,v,24,7,7,25,49,0 days 00:00:00.077334
1263,Aircoookie/WLED,1,v,8,1,6,15,23,0 days 00:00:00.101902
1264,zerotier/ZeroTierOne,1,,15,4,6,68,83,0 days 00:00:00.712595
1265,mapeditor/tiled,1,v,27,3,19,56,83,0 days 00:00:00.423047
1266,GoogleChromeLabs/comlink,1,v,15,8,4,23,38,0 days 00:00:00.070217
1267,mementum/backtrader,1,,7,2,1,132,139,0 days 00:00:00.151269
1268,easy-mock/easy-mock,1,v,4,0,1,8,12,0 days 00:00:00.015294
1269,AutoMapper/AutoMapper,2, v,24,0,20,26,50,0 days 00:00:00.222213
1270,cefsharp/CefSharp,1,v,27,5,11,70,97,0 days 00:00:00.356258
1271,pytest-dev/pytest,1,,42,10,17,122,164,0 days 00:00:00.941972
1272,jshint/jshint,3, r relicensing-,27,10,10,47,74,0 days 00:00:00.224708
1273,coursera-dl/coursera-dl,1,,8,1,5,12,20,0 days 00:00:00.063962
1274,novnc/noVNC,1,v,10,0,8,3,13,0 days 00:00:00.110692
1275,videolan/vlc,1,,9,1,3,50,59,0 days 00:00:04.005066
1276,gregberge/svgr,1,v,36,29,4,19,55,0 days 00:00:00.057349
1277,aws/aws-cdk,1,v,217,216,0,46,263,0 days 00:00:00.814102
1278,ultralytics/yolov3,1,v,12,6,4,0,12,0 days 00:00:00.240912
1279,desandro/imagesloaded,1,v,11,3,5,27,38,0 days 00:00:00.029691
1280,espressif/arduino-esp32,1,,2,0,1,9,11,0 days 00:00:00.102199
1281,django-cms/django-cms,1,,16,0,15,69,85,0 days 00:00:01.090671
1282,IdentityServer/IdentityServer4,3, RC beta,17,8,7,44,61,0 days 00:00:00.286900
1283,YiiGuxing/TranslationPlugin,2,clion# v,19,4,7,42,61,0 days 00:00:00.120278
1284,doctrine/dbal,2, v,18,2,14,79,97,0 days 00:00:00.652569
1285,s0md3v/Photon,1,v,2,0,0,17,19,0 days 00:00:00.028557
1286,SignalR/SignalR,2, v,10,0,9,23,33,0 days 00:00:00.223898
1287,microsoft/Windows-universal-samples,2, v,438,13,9,171,609,0 days 00:00:00.574613
1288,pyodide/pyodide,2, v,20,11,6,25,45,0 days 00:00:00.116083
1289,caprover/caprover,2,v V,12,6,5,17,29,0 days 00:00:00.073443
1290,vercel/vercel,44, @now/optipng@ @now/lambda@ @now/php-bridge@ @now/build-utils@ @now/md@ @now/bash@ @now/layer-node@ @now/wordpress@ @now/next@ gatsby-plugin-now@ @vercel/python@ @vercel/static-config@ now-client@ @vercel/static-build@ @now/rust@ @vercel/next@ @vercel/cgi@ @now/php@ @vercel/node@ @vercel/redwood@ @vercel/node-bridge@ @vercel/routing-utils@ @now/ruby@ @now/node-bridge@ @now/cgi@ @vercel/build-utils@ @now/python@ @now/routing-utils@ @now/go@ @now/frameworks@ now@ @now/layer-yarn@ @vercel/frameworks@ @vercel/ruby@ @now/layer-npm@ @vercel/go@ @now/mdx-deck@ vercel@ @now/html-minifier@ @now/node@ @now/static-build@ @vercel/client@ @now/node-server@,164,95,2,1019,1183,0 days 00:00:02.449096
1291,piskelapp/piskel,1,v,14,2,9,16,30,0 days 00:00:00.094122
1292,chakra-core/ChakraCore,1,v,9,1,3,52,61,0 days 00:00:00.699754
1293,cs01/gdbgui,4, v pypi- pyPI-,16,9,3,52,68,0 days 00:00:00.058120
1294,keplergl/kepler.gl,3,keplergl== v keplergl-jupyter@,10,3,5,53,63,0 days 00:00:00.177994
1295,questdb/questdb,2, v,12,1,8,39,51,0 days 00:00:00.191488
1296,mailpile/Mailpile,1,,5,1,2,6,11,0 days 00:00:00.200875
1297,captbaritone/webamp,1,,6,0,3,11,17,0 days 00:00:00.149877
1298,mapbox/mapbox-gl-js,2,v style-spec@,108,54,7,100,208,0 days 00:00:00.678786
1299,gedoor/legado,1,,0,0,0,231,231,0 days 00:00:00.742537
1300,Nickersoft/push.js,2, v,1,0,0,23,24,0 days 00:00:00.028492
1301,cyrus-and/gdb-dashboard,1,v,15,6,8,15,30,0 days 00:00:00.030705
1302,tweenjs/tween.js,3, r v,30,12,13,23,53,0 days 00:00:00.060219
1303,spotDL/spotify-downloader,1,v,14,4,4,38,52,0 days 00:00:00.085353
1304,EpistasisLab/tpot,2, v,9,1,5,15,24,0 days 00:00:00.123257
1305,Automattic/node-canvas,2, v,30,11,13,88,118,0 days 00:00:00.127498
1306,OnsenUI/OnsenUI,1,,20,6,8,68,88,0 days 00:00:00.565997
1307,CesiumGS/cesium,2, b,120,117,0,12,132,0 days 00:00:02.287262
1308,aws/serverless-application-model,2, v,42,25,6,9,51,0 days 00:00:00.196601
1309,Shopify/sarama,1,v,34,10,15,18,52,0 days 00:00:00.144634
1310,ExistentialAudio/BlackHole,1,v,1,0,0,9,10,0 days 00:00:00.032954
1311,microsoft/qlib,1,v,4,0,2,11,15,0 days 00:00:00.230636
1312,claudiodangelis/qrcp,1,,6,2,3,17,23,0 days 00:00:00.024521
1313,google/go-github,1,v,59,43,6,35,94,0 days 00:00:00.114111
1314,trufflesecurity/trufflehog,2, v,7,6,0,20,27,0 days 00:00:00.091464
1315,XTLS/Xray-core,1,v,6,3,1,21,27,0 days 00:00:00.031527
1316,Activiti/Activiti,2, activiti-,29,11,14,6,35,0 days 00:00:00.675428
1317,gotwarlost/istanbul,2, v,3,0,2,52,55,0 days 00:00:00.044990
1318,graphql-go/graphql,1,v,4,0,2,10,14,0 days 00:00:00.061751
1319,aristocratos/bpytop,1,v,1,0,0,68,69,0 days 00:00:00.046780
1320,Justson/AgentWeb,2, v,4,1,1,13,17,0 days 00:00:00.042808
1321,muesli/duf,1,v,8,5,2,4,12,0 days 00:00:00.020824
1322,pallets/jinja,1,,14,0,11,29,43,0 days 00:00:00.153828
1323,dotnet/orleans,4, v. v rebond/tmp/feature/directory-rework/,18,0,15,72,90,0 days 00:00:00.271814
1324,dotnet/runtime,1,v,2,0,1,22,24,0 days 00:00:06.975546
1325,keras-team/autokeras,1,,4,0,3,47,51,0 days 00:00:00.181766
1326,gildas-lormeau/SingleFile,1,v,1,0,0,66,67,0 days 00:00:00.405834
1327,sveltejs/kit,1,kit.svelte.dev@,0,0,0,1,1,0 days 00:00:00.297612
1328,dotansimha/graphql-code-generator,60, @graphql-codegen/typescript-enum-array@ @graphql-codegen/visitor-plugin-common@ @graphql-codegen/typescript-react-query@ @graphql-codegen/typescript-graphql-files-modules@ @graphql-codegen/java@ @graphql-codegen/time@ @graphql-codegen/gql-tag-operations-preset@ @graphql-codegen/core@ @graphql-codegen/flow-operations@ @graphql-codegen/kotlin@ @graphql-codegen/fragment-matcher@ @graphql-codegen/typescript-resolvers@ @graphql-codegen/near-operation-file-preset@ @graphql-codegen/named-operations-object@ @graphql-codegen/flow-resolvers@ @graphql-codegen/jsdoc@ @graphql-codegen/typescript-compatibility@ @graphql-codegen/typescript-urql-graphcache@ @graphql-codegen/hasura-allow-list@ @graphql-codegen/typescript-operations@ @graphql-codegen/typescript-graphql-apollo@ @graphql-codegen/c-sharp@ @graphql-codegen/java-apollo-android@ @graphql-codegen/graphql-modules-preset@ @graphql-codegen/import-types-preset@ @graphql-codegen/typescript-apollo-client-helpers@ @graphql-codegen/add@ @graphql-codegen/typescript-mongodb@ @graphql-codegen/c-sharp-operations@ @graphql-codegen/typescript-oclif@ @graphql-codegen/typescript-document-nodes@ @graphql-codegen/typescript-jit-sdk@ @graphql-codegen/java-common@ @graphql-codegen/introspection@ @graphql-codegen/typescript-msw@ @graphql-codegen/urql-introspection@ @graphql-codegen/typescript-react-offix@ @graphql-codegen/cli@ @graphql-codegen/typescript-type-graphql@ @graphql-codegen/typescript-generic-sdk@ @graphql-codegen/typescript-vue-apollo-smart-ops@ @graphql-codegen/typescript-rtk-query@ @graphql-codegen/typescript-vue-apollo@ @graphql-codegen/typescript-react-apollo@ @graphql-codegen/schema-ast@ @graphql-codegen/typescript-urql@ @graphql-codegen/typescript-apollo-angular@ @graphql-codegen/flow@ @graphql-codegen/typed-document-node@ @graphql-codegen/typescript-graphql-request@ @graphql-codegen/typescript@ @graphql-codegen/java-resolvers@ @graphql-codegen/typescript-vue-urql@ @graphql-codegen/gql-tag-operations@ v @graphql-cli/codegen@ @graphql-codegen/typescript-stencil-apollo@ @graphql-codegen/plugin-helpers@ @graphql-codegen/urql-svelte-operations-store@,60,26,2,1553,1613,0 days 00:00:03.483094
1329,pmndrs/jotai,1,v,24,17,1,88,112,0 days 00:00:00.080109
1330,scrapinghub/portia,3,slybot_ slybot- portia-,4,1,1,16,20,0 days 00:00:00.134913
1331,jprichardson/node-fs-extra,2, v,43,18,12,42,85,0 days 00:00:00.073161
1332,shipshapecode/tether,1,v,13,6,4,60,73,0 days 00:00:00.074095
1333,nextapps-de/flexsearch,1,,4,2,1,13,17,0 days 00:00:00.023065
1334,golang/protobuf,1,v,6,0,5,10,16,0 days 00:00:00.052570
1335,welldone-software/why-did-you-render,2,v. v,19,8,6,67,86,0 days 00:00:00.048544
1336,listen1/listen1_chrome_extension,1,v,32,22,7,36,68,0 days 00:00:00.045412
1337,wkentaro/labelme,1,v,50,38,9,125,175,0 days 00:00:00.124060
1338,phpspec/prophecy,2, v,16,0,13,24,40,0 days 00:00:00.049723
1339,MarshallOfSound/Google-Play-Music-Desktop-Player-UNOFFICIAL-,2, v,26,17,3,32,58,0 days 00:00:00.204370
1340,linkerd/linkerd2,3,edge- v stable-,17,2,6,222,239,0 days 00:00:00.414672
1341,James-Yu/LaTeX-Workshop,1,v,89,74,1,126,215,0 days 00:00:00.380425
1342,restsharp/RestSharp,2, v,30,14,10,29,59,0 days 00:00:00.105964
1343,MonoGame/MonoGame,2, v,12,1,9,4,16,0 days 00:00:00.592227
1344,blevesearch/bleve,1,v,14,4,7,27,41,0 days 00:00:00.133754
1345,cats-oss/android-gpuimage,1,v,3,0,2,9,12,0 days 00:00:00.031298
1346,google/go-cloud,9, pubsub/kafkapubsub/v secrets/vault/v pubsub/natspubsub/v v pubsub/rabbitpubsub/v secrets/hashivault/v runtimevar/etcdvar/v docstore/mongodocstore/v,25,14,6,63,88,0 days 00:00:00.126603
1347,giampaolo/psutil,1,release-,32,8,17,52,84,0 days 00:00:00.251443
1348,gskinner/regexr,1,,5,2,1,6,11,0 days 00:00:00.021588
1349,kubernetes-sigs/kustomize,10,kustomize/v kstatus/v kyaml/v cmd/kubectl/v cmd/config/v v api/v cmd/resource/v pluginator/v pseudo/k8s/v,33,14,9,249,282,0 days 00:00:00.532292
1350,tsayen/dom-to-image,1,,13,7,3,23,36,0 days 00:00:00.137912
1351,libgit2/libgit2,1,v,29,7,16,48,77,0 days 00:00:00.893679
1352,evolus/pencil,1,v,2,0,1,4,6,0 days 00:00:00.079530
1353,nilaoda/N_m3u8DL-CLI,1,,18,9,3,65,83,0 days 00:00:00.041470
1354,cesanta/mongoose,1,,43,12,22,1,44,0 days 00:00:00.183586
1355,GeekyAnts/vue-native-core,2, v,3,0,2,6,9,0 days 00:00:00.027660
1356,stanfordnlp/CoreNLP,1,v,11,1,8,12,23,0 days 00:00:00.833152
1357,microsoft/reactxp,1,,1,0,0,1,2,0 days 00:00:00.066916
1358,nodejs/node-gyp,2, v,37,7,18,98,135,0 days 00:00:00.106083
1359,node-schedule/node-schedule,2, v,10,3,5,36,46,0 days 00:00:00.036134
1360,acornjs/acorn,3, walk- v,53,23,13,66,119,0 days 00:00:00.253077
1361,cytoscape/cytoscape.js,1,v,29,10,13,198,227,0 days 00:00:00.776415
1362,jwtk/jjwt,1,,11,4,6,15,26,0 days 00:00:00.037722
1363,projectdiscovery/nuclei,2,v. v,10,2,6,43,53,0 days 00:00:00.301384
1364,ludwig-ai/ludwig,1,v,5,0,4,17,22,0 days 00:00:00.135494
1365,reactphp/reactphp,1,v,7,0,5,14,21,0 days 00:00:00.047119
1366,KurtBestor/Hitomi-Downloader,1,v,17,3,8,0,17,0 days 00:00:00.016407
1367,rq/rq,2, v,24,2,15,44,68,0 days 00:00:00.111687
1368,espressif/esp-idf,1,v,13,0,11,41,54,0 days 00:00:01.978557
1369,felixse/FluentTerminal,1,,5,0,3,26,31,0 days 00:00:00.038293
1370,vector-im/element-web,1,v,27,9,9,172,199,0 days 00:00:00.747211
1371,borgbackup/borg,1,,22,13,5,36,58,0 days 00:00:00.430671
1372,Nozbe/WatermelonDB,1,v,19,5,6,17,36,0 days 00:00:00.193853
1373,Perfare/AssetStudio,1,v,10,0,8,13,23,0 days 00:00:00.038495
1374,chocolatey/choco,1,,5,1,2,38,43,0 days 00:00:00.182641
1375,sebastianbergmann/php-code-coverage,1,,23,4,13,138,161,0 days 00:00:00.159725
1376,junit-team/junit4,1,r,8,1,6,5,13,0 days 00:00:00.394192
1377,ag-grid/ag-grid,2, v,87,62,5,103,190,0 days 00:00:01.335475
1378,panjf2000/ants,1,v,9,4,4,15,24,0 days 00:00:00.035060
1379,benoitc/gunicorn,1,,31,12,14,51,82,0 days 00:00:00.128848
1380,myclabs/DeepCopy,1,,12,1,10,18,30,0 days 00:00:00.022331
1381,uber/react-vis,2, v,22,14,3,77,99,0 days 00:00:00.065358
1382,dat-ecosystem-archive/dat,1,v,43,31,8,64,107,0 days 00:00:00.119832
1383,sshuttle/sshuttle,2,sshuttle- v,29,13,7,11,40,0 days 00:00:00.068008
1384,cakephp/cakephp,1,,28,0,27,330,358,0 days 00:00:02.903659
1385,MahApps/MahApps.Metro,1,,21,5,11,33,54,0 days 00:00:00.388081
1386,sumatrapdfreader/sumatrapdf,1,,1,0,0,0,1,0 days 00:00:00.625978
1387,agenda/agenda,2, v,20,5,11,65,85,0 days 00:00:00.073267
1388,square/moshi,1,moshi-parent-,15,1,12,4,19,0 days 00:00:00.067977
1389,zinclabs/zinc,1,v,2,0,1,10,12,0 days 00:00:00.019182
1390,protobufjs/protobuf.js,2, v,23,11,6,55,78,0 days 00:00:00.085685
1391,ReFirmLabs/binwalk,2,v python,5,0,4,5,10,0 days 00:00:00.062975
1392,gridsome/gridsome,22,@gridsome/transformer-csv@ @gridsome/source-graphql@ @gridsome/transformer-remark@ @gridsome/source-strapi@ @gridsome/source-faker@ @gridsome/remark-prismjs@ @gridsome/source-drupal@ @gridsome/source-airtable@ @gridsome/source-ghost@ @gridsome/transformer-yaml@ @gridsome/plugin-sitemap@ @gridsome/source-filesystem@ @gridsome/plugin-critical@ gridsome@ @gridsome/transformer-json@ @gridsome/source-wordpress@ @gridsome/cli@ @gridsome/source-datocms@ @gridsome/vue-remark@ @gridsome/source-contentful@ @gridsome/plugin-google-analytics@ v,7,0,0,239,246,0 days 00:00:00.147355
1393,jopohl/urh,1,v,17,8,7,74,91,0 days 00:00:00.251766
1394,coil-kt/coil,1,,15,5,6,12,27,0 days 00:00:00.168556
1395,google/or-tools,1,v,32,7,8,3,35,0 days 00:00:00.572268
1396,pre-commit/pre-commit,1,v,60,32,9,111,171,0 days 00:00:00.136795
1397,YOURLS/YOURLS,1,,8,0,5,14,22,0 days 00:00:00.095253
1398,sogou/workflow,1,v,1,0,0,12,13,0 days 00:00:00.084019
1399,devhubapp/devhub,2, v,55,47,3,61,116,0 days 00:00:00.199244
1400,symfony/http-foundation,1,v,26,4,20,464,490,0 days 00:00:00.497866
1401,dropwizard/dropwizard,1,v,15,1,11,119,134,0 days 00:00:00.571386
1402,NG-ZORRO/ng-zorro-antd,1,,41,30,5,65,106,0 days 00:00:00.276298
1403,text-mask/text-mask,11, core-v vue-v angular2-v addons-v ember-v vanilla-v v text-mask-v angular1-v react-v,55,21,6,245,300,0 days 00:00:00.137484
1404,tidwall/tile38,1,,27,6,7,59,86,0 days 00:00:00.067909
1405,BuilderIO/partytown,1,v,6,4,0,54,60,0 days 00:00:00.059573
1406,sass/node-sass,4, napi_ v RELEASE-,45,16,18,114,159,0 days 00:00:00.439763
1407,facebook/buck,1,v,0,0,0,61,61,0 days 00:00:01.369100
1408,lima-vm/lima,1,v,11,6,1,16,27,0 days 00:00:00.076412
1409,apache/tvm,1,v,7,0,6,1,8,0 days 00:00:00.396258
1410,rawgraphs/rawgraphs-app,3, v. v,3,0,2,5,8,0 days 00:00:00.036604
1411,Shopify/toxiproxy,1,v,8,0,4,11,19,0 days 00:00:00.033405
1412,goplus/gop,1,v,5,0,4,91,96,0 days 00:00:00.133912
1413,bloomrpc/bloomrpc,2, v,6,2,3,9,15,0 days 00:00:00.017353
1414,ninja-build/ninja,2,release- v,14,1,10,12,26,0 days 00:00:00.143566
1415,googleapis/google-api-php-client,2, v,13,2,8,32,45,0 days 00:00:00.223063
1416,gitpod-io/gitpod,4, production_ v poolkeeper-v,10,5,3,5,15,0 days 00:00:00.468398
1417,alibaba/atlas,2, v,4,1,0,14,18,0 days 00:00:00.071531
1418,hediet/vscode-drawio,1,v,10,6,2,13,23,0 days 00:00:00.030215
1419,OpenFeign/feign,3, release- v,72,48,10,54,126,0 days 00:00:00.097977
1420,symfony/event-dispatcher,1,v,26,4,21,436,462,0 days 00:00:00.360252
1421,olivernn/lunr.js,1,v,12,1,6,46,58,0 days 00:00:00.047655
1422,foliojs/pdfkit,1,v,8,0,7,12,20,0 days 00:00:00.047363
1423,mawww/kakoune,1,v,1,0,0,13,14,0 days 00:00:00.478652
1424,knadh/listmonk,1,v,4,1,2,0,4,0 days 00:00:00.055682
1425,maurosoria/dirsearch,1,v,2,0,1,12,14,0 days 00:00:00.098127
1426,VulcanJS/Vulcan,2, v,22,11,6,45,67,0 days 00:00:00.397199
1427,microsoft/react-native-code-push,2, v,11,0,7,20,31,0 days 00:00:00.079118
1428,resilience4j/resilience4j,3, v. v,22,5,9,15,37,0 days 00:00:00.074648
1429,microsoft/pyright,1,,2,0,1,328,330,0 days 00:00:00.560565
1430,MetaMask/metamask-extension,5, Version- Version v v.,82,70,4,239,321,0 days 00:00:01.019930
1431,amitshekhariitbhu/Android-Debug-Database,1,v,6,4,0,6,12,0 days 00:00:00.027145
1432,openshift/origin,1,v,14,2,10,25,39,0 days 00:00:01.678102
1433,paragonie/random_compat,2, v,7,3,1,54,61,0 days 00:00:00.045502
1434,Koenkk/zigbee2mqtt,1,,28,16,5,33,61,0 days 00:00:00.213361
1435,PaddlePaddle/PaddleHub,2, v,12,3,1,10,22,0 days 00:00:00.243401
1436,happyfish100/fastdfs,1,V,16,7,5,0,16,0 days 00:00:00.021832
1437,graphql/graphql-playground,9, graphql-playground-middleware-express@ graphql-playground-middleware-hapi@ graphql-playground-html@ v graphql-playground-middleware-koa@ graphql-playground-middleware-lambda@ graphql-playground-react@ graphql-playground-electron@,9,4,1,92,101,0 days 00:00:00.176337
1438,electron/electron-packager,1,v,53,30,10,42,95,0 days 00:00:00.088037
1439,square/okio,3, okio-parent- parent-,36,14,12,13,49,0 days 00:00:00.081221
1440,abpframework/abp,2, v,43,33,3,60,103,0 days 00:00:01.451155
1441,rofl0r/proxychains-ng,1,v,16,3,10,1,17,0 days 00:00:00.029126
1442,OpenIMSDK/Open-IM-Server,1,v,3,1,1,15,18,0 days 00:00:00.086999
1443,pypa/pip,1,,36,2,27,73,109,0 days 00:00:00.729281
1444,shwenzhang/AndResGuard,1,,3,1,1,35,38,0 days 00:00:00.035940
1445,jbogard/MediatR,1,v,12,0,9,6,18,0 days 00:00:00.035110
1446,dotnet/machinelearning,1,v,18,12,4,5,23,0 days 00:00:00.174302
1447,symfony/finder,1,v,26,4,20,440,466,0 days 00:00:00.335037
1448,sockjs/sockjs-client,1,v,11,1,7,20,31,0 days 00:00:00.055030
1449,keybase/client,2, v,29,21,5,65,94,0 days 00:00:02.226616
1450,Stuk/jszip,1,v,19,5,11,14,33,0 days 00:00:00.051606
1451,apache/dolphinscheduler,1,,5,0,4,19,24,0 days 00:00:00.532393
1452,gwuhaolin/livego,1,,0,0,0,13,13,0 days 00:00:00.020017
1453,VowpalWabbit/vowpal_wabbit,3, v r_l.snapshot.,33,3,22,10,43,0 days 00:00:00.520504
1454,ng-bootstrap/ng-bootstrap,1,,27,12,6,49,76,0 days 00:00:00.129425
1455,sahat/satellizer,1,,14,7,4,41,55,0 days 00:00:00.249490
1456,dexie/Dexie.js,1,v,9,0,8,24,33,0 days 00:00:00.117797
1457,rematch/rematch,8, @rematch/typed-state@ @rematch/persist@ @rematch/updated@ @rematch/select@ @rematch/core@ @rematch/immer@ @rematch/loading@,16,4,6,46,62,0 days 00:00:00.284137
1458,szimek/signature_pad,1,v,11,3,4,19,30,0 days 00:00:00.170255
1459,firefly-iii/firefly-iii,1,,41,19,8,201,242,0 days 00:00:01.217316
1460,smicallef/spiderfoot,1,v,8,1,6,1,9,0 days 00:00:00.404310
1461,airbnb/epoxy,1,,41,26,5,22,63,0 days 00:00:00.040629
1462,arrow-py/arrow,1,,17,2,12,37,54,0 days 00:00:00.087173
1463,ChrisRM/material-theme-jetbrains,2, v,83,68,2,163,246,0 days 00:00:00.235039
1464,grommet/grommet,2, v,41,18,8,76,117,0 days 00:00:00.357523
1465,adrai/flowchart.js,1,v,17,4,9,31,48,0 days 00:00:00.030106
1466,PostHog/posthog,1,,37,33,0,25,62,0 days 00:00:00.461096
1467,doitsujin/dxvk,1,v,40,30,5,32,72,0 days 00:00:00.222818
1468,Jguer/yay,1,v,49,33,9,26,75,0 days 00:00:00.247913
1469,Pikaday/Pikaday,1,,9,1,7,6,15,0 days 00:00:00.031043
1470,JustArchiNET/ArchiSteamFarm,1,,167,154,10,431,598,0 days 00:00:00.892951
1471,hs-web/hsweb-framework,3, v V,3,0,2,12,15,0 days 00:00:00.116460
1472,coturn/coturn,2,upstream/ ,13,4,5,43,56,0 days 00:00:00.072212
1473,mediaelement/mediaelement,1,,32,8,12,117,149,0 days 00:00:00.358098
1474,qutebrowser/qutebrowser,1,v,32,4,16,49,81,0 days 00:00:01.378215
1475,tiangolo/typer,1,,4,1,1,15,19,0 days 00:00:00.030109
1476,reduxjs/redux-toolkit,3, v @rtk-query/graphql-request-base-query@,19,8,6,38,57,0 days 00:00:00.097516
1477,hackmdio/codimd,2, v,10,0,7,16,26,0 days 00:00:00.154767
1478,mjmlio/mjml,3, v V,25,8,11,50,75,0 days 00:00:00.135344
1479,d2l-ai/d2l-en,1,v,8,1,4,17,25,0 days 00:00:00.211817
1480,scylladb/scylla,1,scylla-,33,11,10,130,163,0 days 00:00:01.931438
1481,huggingface/datasets,1,,26,21,1,26,52,0 days 00:00:00.305869
1482,wtfutil/wtf,2, v,41,29,1,26,67,0 days 00:00:00.255793
1483,ArchiveBox/ArchiveBox,1,v,3,0,2,24,27,0 days 00:00:00.127935
1484,justauth/JustAuth,3, v. v,14,9,2,25,39,0 days 00:00:00.042103
1485,zalmoxisus/redux-devtools-extension,2, v,27,23,2,43,70,0 days 00:00:00.054192
1486,google/cadvisor,2, v,45,20,15,71,116,0 days 00:00:00.394321
1487,openzfs/zfs,1,zfs-,6,0,5,60,66,0 days 00:00:02.069989
1488,grpc-ecosystem/grpc-gateway,1,v,28,10,10,43,71,0 days 00:00:00.117576
1489,fabric/fabric,1,,26,4,19,97,123,0 days 00:00:00.331597
1490,automerge/automerge,1,v,13,4,6,20,33,0 days 00:00:00.045408
1491,verdaccio/verdaccio,1,v,64,34,13,148,212,0 days 00:00:00.350740
1492,simple-icons/simple-icons,2, v,116,115,0,27,143,0 days 00:00:00.478520
1493,MithrilJS/mithril.js,3,ospec_v v ospec-v,7,2,3,55,62,0 days 00:00:00.308737
1494,powerline/powerline,1,,13,3,7,10,23,0 days 00:00:00.130787
1495,Tencent/APIJSON,1,,37,21,7,51,88,0 days 00:00:00.173145
1496,orhanobut/logger,2, v,13,6,4,1,14,0 days 00:00:00.020205
1497,android-hacker/VirtualXposed,2, v,12,3,3,55,67,0 days 00:00:00.130702
1498,getgrav/grav,1,,13,3,8,170,183,0 days 00:00:00.498480
1499,authelia/authelia,1,v,55,39,5,114,169,0 days 00:00:00.385355
1500,woocommerce/woocommerce,3, @woocommerce/e2e-environment@ v,50,28,17,349,399,0 days 00:00:03.298879
1501,shelljs/shelljs,1,v,6,0,4,33,39,0 days 00:00:00.052794
1502,apache/incubator-brpc,2, v,3,0,2,3,6,0 days 00:00:00.126966
1503,openjdk/jdk,0,,0,0,0,0,0,0 days 00:00:00.233178
1504,microsoft/recommenders,1,,9,0,7,2,11,0 days 00:00:00.407752
1505,Budibase/budibase,1,v,10,5,3,479,489,0 days 00:00:01.586805
1506,RaRe-Technologies/gensim,1,,23,6,11,36,59,0 days 00:00:00.234908
1507,liabru/matter-js,1,,10,1,7,8,18,0 days 00:00:00.048521
1508,python/mypy,1,v,59,38,8,7,66,0 days 00:00:00.624642
1509,microsoft/AirSim,2,v. v,3,1,1,15,18,0 days 00:00:00.247562
1510,timescale/timescaledb,1,,28,8,8,33,61,0 days 00:00:00.233505
1511,aws-amplify/amplify-js,31, @aws-amplify/interactions@ amazon-cognito-identity-js@ @aws-amplify/api-rest@ @aws-amplify/storage@ @aws-amplify/datastore-storage-adapter@ aws-amplify-react@ @aws-amplify/ui@ @aws-amplify/analytics@ @aws-amplify/core@ @aws-amplify/predictions@ @aws-amplify/pushnotification@ @aws-amplify/ui-storybook@ @aws-amplify/api-graphql@ aws-amplify@ @aws-amplify/ui-react@ @aws-amplify/ui-vue@ @aws-amplify/pubsub@ aws-amplify-angular@ @aws-amplify/cache@ @aws-amplify/geo@ aws-amplify-react-naitve@ @aws-amplify/ui-angular@ aws-amplify-react-native@ @aws-amplify/auth@ aws-amplify-vue@ @aws-amplify/datastore@ v @aws-amplify/xr@ @aws-amplify/api@ @aws-amplify/ui-components@,54,0,0,3284,3338,0 days 00:00:15.426837
1512,remotion-dev/remotion,1,v,14,8,1,81,95,0 days 00:00:00.424995
1513,flipped-aurora/gin-vue-admin,3,v. v V,7,2,2,21,28,0 days 00:00:00.114127
1514,ahmetb/kubectx,1,v,9,2,5,11,20,0 days 00:00:00.025690
1515,mdx-js/mdx,2, v,26,19,5,140,166,0 days 00:00:00.152024
1516,MarlinFirmware/Marlin,1,,2,0,1,37,39,0 days 00:00:01.229125
1517,keepassxreboot/keepassxc,1,,8,0,7,29,37,0 days 00:00:00.228509
1518,txthinking/brook,1,v,43,22,6,0,43,0 days 00:00:00.046611
1519,pavlobu/deskreen,1,v,1,0,0,12,13,0 days 00:00:00.022460
1520,Konloch/bytecode-viewer,5, b B b. v,17,13,1,41,58,0 days 00:00:00.074029
1521,the1812/Bilibili-Evolved,1,v,7,0,6,74,81,0 days 00:00:00.507802
1522,brix/crypto-js,2, release-,4,2,1,10,14,0 days 00:00:00.022079
1523,eclipse-vertx/vert.x,4, _old/v Eclipse_Initial_Contribution_ v,18,0,15,57,75,0 days 00:00:00.487134
1524,microsoft/WSL,1,,2,0,1,9,11,0 days 00:00:00.019671
1525,modood/Administrative-divisions-of-China,1,,9,1,7,7,16,0 days 00:00:00.021107
1526,mockito/mockito,1,v,58,32,10,409,467,0 days 00:00:00.542785
1527,xtermjs/xterm.js,1,,76,52,7,35,111,0 days 00:00:00.563486
1528,redwoodjs/redwood,2, v,57,53,1,71,128,0 days 00:00:00.487971
1529,termux/termux-app,1,v,89,73,7,0,89,0 days 00:00:00.081829
1530,Unity-Technologies/ml-agents,5,com.unity.ml-agents_  python-packages_ release_ v,57,15,6,33,90,0 days 00:00:00.260439
1531,jsdoc/jsdoc,11, @jsdoc/prettier-config@ @jsdoc/task-runner@ @jsdoc/util@ @jsdoc/test-matchers@ @jsdoc/cli@ @jsdoc/parse@ @jsdoc/eslint-config@ @jsdoc/core@ v @jsdoc/tag@,12,1,6,99,111,0 days 00:00:00.142874
1532,xtaci/kcptun,2, v,106,79,7,0,106,0 days 00:00:00.085942
1533,arduino/Arduino,1,,26,5,13,46,72,0 days 00:00:00.451993
1534,bcicen/ctop,2, v,5,2,2,11,16,0 days 00:00:00.035756
1535,selectize/selectize.js,1,v,12,5,2,64,76,0 days 00:00:00.060595
1536,WerWolv/ImHex,1,v,19,14,2,12,31,0 days 00:00:00.071177
1537,gionkunz/chartist-js,1,v,11,6,4,47,58,0 days 00:00:00.052845
1538,GoogleContainerTools/skaffold,1,v,80,76,1,29,109,0 days 00:00:00.645024
1539,wechaty/wechaty,1,v,15,4,7,8,23,0 days 00:00:00.316871
1540,ether/etherpad-lite,1,,8,0,7,50,58,0 days 00:00:00.442796
1541,http-party/node-http-proxy,2, v,27,11,13,70,97,0 days 00:00:00.101962
1542,filp/whoops,1,,18,6,8,50,68,0 days 00:00:00.078798
1543,kubernetes/ingress-nginx,6, controller- ingress-nginx- helm-chart- controller-v nginx-,100,73,7,75,175,0 days 00:00:00.510658
1544,Semantic-Org/Semantic-UI-React,1,v,93,78,5,211,304,0 days 00:00:00.434336
1545,reduxjs/redux-devtools,48,@redux-devtools/inspector-monitor-test-tab@ remotedev-redux-devtools-extension@ remotedev-serialize@ react-base16-styling@ react-dock-demo@ d3tooltip@ redux-devtools-dock-monitor@ redux-devtools-test-generator@ redux-devtools@ @redux-devtools/instrument@ redux-devtools-log-monitor@ redux-devtools-chart-monitor@ redux-devtools-instrument@ react-json-tree@ react-json-tree-example@ redux-devtools-serialize@ redux-devtools-testing@ @redux-devtools/ui@ react-dock@ redux-devtools-trace-monitor@ rtk-query-demo@ @redux-devtools/log-monitor@ counter-redux@ @redux-devtools/utils@ inspector-demo@ redux-devtools-extension@ todomvc@ @redux-devtools/inspector-monitor@ @redux-devtools/inspector-monitor-trace-tab@ test-demo@ d3-state-visualizer@ map2tree@ react-json-tree-testing@ @redux-devtools/chart-monitor@ @redux-devtools/core@ @redux-devtools/extension@ redux-devtools-inspector@ @redux-devtools/rtk-query-monitor@ @redux-devtools/cli@ slider-todomvc@ extension@ @redux-devtools/dock-monitor@ @redux-devtools/remote@ @redux-devtools/serialize@ v @redux-devtools/app@ d3-state-visualizer-tree-example@ @redux-devtools/slider-monitor@,41,8,6,260,301,0 days 00:00:00.203943
1546,google/gvisor,1,release-,99,93,1,0,99,0 days 00:00:00.369863
1547,nrwl/nx,1,,75,66,0,218,293,0 days 00:00:00.572530
1548,DIYgod/DPlayer,2, v,21,12,5,21,42,0 days 00:00:00.077681
1549,CachetHQ/Cachet,1,v,7,1,2,30,37,0 days 00:00:00.234430
1550,you-dont-need/You-Dont-Need-Momentjs,1,v,6,3,2,5,11,0 days 00:00:00.022839
1551,dutchcoders/transfer.sh,1,v,5,0,4,13,18,0 days 00:00:00.044542
1552,flarum/flarum,1,v,3,0,2,0,3,0 days 00:00:00.031518
1553,Foundry376/Mailspring,1,,11,1,6,43,54,0 days 00:00:00.445202
1554,rwaldron/johnny-five,2, v,14,3,7,73,87,0 days 00:00:00.159744
1555,formatjs/formatjs,37,@formatjs/intl-localematcher@ @formatjs/icu-messageformat-parser@ @formatjs/intl-numberformat@ intl-format-cache@ @formatjs/intl-utils@ @formatjs/cli@ eslint-plugin-formatjs@ babel-plugin-react-intl@ intl-messageformat-parser@ @formatjs/intl-listformat@ @formatjs/macro@ intl-messageformat@ website@ @formatjs/ecma402-abstract@ @formatjs/fast-memoize@ @formatjs/intl-displaynames@ @formatjs/icu-skeleton-parser@ @formatjs/intl-unified-numberformat@ formatjs-website@ @formatjs/intl@ @formatjs/editor@ @formatjs/swc-plugin@ react-intl@ formatjs-extract-cldr-data@ @formatjs/ts-transformer@ @formatjs/vue-intl@ @formatjs/intl-datetimeformat@ @formatjs/intl-locale@ @formatjs/intl-getcanonicallocales@ @formatjs/ecma376@ @formatjs/intl-pluralrules@ intl-locales-supported@ @formatjs/ecma-376@ v vue-intl@ @formatjs/intl-relativetimeformat@ babel-plugin-formatjs@,130,26,9,2030,2160,0 days 00:00:06.256315
1556,umijs/qiankun,1,v,14,4,7,92,106,0 days 00:00:00.068383
1557,NodeBB/NodeBB,1,v,30,2,17,93,123,0 days 00:00:01.344652
1558,faressoft/terminalizer,1,v,6,3,1,25,31,0 days 00:00:00.021716
1559,Intervention/image,1,,15,3,8,93,108,0 days 00:00:00.068537
1560,redux-form/redux-form,1,v,46,30,8,141,187,0 days 00:00:00.283195
1561,revel/revel,1,v,18,4,10,7,25,0 days 00:00:00.081740
1562,BrainJS/brain.js,1,,4,0,1,16,20,0 days 00:00:00.039007
1563,ory/hydra,3, sdk/go/hydra/v v,20,10,6,126,146,0 days 00:00:00.187249
1564,pulumi/pulumi,3,sdk/v v pkg/v,90,81,3,393,483,0 days 00:00:00.756653
1565,aleju/imgaug,1,,3,0,2,9,12,0 days 00:00:00.126814
1566,adonisjs/core,3,@adonisjs/framework@ v @adonisjs/framework@v,24,14,8,139,163,0 days 00:00:00.133620
1567,onnx/onnx,1,v,13,1,10,9,22,0 days 00:00:00.253616
1568,google/yapf,2,yapf-v v,31,14,10,34,65,0 days 00:00:00.068982
1569,apache/hadoop,3,rel/release- rel/submarine- release-,39,1,16,92,131,0 days 00:00:03.076694
1570,charmbracelet/bubbletea,1,v,20,14,4,27,47,0 days 00:00:00.044179
1571,uxsolutions/bootstrap-datepicker,2, v,10,0,8,13,23,0 days 00:00:00.079106
1572,facebook/stetho,1,v,7,0,5,6,13,0 days 00:00:00.037238
1573,moment/luxon,1,,37,21,6,69,106,0 days 00:00:00.073648
1574,showdownjs/showdown,2, v,14,3,7,42,56,0 days 00:00:00.049974
1575,pqina/filepond,1,,52,41,4,143,195,0 days 00:00:00.093663
1576,thephpleague/flysystem,1,,13,2,6,175,188,0 days 00:00:00.395285
1577,eclipse/deeplearning4j,2,_old/deeplearning4j- _old/deeplearning4j-parent-,9,3,3,16,25,0 days 00:00:00.841233
1578,CodisLabs/codis,1,,3,0,2,33,36,0 days 00:00:00.078763
1579,psf/requests-html,1,v,8,6,1,22,30,0 days 00:00:00.030866
1580,horovod/horovod,1,v,16,3,10,53,69,0 days 00:00:00.079701
1581,myliang/x-spreadsheet,1,v,1,0,0,26,27,0 days 00:00:00.032960
1582,signalapp/Signal-Desktop,2,v c,124,110,5,169,293,0 days 00:00:00.644234
1583,aws/aws-cli,1,,46,24,17,1642,1688,0 days 00:00:03.714740
1584,saltstack/salt,2,v old-branch-,62,22,20,151,213,0 days 00:00:06.466755
1585,aio-libs/aiohttp,4, 4v v. v,38,15,9,124,162,0 days 00:00:00.494368
1586,OptimalBits/bull,2, v,49,26,13,84,133,0 days 00:00:00.126161
1587,openstf/stf,1,v,12,4,7,16,28,0 days 00:00:00.100176
1588,bvaughn/react-window,1,,4,2,1,16,20,0 days 00:00:00.027677
1589,keycloak/keycloak,1,,16,3,7,21,37,0 days 00:00:00.670430
1590,apollographql/apollo-server,36,apollo-engine-reporting@ apollo-server-cache-memcached@ apollo-server-azure-functions@ @apollo/federation@ apollo-server-testing@ apollo-server-lambda@ apollo-server-express@ apollo-server-fastify@ graphql-extensions@ apollo-server-errors@ apollo-server-koa@ publish/ apollo-server-cloud-functions@ apollo-server@ apollo-engine-reporting-protobuf@ apollo-tracing@ apollo-datasource@ apollo-server-integration-testsuite@ apollo-server-caching@ apollo-server-plugin-response-cache@ apollo-graphql@ apollo-cache-control@ apollo-server-core@ apollo-server-types@ apollo-server-plugin-base@ apollo-server-cache-redis@ apollo-server-hapi@ @apollo/gateway@ apollo-server-micro@ apollo-datasource-rest@ apollo-server-env@ apollo-reporting-protobuf@ v apollo-server-cloudflare@ apollo-server-plugin-operation-registry@ apollo-federation-integration-testsuite@,247,89,2,2316,2563,0 days 00:00:10.977768
1591,google/tink,3,go/v v go/integration/hcvault/v,7,0,6,9,16,0 days 00:00:00.212286
1592,josdejong/mathjs,1,v,109,83,4,118,227,0 days 00:00:00.378099
1593,umijs/umi,37,umi-ui-tasks@ umi@ umi-server@ umi-buildAndDev@ umi-ui@ umi-plugin-routes@ umi% umi-core@ umi-plugin-es5-imcompatible-versions@ eslint-config-umi@ umi-ui-theme@ umi-plugin-dva@ umi-router@ umi-library@ umi-test@ umi-serve@ umi-plugin-modern-mode@ umi-plugin-ui@ umi-build-dev@ umi-plugin-react@ umi-plugin-yunfengdie@ umi-plugin-prerender@ umi-mock@ umi-plugin-polyfills@ umi-types@ af-webpack@ umi-plugin-auto-externals@ umi-plugin@ umi-plugin-hd@ umi-plugin-locale@ umi-plugin-polyfill@ umi-utils@ v umi-plugin-datahub@ babel-preset-umi@ @umijs/plugin-prerender@ umi-plugin-dll@,62,6,4,1402,1464,0 days 00:00:02.437851
1594,pyecharts/pyecharts,1,v,14,4,6,29,43,0 days 00:00:00.274378
1595,barryvdh/laravel-ide-helper,1,v,25,8,15,61,86,0 days 00:00:00.060037
1596,kovidgoyal/calibre,2, v,252,251,0,57,309,0 days 00:00:02.616576
1597,MaterialDesignInXAML/MaterialDesignInXamlToolkit,2, v,21,5,12,12,33,0 days 00:00:00.111159
1598,uuidjs/uuid,1,v,16,6,8,21,37,0 days 00:00:00.232805
1599,surmon-china/vue-awesome-swiper,2, v,14,5,5,36,50,0 days 00:00:00.026059
1600,zhihu/Matisse,1,v,0,0,0,3,3,0 days 00:00:00.016402
1601,qmk/qmk_firmware,10, breakpoint_ LUFA- preonic- ergodox_ez- planck- v planck-light- gh60- drop-,29,0,20,1440,1469,0 days 00:00:04.274364
1602,go-sql-driver/mysql,2,v beta,10,2,6,8,18,0 days 00:00:00.045018
1603,tensorflow/tensor2tensor,3, v. v,15,5,4,61,76,0 days 00:00:00.181823
1604,gunthercox/ChatterBot,1,,10,0,9,65,75,0 days 00:00:00.086582
1605,GoogleCloudPlatform/microservices-demo,1,v,3,0,2,16,19,0 days 00:00:00.043085
1606,danilowoz/react-content-loader,2, v,16,6,8,27,43,0 days 00:00:00.030817
1607,liriliri/eruda,1,v,15,6,5,40,55,0 days 00:00:00.043158
1608,antlr/antlr4,3, v antlr4-master-,11,1,9,15,26,0 days 00:00:00.527574
1609,gaearon/react-hot-loader,2, v,25,13,6,107,132,0 days 00:00:00.128271
1610,OpenAPITools/openapi-generator,2, v,16,2,11,38,54,0 days 00:00:01.058536
1611,pandao/editor.md,1,v,6,4,0,14,20,0 days 00:00:00.017704
1612,linnovate/mean,2, v,4,0,3,9,13,0 days 00:00:00.081408
1613,gruntjs/grunt,1,v,7,0,5,14,21,0 days 00:00:00.068067
1614,arangodb/arangodb,3, v documentation-,31,5,18,319,350,0 days 00:00:03.125415
1615,pinpoint-apm/pinpoint,2, v,9,0,7,25,34,0 days 00:00:00.638188
1616,wkhtmltopdf/wkhtmltopdf,1,,8,4,3,31,39,0 days 00:00:00.059301
1617,11ty/eleventy,1,v,13,2,7,41,54,0 days 00:00:00.090908
1618,systemjs/systemjs,2, v,40,18,10,187,227,0 days 00:00:00.159729
1619,rt2zz/redux-persist,1,v,36,27,6,76,112,0 days 00:00:00.062428
1620,aquasecurity/trivy,1,v,28,19,2,59,87,0 days 00:00:00.170959
1621,withastro/astro,31,@astrojs/renderer-svelte@ @astrojs/test-static-build-pkg@ @astrojs/deno@ @astrojs/markdown-remark@ @astrojs/partytown@ create-astro@ @astrojs/netlify@ @astrojs/preact@ @astrojs/parser@ @astrojs/renderer-vue@ @astrojs/renderer-solid@ astro@ @astrojs/vue@ @astrojs/telemetry@ @astrojs/webapi@ @astrojs/markdown-support@ @astrojs/rss@ @astrojs/prism@ @astrojs/vercel@ @astrojs/lit@ @astrojs/tailwind@ @astrojs/sitemap@ @astrojs/node@ @astrojs/renderer-react@ @astrojs/renderer-preact@ @astrojs/react@ @astrojs/solid-js@ v @astrojs/svelte@ @astrojs/turbolinks@ @astrojs/renderer-lit@,20,0,0,248,268,0 days 00:00:00.234941
1622,wagtail/wagtail,3,caltech-upgrade-point- v ads-,40,6,13,99,139,0 days 00:00:00.839050
1623,electron-userland/electron-builder,5, docker@ electron-updater-v v electron-updater@,320,301,5,434,754,0 days 00:00:01.000370
1624,mishoo/UglifyJS,2,harmony-v v,25,4,14,306,331,0 days 00:00:00.294305
1625,visionmedia/supertest,2, v,29,8,13,29,58,0 days 00:00:00.037021
1626,lra/mackup,1,,8,4,3,53,61,0 days 00:00:00.110396
1627,Automattic/wp-calypso,23,@automattic/explat-client-react-helpers@ @automattic/calypso-babel-config@ @automattic/explat-client@ @automattic/popup-monitor@ calypso- eslint-plugin-wpcalypso@ desktop- @automattic/webpack-rtl-plugin@ @automattic/jetpack-blocks@ @automattic/babel-plugin-transform-wpcalypso-async@ @automattic/data-stores@ @automattic/effective-module-tree@ @automattic/interpolate-components@ @automattic/babel-plugin-i18n-calypso@ desktop-v desktop/ @automattic/eslint-plugin-wpcalypso@ @automattic/social-previews@ @automattic/format-currency@ wp-calypso@ i18n-calypso@ @automattic/tree-select@ v,139,118,13,47,186,0 days 00:00:02.899344
1628,casbin/casbin,1,v,68,52,5,118,186,0 days 00:00:00.102089
1629,mattboldt/typed.js,1,v,3,0,2,19,22,0 days 00:00:00.025578
1630,oliver-moran/jimp,2, v,15,8,4,71,86,0 days 00:00:00.062354
1631,ish-app/ish,3,builds/ builds/beta/ builds/iostestflight/,318,309,2,0,318,0 days 00:00:00.241882
1632,cilium/cilium,2, v,17,0,8,287,304,0 days 00:00:01.715693
1633,tabler/tabler-icons,1,v,69,65,2,15,84,0 days 00:00:00.066542
1634,sivel/speedtest-cli,1,v,5,0,4,24,29,0 days 00:00:00.025573
1635,mlflow/mlflow,2, v,35,21,1,20,55,0 days 00:00:00.193108
1636,android/compose-samples,3,dev v github/dev,5,2,1,8,13,0 days 00:00:00.090610
1637,Netflix/zuul,2,zuul- v,9,1,7,43,52,0 days 00:00:00.068796
1638,foambubble/foam,1,v,17,10,3,44,61,0 days 00:00:00.297627
1639,arut/nginx-rtmp-module,1,v,12,5,3,100,112,0 days 00:00:00.071336
1640,qax-os/excelize,1,v,11,0,10,6,17,0 days 00:00:00.057741
1641,Miserlou/Zappa,2, v,50,42,3,71,121,0 days 00:00:00.335522
1642,calcom/cal.com,3,v. v V,7,4,0,3,10,0 days 00:00:00.145635
1643,Delgan/loguru,1,,6,1,4,12,18,0 days 00:00:00.038487
1644,trufflesuite/truffle,92, truffle-blockchain-utils@ truffle-interface-adapter@ @truffle/abi-utils@ @truffle/decoder@ truffle-debug-utils@ truffle-decode-utils@ @truffle/preserve-to-filecoin@ @truffle/resolver@ truffle-hdwallet-provider@ @truffle/environment@ @truffle/encoder@ truffle-external-compile@ @truffle/debug-utils@ @truffle/db@ @truffle/source-map-utils@ @truffle/expect@ @truffle/dashboard-message-bus@ truffle-workflow-compile@ @truffle/fetch-and-compile@ @truffle/contract@ truffle-require@ v truffle-error@ truffle-deployer@ @truffle/codec@ @truffle/core@ truffle-decoder@ @truffle/require@ @truffle/preserve-fs@ @truffle/hdwallet-provider@ @truffle/provider@ @truffle/artifactor@ @truffle/solidity-loader@ @truffle/error@ truffle-provider@ truffle-resolver@ truffle-contract-schema@ @truffle/workflow-compile@ v. truffle-sawtooth-seth-provider@ @truffle/preserve@ @truffle/dashboard-provider@ truffle-provisioner@ truffle-environment@ truffle-compile-vyper@ @truffle/config@ truffle-core@ truffle-solidity-utils@ @truffle/source-fetcher@ @truffle/preserve-to-buckets@ @truffle/contract-tests@ @truffle/contract-schema@ truffle-artifactor@ @truffle/decode-utils@ truffle-compile@ truffle-solidity-loader@ truffle-contract@ @truffle/compile-solidity@ @truffle/interface-adapter@ @truffle/profiler@ @truffle/migrate@ truffle-expect@ @truffle/contract-sources@ @truffle/dashboard@ truffle-box@ @truffle/external-compile@ @truffle/db-kit@ truffle-reporters@ truffle-contract-sources@ @truffle/box@ truffle-legacy-system@ @truffle/compile-vyper@ @truffle/spinners@ @truffle/compile-common@ @truffle/db-loader@ @truffle/preserve-to-ipfs@ @truffle/debugger@ truffle@ truffle-migrate@ @truffle/plugins@ @truffle/provisioner@ @truffle/blockchain-utils@ @truffle/solidity-utils@ @truffle/reporters@ @truffle/sawtooth-seth-provider@ @truffle/events@ @truffle/deployer@ truffle-debugger@ truffle-code-utils@ @truffle/code-utils@ truffle-config@,58,0,10,4135,4193,0 days 00:00:27.250764
1645,GoogleContainerTools/jib,1,v,2,0,1,7,9,0 days 00:00:00.046032
1646,react-dates/react-dates,1,v,78,74,1,81,159,0 days 00:00:00.135235
1647,carloscuesta/gitmoji,1,v,13,5,2,5,18,0 days 00:00:00.047562
1648,gravitational/teleport,3, teleport-connect-preview- v,35,14,8,277,312,0 days 00:00:00.829678
1649,memcached/memcached,1,,4,0,3,86,90,0 days 00:00:00.120738
1650,roots/sage,2, v,27,10,12,35,62,0 days 00:00:00.140286
1651,webpack-contrib/webpack-bundle-analyzer,1,v,32,19,8,34,66,0 days 00:00:00.051959
1652,http-party/http-server,2, v,15,2,10,30,45,0 days 00:00:00.050927
1653,BrowserSync/browser-sync,3, v v2-rc,45,29,8,184,229,0 days 00:00:00.172803
1654,Tonejs/Tone.js,2, r,12,1,8,4,16,0 days 00:00:00.389286
1655,aurelia/framework,1,,23,16,5,32,55,0 days 00:00:00.055840
1656,jaredreich/pell,1,v,6,4,1,6,12,0 days 00:00:00.015342
1657,apache/druid,1,druid-,18,1,13,366,384,0 days 00:00:01.021828
1658,pytorch/vision,2,ciflow/default/ v,16,2,9,18,34,0 days 00:00:00.232120
1659,Tamsiree/RxTool,2, v,15,7,4,177,192,0 days 00:00:00.111025
1660,karma-runner/karma,2, v,35,14,12,198,233,0 days 00:00:00.408470
1661,FaridSafi/react-native-gifted-chat,2, v,16,6,7,46,62,0 days 00:00:00.092420
1662,thingsboard/thingsboard,1,v,15,2,7,33,48,0 days 00:00:00.545298
1663,rrweb-io/rrweb,5, rrweb@ rrdom@ rrweb-snapshot@ rrweb-player@,6,0,2,92,98,0 days 00:00:00.094890
1664,ramsey/uuid,1,,26,6,14,37,63,0 days 00:00:00.068971
1665,flairNLP/flair,1,v,11,1,6,12,23,0 days 00:00:00.254150
1666,typescript-eslint/typescript-eslint,2, v,122,120,0,50,172,0 days 00:00:00.285538
1667,ben-manes/caffeine,2, v,16,4,7,45,61,0 days 00:00:00.103778
1668,segmentio/evergreen,1,v,51,39,2,84,135,0 days 00:00:00.094469
1669,AdguardTeam/AdGuardHome,1,v,19,6,4,31,50,0 days 00:00:00.154611
1670,medusajs/medusa,40,medusa-fulfillment-manual@ medusa-plugin-restock-notification@ medusa-react@ @medusajs/medusa-cli@ medusa-plugin-brightpearl@ medusa-core-utils@ @medusajs/medusa@ medusa-interfaces@ medusa-payment-stripe@ medusa-plugin-meilisearch@ medusa-plugin-discount-generator@ @medusajs/medusa-js@ medusa-plugin-contentful@ medusa-plugin-slack-notification@ medusa-file-s3@ medusa-source-shopify@ medusa-payment-manual@ medusa-plugin-add-ons@ medusa-plugin-sendgrid@ medusa-file-spaces@ medusa-telemetry@ medusa-test-utils@ medusa-plugin-segment@ medusa-dev-cli@ medusa-plugin-algolia@ medusa-payment-paypal@ babel-preset-medusa-package@ medusa-payment-klarna@ medusa-plugin-mailchimp@ medusa-plugin-wishlist@ medusa-plugin-permissions@ medusa-fulfillment-webshipper@ medusa-file-minio@ create-medusa-app@ medusa-plugin-ip-lookup@ v medusa-plugin-economic@ medusa-plugin-twilio-sms@ gatsby-source-medusa@ medusa-payment-adyen@,7,1,2,1308,1315,0 days 00:00:02.455313
1671,ranger/ranger,1,v,10,1,8,31,41,0 days 00:00:00.289115
1672,lit/lit,20, @lit-labs/context@ @lit-labs/react@ @lit-labs/motion@ lit-element@ @lit/ts-transformers@ @lit-labs/observers@ @lit-labs/router@ lit@ lit-html@ @lit/localize@ @lit-labs/eleventy-plugin-lit@ @lit/localize-tools@ @lit/reactive-element@ @lit-labs/analyzer@ @lit-labs/task@ v @lit-labs/scoped-registry-mixin@ @lit-labs/ssr@ @lit-labs/ssr-client@,20,5,5,96,116,0 days 00:00:00.106234
1673,plotly/plotly.py,6, widget-v plotly-geo-v v chart-studio-v jupyterlab-plotly-v,48,21,3,42,90,0 days 00:00:00.255043
1674,influxdata/telegraf,4, igloo-rc v plugins-rc,29,3,19,109,138,0 days 00:00:00.453106
1675,emirpasic/gods,1,v,19,14,3,6,25,0 days 00:00:00.032860
1676,mikepenz/MaterialDrawer,1,v,35,19,8,166,201,0 days 00:00:00.194185
1677,LuckSiege/PictureSelector,2,v. v,12,6,5,91,103,0 days 00:00:00.328051
1678,NetEase/pomelo,2, v,9,1,4,84,93,0 days 00:00:00.071848
1679,microsoft/nni,1,v,27,9,2,16,43,0 days 00:00:00.309245
1680,apexcharts/apexcharts.js,2, v,32,15,3,54,86,0 days 00:00:00.136612
1681,PuerkitoBio/goquery,1,v,12,1,8,10,22,0 days 00:00:00.030409
1682,nock/nock,2, v,125,107,13,181,306,0 days 00:00:00.242847
1683,QL-Win/QuickLook,2, v,4,1,1,38,42,0 days 00:00:00.056973
1684,go-chi/chi,1,v,12,1,5,27,39,0 days 00:00:00.045540
1685,rjsf-team/react-jsonschema-form,1,v,71,56,6,52,123,0 days 00:00:00.102123
1686,d2-projects/d2-admin,2, v,25,17,4,62,87,0 days 00:00:00.190951
1687,koekeishiya/yabai,1,v,12,5,1,34,46,0 days 00:00:00.159903
1688,alibaba/tengine,3, tags/tengine- tengine-,7,0,6,22,29,0 days 00:00:00.188789
1689,mifi/lossless-cut,1,v,70,52,9,67,137,0 days 00:00:00.126151
1690,sindresorhus/got,1,v,70,49,11,71,141,0 days 00:00:00.124145
1691,spicetify/spicetify-cli,2,v. v,23,14,5,52,75,0 days 00:00:00.079669
1692,netchx/netch,2, v,6,1,3,47,53,0 days 00:00:00.125527
1693,meolu/walle-web,1,v,13,8,1,6,19,0 days 00:00:00.065762
1694,kyleneideck/BackgroundMusic,1,v,3,0,2,3,6,0 days 00:00:00.030432
1695,rizinorg/cutter,1,v,14,6,5,16,30,0 days 00:00:00.129658
1696,openwrt/openwrt,1,v,4,0,3,29,33,0 days 00:00:03.262190
1697,video-dev/hls.js,1,v,16,2,9,185,201,0 days 00:00:00.613536
1698,twitter/twemproxy,2, v,4,0,3,10,14,0 days 00:00:00.043808
1699,mikecao/umami,1,v,46,42,0,3,49,0 days 00:00:00.103225
1700,OpenRA/OpenRA,5, release- pkgtest- playtest- devtest-,309,260,16,16,325,0 days 00:00:01.683211
1701,chenshuo/muduo,2,pre-cpp v,12,2,8,45,57,0 days 00:00:00.166372
1702,blitz-js/blitz,2,v affbcb,41,38,0,74,115,0 days 00:00:00.219534
1703,FreeCAD/FreeCAD,1,,7,0,6,10,17,0 days 00:00:01.209429
1704,apple/foundationdb,2, snowflake-,8,0,7,120,128,0 days 00:00:01.413689
1705,bettercap/bettercap,1,v,33,23,5,10,43,0 days 00:00:00.285042
1706,hotwired/stimulus,1,v,12,5,4,14,26,0 days 00:00:00.063599
1707,EOSIO/eos,3,box-pre- v dawn-v,15,6,4,80,95,0 days 00:00:01.283921
1708,facebook/flipper,2, v,136,133,0,66,202,0 days 00:00:00.617808
1709,graphile/postgraphile,1,v,35,20,7,60,95,0 days 00:00:00.251762
1710,marko-js/marko,5,@marko/compiler@ @marko/babel-utils@ @marko/translator-default@ v marko@,78,51,10,525,603,0 days 00:00:00.827352
1711,slimphp/Slim,1,,40,11,21,55,95,0 days 00:00:00.264732
1712,xinntao/Real-ESRGAN,1,v,2,1,0,12,14,0 days 00:00:00.017359
1713,dotnet/efcore,4, release/ v rel/,9,0,7,102,111,0 days 00:00:00.709386
1714,Netflix/eureka,5, blitz4j- eureka- v v.,25,23,1,203,228,0 days 00:00:00.194939
1715,mengshukeji/Luckysheet,2,v doc,3,0,0,16,19,0 days 00:00:00.046349
1716,dimsemenov/Magnific-Popup,1,,3,0,2,18,21,0 days 00:00:00.025006
1717,wenzhixin/bootstrap-table,1,,18,3,9,39,57,0 days 00:00:00.189613
1718,realm/realm-java,4,v alpha- b DLL-Ver-,101,65,12,91,192,0 days 00:00:00.640903
1719,Textualize/textual,1,v,0,0,0,10,10,0 days 00:00:00.031654
1720,CodeSeven/toastr,2, v,4,0,2,10,14,0 days 00:00:00.028403
1721,mantinedev/mantine,1,,19,14,0,90,109,0 days 00:00:00.489527
1722,nexe/nexe,1,v,5,2,1,14,19,0 days 00:00:00.047050
1723,projectlombok/lombok,1,v,7,0,6,47,54,0 days 00:00:00.180671
1724,tinymce/tinymce,24, @ephox/darwin@ @ephox/jax@ @ephox/sugar@ @ephox/boulder@ @ephox/alloy@ @ephox/agar@ @ephox/phoenix@ @tinymce/oxide@ @ephox/porkbun@ @ephox/sand@ @ephox/snooker@ @ephox/acid@ @ephox/katamari-assertions@ @ephox/mcagar@ @ephox/robin@ @ephox/boss@ @ephox/bridge@ @tinymce/oxide-icons-default@ @ephox/imagetools@ @ephox/echo@ @ephox/dragster@ @ephox/polaris@ @ephox/katamari@,59,2,19,1408,1467,0 days 00:00:04.299647
1725,RPCS3/rpcs3,1,v,5,1,3,21,26,0 days 00:00:00.750091
1726,searx/searx,2, v,14,1,12,3,17,0 days 00:00:00.330447
1727,cloudwu/skynet,1,v,15,7,6,18,33,0 days 00:00:00.120207
1728,antvis/G2,2, v,13,2,8,144,157,0 days 00:00:00.293367
1729,getlantern/lantern,6, natty-beta _ lantern- v android-sdk-,21,1,6,164,185,0 days 00:00:01.044095
1730,Yalantis/uCrop,1,,0,0,0,8,8,0 days 00:00:00.028095
1731,java-decompiler/jd-gui,1,v,7,5,1,11,18,0 days 00:00:00.022954
1732,MobSF/Mobile-Security-Framework-MobSF,2, v,5,0,3,37,42,0 days 00:00:00.107369
1733,conventional-changelog/commitlint,1,v,47,28,10,89,136,0 days 00:00:00.285286
1734,kubernetes/dashboard,1,v,15,1,10,20,35,0 days 00:00:00.386569
1735,ankitects/anki,1,,1,0,0,83,84,0 days 00:00:00.465653
1736,PHPOffice/PhpSpreadsheet,1,,24,6,7,10,34,0 days 00:00:00.191556
1737,tensorflow/tfjs-models,19,coco-ssd-v toxicity-v knn-classifier-v universal-sentence-encoder-v face-landmarks-detection-v qna-v deeplab-v face-detection-v pose-detection-v blazeface-v posenet-v body-segmentation-v hand-pose-detection-v depth-estimation-v mobilenet-v facemesh-v handpose-v body-pix-v speech-commands-v,6,0,3,70,76,0 days 00:00:00.092575
1738,micro/micro,2, v,62,48,2,37,99,0 days 00:00:00.244219
1739,gopherjs/gopherjs,2,go v,2,0,1,3,5,0 days 00:00:00.223339
1740,pagehelper/Mybatis-PageHelper,1,v,18,9,6,42,60,0 days 00:00:00.049844
1741,google/guice,2, snapshot,19,4,10,4,23,0 days 00:00:00.226844
1742,single-spa/single-spa,2, v,29,15,10,85,114,0 days 00:00:00.066348
1743,davisking/dlib,1,v,55,14,13,0,55,0 days 00:00:00.367765
1744,argoproj/argo-workflows,2, v,23,7,9,102,125,0 days 00:00:00.356886
1745,containerd/containerd,2, v,9,1,7,76,85,0 days 00:00:00.929896
1746,frappe/erpnext,2, v,153,136,7,763,916,0 days 00:00:03.591320
1747,FriendsOfPHP/PHP-CS-Fixer,1,v,48,26,15,148,196,0 days 00:00:00.619451
1748,ccampbell/mousetrap,1,,7,1,5,21,28,0 days 00:00:00.031089
1749,hashicorp/nomad,1,v,17,0,15,104,121,0 days 00:00:01.235936
1750,nightwatchjs/nightwatch,1,v,16,1,9,207,223,0 days 00:00:00.427808
1751,google/brotli,1,v,6,1,4,10,16,0 days 00:00:00.060222
1752,mail-in-a-box/mailinabox,1,v,45,16,11,0,45,0 days 00:00:00.103945
1753,jquery/jquery-ui,1,,8,1,6,38,46,0 days 00:00:00.396407
1754,ajv-validator/ajv,2, v,71,54,6,89,160,0 days 00:00:00.179991
1755,pybind/pybind11,2,v archive/yclass_v,19,5,8,16,35,0 days 00:00:00.318342
1756,SFTtech/openage,1,v,5,2,2,4,9,0 days 00:00:00.343591
1757,octalmage/robotjs,1,v,6,0,4,28,34,0 days 00:00:00.048420
1758,allenai/allennlp,2, v,24,7,5,23,47,0 days 00:00:00.147089
1759,the-control-group/voyager,1,v,5,0,4,35,40,0 days 00:00:00.139701
1760,elastic/beats,3, libbeat/v v,45,10,9,136,181,0 days 00:00:01.468939
1761,baidu/amis,1,,9,5,2,37,46,0 days 00:00:00.487992
1762,permissions-dispatcher/PermissionsDispatcher,2, ktx-,22,6,11,35,57,0 days 00:00:00.049718
1763,keeweb/keeweb,1,v,25,10,9,103,128,0 days 00:00:00.197130
1764,ansible/awx,1,,36,18,2,20,56,0 days 00:00:01.763344
1765,nats-io/nats-server,1,v,17,2,12,49,66,0 days 00:00:00.398438
1766,stylus/stylus,1,,53,34,11,115,168,0 days 00:00:00.199422
1767,beetbox/beets,1,v,6,1,4,30,36,0 days 00:00:00.623906
1768,Chia-Network/chia-blockchain,3, alpha- Alpha-,6,5,0,36,42,0 days 00:00:00.365821
1769,codecentric/spring-boot-admin,1,,12,0,11,62,74,0 days 00:00:00.110178
1770,json-iterator/go,3, jsoniter-go- v,2,0,1,29,31,0 days 00:00:00.044249
1771,facebook/watchman,2,v mlion_,38,29,4,110,148,0 days 00:00:00.596658
1772,apache/pulsar,1,v,14,1,10,37,51,0 days 00:00:00.774571
1773,jonas/tig,1,tig-,27,6,19,22,49,0 days 00:00:00.210357
1774,tomnomnom/gron,2, v,7,2,2,27,34,0 days 00:00:00.021403
1775,taye/interact.js,1,v,11,0,4,102,113,0 days 00:00:00.183692
1776,WickyNilliams/headroom.js,1,v,9,1,5,8,17,0 days 00:00:00.023883
1777,postmanlabs/httpbin,3,v deployment-prod- deployment-test-,16,3,5,12,28,0 days 00:00:00.041328
1778,dgraph-io/badger,1,v,14,6,7,20,34,0 days 00:00:00.103662
1779,containrrr/watchtower,1,v,8,1,5,24,32,0 days 00:00:00.051959
1780,ent/ent,1,v,10,3,4,21,31,0 days 00:00:00.104665
1781,mobile-shell/mosh,1,mosh-,4,2,1,10,14,0 days 00:00:00.069412
1782,doctrine/inflector,2, v,6,1,4,10,16,0 days 00:00:00.031228
1783,reactos/reactos,70,backups/umode_net_branch@ backups/reactos-yarotows@ backups/curicon_rewrite@ backups/arty-newcc@ backups/ros@ backups/cmake-bringup@ backups/colins-printing-for-freedom@ backups/tcpip_revolution@ backups/cache_manager_rewrite@ backups/DBXSL@ backups/pierre-fsd@ backups/winldr@ backups/tcp-rewrite-branch@ backups/pnpmgr_cleanup@ backups/shell-experiments@ backups/umode-network-branch@ backups/reactos@ ReactOS- backups/usb-bringup@ backups/clipboard@ backups/GSoC_Network@ backups/vs_jc@ backups/header-work@ backups/alex-kd-branch@ backups/GSoC_Themes@ backups/arty-stable@ backups/alex_devel_branch@ backups/c++-bringup@ backups/ros-csrss@ backups/the-real-msvc@ backups/powerpc@ backups/expat-rbuild@ backups/FreeLoader@ backups/danny-web@ backups/Ash_Shell@ backups/usb-bringup-trunk@ backups/sndblst@ backups/hyperion@ backups/rox-u@ backups/audio-bringup@ backups/baikalnet@ backups/lean-explorer@ backups/ntoskrnl-audit@ backups/aicom-network-stable@ backups/lean-explorer_tmp@ backups/avendor@ backups/mpw@ backups/KJKHyperion-RtlUnwind@ backups/keyboard_heavy_lifting@ backups/unmaintained@ backups/xen@ backups/cis@ backups/no-windres-workaround@ backups/iut-netsh@ backups/silverblade-audio@ backups/jcatena-branch@ backups/wlan-bringup@ backups/xmlbuildsystem@ backups/new_headers@ backups/reactx@ backups/aicom-network-fixes@ backups/ROS@ backups/rbuild@ backups/nyadav-audio-branch@ v backups/KJKHyperion-ntoskrnl-fixnotifs@ backups/alex-cm-branch@ backups/services--dd--floppy@ backups/old_reactx@ backups/ELF_support@,74,12,50,64,138,0 days 00:00:03.387701
1784,Kotlin/kotlinx.coroutines,1,,24,11,6,38,62,0 days 00:00:00.147316
1785,SpartnerNL/Laravel-Excel,2, v,11,3,6,143,154,0 days 00:00:00.250518
1786,octobercms/october,1,v,5,0,4,203,208,0 days 00:00:00.308958
1787,networkx/networkx,1,networkx-,37,7,25,10,47,0 days 00:00:00.471464
1788,wbkd/react-flow,2, v,56,52,2,118,174,0 days 00:00:00.174883
1789,GoogleChrome/workbox,1,v,24,10,7,38,62,0 days 00:00:00.214006
1790,jaredpalmer/razzle,24, razzle-start-server-webpack-plugin@ razzle-plugin-devcert@ razzle-dev-utils@ razzle@ babel-preset-razzle@ razzle-plugin-mdx@ razzle-plugin-scss@ razzle-plugin-preact@ create-razzle-app@ razzle-plugin-bundle-analyzer@ razzle-plugin-typescript@ razzle-plugin-svelte@ razzle-plugin-less@ razzle-plugin-eslint@ razzle-plugin-graphql@ razzle-plugin-css@ razzle-plugin-vue@ razzle-plugin-elm@ razzle-plugin-react@ v razzle-plugin-manifest@ razzle-plugin-php@ razzle-plugin-inferno@,16,6,7,129,145,0 days 00:00:00.144091
1791,summernote/summernote,1,v,8,2,2,52,60,0 days 00:00:00.180393
1792,javve/list.js,2, v,11,4,5,10,21,0 days 00:00:00.049820
1793,lokesh/color-thief,2, v,5,1,2,6,11,0 days 00:00:00.018357
1794,nltk/nltk,1,,8,0,7,23,31,0 days 00:00:00.735462
1795,Chocobozzz/PeerTube,2,v test-tag-,17,0,6,10,27,0 days 00:00:00.515990
1796,GoogleChromeLabs/ndb,1,v,2,0,1,57,59,0 days 00:00:00.028360
1797,ionic-team/stencil,1,v,53,40,2,189,242,0 days 00:00:00.571520
1798,egulias/EmailValidator,1,,8,0,5,47,55,0 days 00:00:00.032962
1799,diegomura/react-pdf,18, @react-pdf/png-js@ @react-pdf/textkit@ @react-pdf/font@ @react-pdf/primitives@ @react-pdf/zlib@ @react-pdf/types@ @react-pdf/layout@ @react-pdf/yoga@ @react-pdf/unicode-properties@ v @react-pdf/stylesheet@ @react-pdf/render@ @react-pdf/image@ @react-pdf/fontkit@ @react-pdf/pdfkit@ @react-pdf/svgkit@ @react-pdf/renderer@,17,7,4,234,251,0 days 00:00:00.152742
1800,browserslist/browserslist,1,,49,24,11,119,168,0 days 00:00:00.122246
1801,Rapptz/discord.py,1,v,24,15,6,41,65,0 days 00:00:00.147296
1802,compiler-explorer/compiler-explorer,1,gh-,1309,1296,0,0,1309,0 days 00:00:02.342123
1803,fengyuanchen/cropperjs,1,v,14,6,4,40,54,0 days 00:00:00.042432
1804,casesandberg/react-color,2, v,14,8,5,23,37,0 days 00:00:00.038478
1805,jxnblk/mdx-deck,1,v,21,16,2,91,112,0 days 00:00:00.233623
1806,dolthub/dolt,3, go/v v,30,20,2,119,149,0 days 00:00:00.747240
1807,doctrine/instantiator,1,,5,0,4,7,12,0 days 00:00:00.031207
1808,swaywm/sway,1,,22,7,8,7,29,0 days 00:00:00.317051
1809,phalcon/cphalcon,3,Dao-v phalcon-v v,15,2,8,80,95,0 days 00:00:00.911444
1810,highcharts/highcharts,4,test-v v highstock-v highmaps-v,27,0,19,153,180,0 days 00:00:01.345309
1811,OpenRCT2/OpenRCT2,1,v,4,0,3,23,27,0 days 00:00:01.163508
1812,lingochamp/FileDownloader,1,v,11,4,4,56,67,0 days 00:00:00.049719
1813,downshift-js/downshift,1,v,49,38,4,179,228,0 days 00:00:00.123036
1814,tymondesigns/jwt-auth,1,,6,3,2,29,35,0 days 00:00:00.083335
1815,App-vNext/Polly,2, v,7,3,2,4,11,0 days 00:00:00.054841
1816,FiloSottile/age,1,v,1,0,0,0,1,0 days 00:00:00.018986
1817,polybar/polybar,1,,20,12,7,84,104,0 days 00:00:00.228715
1818,apache/zookeeper,2, release-,10,0,4,40,50,0 days 00:00:00.202630
1819,dotnet/AspNetCore.Docs,1,,40,33,1,0,40,0 days 00:00:00.596431
1820,withspectrum/spectrum,3, v desktop-v,10,7,1,151,161,0 days 00:00:00.901834
1821,chjj/blessed,1,v,1,0,0,79,80,0 days 00:00:00.068884
1822,mholt/PapaParse,1,,19,5,7,55,74,0 days 00:00:00.042158
1823,star7th/showdoc,2, v,18,6,6,124,142,0 days 00:00:00.100010
1824,renovatebot/renovate,3, v experiment-,1600,1590,5,4429,6029,0 days 00:00:59.268253
1825,z-song/laravel-admin,2, v,3,0,2,74,77,0 days 00:00:00.328772
1826,redis/jedis,3, jedis- v,27,7,17,36,63,0 days 00:00:00.253129
1827,go-playground/validator,1,v,94,69,10,59,153,0 days 00:00:00.105389
1828,rqlite/rqlite,1,v,56,37,8,39,95,0 days 00:00:00.172084
1829,spatie/laravel-permission,1,,87,61,11,71,158,0 days 00:00:00.119614
1830,VSCodeVim/Vim,2, v,38,19,6,187,225,0 days 00:00:00.349445
1831,openresty/openresty,1,v,1,0,0,161,162,0 days 00:00:00.139417
1832,abseil/abseil-cpp,1,,17,5,9,0,17,0 days 00:00:00.064868
1833,avwo/whistle,1,v,31,12,10,342,373,0 days 00:00:00.932031
1834,restify/node-restify,2, v,44,27,13,96,140,0 days 00:00:00.229399
1835,PatrickJS/angular-starter,2, v,6,4,1,5,11,0 days 00:00:00.078067
1836,GoogleContainerTools/kaniko,1,v,33,20,4,4,37,0 days 00:00:00.217833
1837,akiran/react-slick,2, v,13,3,8,27,40,0 days 00:00:00.080379
1838,thanos-io/thanos,1,v,26,7,2,17,43,0 days 00:00:00.175826
1839,dbcli/pgcli,2, v,39,16,10,47,86,0 days 00:00:00.233436
1840,milvus-io/milvus,1,v,9,3,3,15,24,0 days 00:00:00.979597
1841,peers/peerjs,2, v,6,1,4,30,36,0 days 00:00:00.061786
1842,asciinema/asciinema,1,v,10,0,8,12,22,0 days 00:00:00.048005
1843,dbcli/mycli,1,v,26,8,10,20,46,0 days 00:00:00.088550
1844,luin/ioredis,2, v,54,33,11,132,186,0 days 00:00:00.231662
1845,styleguidist/react-styleguidist,2, v,47,30,7,215,262,0 days 00:00:00.187159
1846,netbox-community/netbox,2, v,24,6,13,173,197,0 days 00:00:00.659664
1847,golangci/golangci-lint,1,v,47,31,1,63,110,0 days 00:00:00.139147
1848,jina-ai/clip-as-service,1,v,15,11,2,92,107,0 days 00:00:00.132801
1849,dangrossman/daterangepicker,2, v,5,1,3,58,63,0 days 00:00:00.178499
1850,TypeStrong/ts-node,1,v,52,29,9,83,135,0 days 00:00:00.106617
1851,redis/redis-py,2, v,15,2,9,49,64,0 days 00:00:00.103609
1852,tidwall/gjson,1,v,15,5,6,42,57,0 days 00:00:00.040234
1853,imakewebthings/waypoints,2, v,6,1,4,17,23,0 days 00:00:00.024092
1854,okonet/lint-staged,2, v,44,23,7,145,189,0 days 00:00:00.109930
1855,aspnetboilerplate/aspnetboilerplate,3, v. v,91,57,7,125,216,0 days 00:00:00.502529
1856,raspberrypi/linux,5, tag stable_ oldstable_ rpi,18,10,4,1,19,0 days 00:01:10.562861
1857,s0md3v/XSStrike,1,,2,1,0,10,12,0 days 00:00:00.031872
1858,reactstrap/reactstrap,2, v,61,45,7,54,115,0 days 00:00:00.093483
1859,lionsoul2014/ip2region,1,release-,0,0,0,1,1,0 days 00:00:00.014009
1860,git-lfs/git-lfs,2, v,29,3,19,60,89,0 days 00:00:00.448755
1861,brave/brave-browser,2,bsc-debug-nightly-win v,4,1,2,5124,5128,0 days 00:00:51.643504
1862,PrismJS/prism,2, v,29,8,11,11,40,0 days 00:00:00.192695
1863,nextauthjs/next-auth,7,@next-auth/upstash-redis-adapter@v @next-auth/prisma-adapter@v @next-auth/mikro-orm-adapter@v v next-auth@v @next-auth/mongodb-adapter@v @next-auth/typeorm-legacy-adapter@v,38,32,2,79,117,0 days 00:00:00.109325
1864,nasa/openmct,8, open-v V-R v v- t-sim-rev openmct-viper-build- vista-,16,0,12,41,57,0 days 00:00:00.496838
1865,shipshapecode/shepherd,1,v,46,28,9,73,119,0 days 00:00:00.153823
1866,snabbdom/snabbdom,1,v,14,3,6,33,47,0 days 00:00:00.063075
1867,ant-design/ant-design-mobile,2, v,28,19,4,107,135,0 days 00:00:00.364409
1868,mockery/mockery,1,,10,0,9,28,38,0 days 00:00:00.109353
1869,knockout/knockout,1,v,13,0,12,12,25,0 days 00:00:00.098334
1870,jquery-validation/jquery-validation,1,,14,0,12,8,22,0 days 00:00:00.053786
1871,spencermountain/compromise,2, v,70,45,12,148,218,0 days 00:00:00.280335
1872,google/blockly,2, blockly-v,19,2,10,22,41,0 days 00:00:00.495769
1873,albumentations-team/albumentations,2, v,6,0,5,7,13,0 days 00:00:00.049672
1874,debug-js/debug,1,,22,7,8,47,69,0 days 00:00:00.048399
1875,lucidrains/vit-pytorch,1,,32,27,1,105,137,0 days 00:00:00.184314
1876,jedisct1/libsodium,1,,8,3,1,25,33,0 days 00:00:00.152072
1877,plouc/nivo,1,v,67,56,7,45,112,0 days 00:00:00.120806
1878,sql-js/sql.js,1,v,7,0,5,7,14,0 days 00:00:00.036059
1879,ToolJet/ToolJet,2,fix-ec v,25,22,0,47,72,0 days 00:00:00.263670
1880,pagekit/vue-resource,1,,12,5,4,41,53,0 days 00:00:00.040055
1881,AppIntro/AppIntro,2, v,10,1,8,8,18,0 days 00:00:00.055465
1882,Netflix/falcor,2,windows v,8,1,6,41,49,0 days 00:00:00.230408
1883,jantimon/html-webpack-plugin,2, v,47,34,10,36,83,0 days 00:00:00.064608
1884,ManimCommunity/manim,1,v,15,12,0,4,19,0 days 00:00:00.298171
1885,bpampuch/pdfmake,1,,2,0,1,72,74,0 days 00:00:00.080739
1886,mailhog/MailHog,2, v,10,7,2,16,26,0 days 00:00:00.027936
1887,vercel/micro,2, v,21,13,5,34,55,0 days 00:00:00.050767
1888,react-static/react-static,1,v,28,20,5,162,190,0 days 00:00:00.196110
1889,ml-tooling/best-of-ml-python,1,,0,0,0,86,86,0 days 00:00:00.056241
1890,cyclejs/cyclejs,1,v,32,27,1,50,82,0 days 00:00:00.059937
1891,veler/DevToys,1,v,6,5,0,19,25,0 days 00:00:00.040700
1892,goreleaser/goreleaser,1,v,193,191,0,300,493,0 days 00:00:00.489380
1893,github/gh-ost,2,revert-pr- v,3,0,2,45,48,0 days 00:00:00.126572
1894,SpacehuhnTech/esp8266_deauther,3, v. v,10,5,3,3,13,0 days 00:00:00.048959
1895,serbanghita/Mobile-Detect,1,,6,2,3,64,70,0 days 00:00:00.063680
1896,samuelcolvin/pydantic,2,v V,42,30,6,37,79,0 days 00:00:00.098520
1897,HandBrake/HandBrake,1,,8,0,7,35,43,0 days 00:00:00.730118
1898,clauderic/react-sortable-hoc,1,v,20,14,3,52,72,0 days 00:00:00.054500
1899,quarkusio/quarkus,1,,28,27,0,13,41,0 days 00:00:00.652871
1900,h2o/h2o,1,v,12,3,2,32,44,0 days 00:00:00.248143
1901,openresty/lua-nginx-module,1,v,9,0,6,118,127,0 days 00:00:00.231781
1902,microsoft/WSL2-Linux-Kernel,3,v linux-msft-wsl- linux-msft-,47,0,1,2480,2527,0 days 00:01:42.305372
1903,kubesphere/kubesphere,2,advanced- v,6,0,5,5,11,0 days 00:00:00.188795
1904,tinygo-org/tinygo,1,v,23,9,3,4,27,0 days 00:00:00.136383
1905,invertase/react-native-firebase,23, @react-native-firebase/in-app-messaging@ @react-native-firebase/remote-config@ @react-native-firebase/dynamic-links@ @react-native-firebase/admob@ @react-native-firebase/storage@ @react-native-firebase/app@ @react-native-firebase/firestore@ @react-native-firebase/app-types@ @react-native-firebase/ml-vision@ @react-native-firebase/ml@ @react-native-firebase/auth@ @react-native-firebase/ml-natural-language@ react-native-firebase-tests@ @react-native-firebase/analytics@ @react-native-firebase/functions@ @react-native-firebase/template@ @react-native-firebase/crashlytics@ @react-native-firebase/perf@ @react-native-firebase/database@ @react-native-firebase/iid@ v @react-native-firebase/messaging@,92,56,6,853,945,0 days 00:00:01.805661
1906,vueuse/vueuse,2, v,40,38,0,123,163,0 days 00:00:00.177801
1907,apple/darwin-xnu,1,xnu-,19,6,0,104,123,0 days 00:00:00.070444
1908,FredrikNoren/ungit,2, v,16,9,6,126,142,0 days 00:00:00.412077
1909,haltu/muuri,1,,9,1,5,14,23,0 days 00:00:00.040135
1910,postgres/postgres,4,Release_ REL REL_ PG95-,88,6,68,362,450,0 days 00:00:04.549040
1911,atomiks/tippyjs,2, v,27,20,5,65,92,0 days 00:00:00.079494
1912,ceph/ceph,3,suse_ses_v v suse_cloud,122,90,14,208,330,0 days 00:00:09.342662
1913,nhn/tui.calendar,1,v,21,13,3,42,63,0 days 00:00:00.100841
1914,jacomyal/sigma.js,1,v,7,1,3,8,15,0 days 00:00:00.073526
1915,rook/rook,1,v,19,1,16,103,122,0 days 00:00:00.846696
1916,leecade/react-native-swiper,2, v,2,0,1,21,23,0 days 00:00:00.028031
1917,typesense/typesense,2, v,16,5,5,8,24,0 days 00:00:00.078420
1918,esimov/caire,2, v,4,0,3,16,20,0 days 00:00:00.027827
1919,qrohlf/trianglify,1,v,12,1,8,8,20,0 days 00:00:00.022965
1920,ktorio/ktor,3, ktor- tmp-,12,1,9,52,64,0 days 00:00:00.244046
1921,neo4j/neo4j,2, browser-,21,0,20,211,232,0 days 00:00:04.623763
1922,dask/dask,1,,97,59,9,141,238,0 days 00:00:00.982896
1923,expressjs/multer,1,v,5,0,4,12,17,0 days 00:00:00.031762
1924,mozilla/sops,2, v,11,0,8,19,30,0 days 00:00:00.085349
1925,walkor/workerman,2, v,5,0,4,98,103,0 days 00:00:00.239700
1926,bitwarden/server,2, v,49,31,4,58,107,0 days 00:00:00.170848
1927,spotify/annoy,3, v. v,9,1,4,15,24,0 days 00:00:00.054817
1928,kubernetes-sigs/kind,2, v,14,2,6,10,24,0 days 00:00:00.187927
1929,Tencent/matrix,1,v,5,0,1,11,16,0 days 00:00:00.163930
1930,Ciphey/Ciphey,2, v,18,15,1,8,26,0 days 00:00:00.119924
1931,zricethezav/gitleaks,1,v,60,47,5,62,122,0 days 00:00:00.081187
1932,w7corp/easywechat,1,,47,25,16,241,288,0 days 00:00:00.267290
1933,WordPress/gutenberg,97, @wordpress/wordcount@ @wordpress/babel-preset-default@ @wordpress/react-native-editor@ rnmobile_v @wordpress/react-i18n@ @wordpress/list-reusable-blocks@ @wordpress/dom-ready@ @wordpress/date@ @wordpress/block-editor@ @wordpress/library-export-default-webpack-plugin@ @wordpress/escape-html@ @wordpress/style-engine@ @wordpress/plugins@ @wordpress/widgets@ @wordpress/url@ @wordpress/dom@ @wordpress/e2e-test-utils@ @wordpress/block-directory@ @wordpress/edit-widgets@ @wordpress/rich-text@ @wordpress/editor@ @wordpress/primitives@ v @wordpress/redux-routine@ @wordpress/custom-templated-path-webpack-plugin@ nmobile/ @wordpress/react-native-bridge@ @wordpress/npm-package-json-lint-config@ rnmobile/ @wordpress/customize-widgets@ @wordpress/e2e-tests@ @wordpress/element@ @wordpress/block-serialization-default-parser@ @wordpress/format-library@ @wordpress/priority-queue@ @wordpress/keycodes@ @wordpress/data-controls@ @wordpress/viewport@ @wordpress/edit-navigation@ @wordpress/reusable-blocks@ @wordpress/interface@ @wordpress/dependency-extraction-webpack-plugin@ @wordpress/react-native-aztec@ @wordpress/i18n@ package_v @wordpress/components@ @wordpress/jest-puppeteer-axe@ @wordpress/nux@ @wordpress/data@ @wordpress/block-library@ @wordpress/jest-preset-default@ @wordpress/browserslist-config@ @wordpress/create-block-tutorial-template@ @wordpress/media-utils@ @wordpress/create-block@ @wordpress/icons@ @wordpress/api-fetch@ @wordpress/stylelint-config@ @wordpress/annotations@ @wordpress/core-data@ @wordpress/edit-post@ @wordpress/prettier-config@ @wordpress/preferences@ @wordpress/preferences-persistence@ @wordpress/compose@ @wordpress/warning@ @wordpress/postcss-themes@ @wordpress/postcss-plugins-preset@ @wordpress/server-side-render@ @wordpress/deprecated@ @wordpress/scripts@ @wordpress/jest-console@ @wordpress/docgen@ @wordpress/html-entities@ @wordpress/hooks@ @wordpress/block-serialization-spec-parser@ @wordpress/token-list@ @wordpress/eslint-plugin@ @wordpress/blob@ @wordpress/autop@ @wordpress/notices@ @wordpress/base-styles@ @wordpress/is-shallow-equal@ @wordpress/blocks@ rnmobile/release-v @wordpress/readable-js-assets-webpack-plugin@ @wordpress/project-management-automation@ @wordpress/admin-manifest@ @wordpress/edit-site@ @wordpress/babel-plugin-makepot@ @wordpress/lazy-import@ @wordpress/shortcode@ @wordpress/a11y@ @wordpress/env@ @wordpress/keyboard-shortcuts@ @wordpress/babel-plugin-import-jsx-pragma@,336,136,9,5921,6257,0 days 00:01:03.566014
1934,visgl/deck.gl,2, v,32,8,11,250,282,0 days 00:00:00.569185
1935,squidfunk/mkdocs-material,1,,52,34,6,192,244,0 days 00:00:00.294813
1936,NaturalNode/natural,2, v,6,2,3,44,50,0 days 00:00:00.459134
1937,frida/frida,1,,54,30,10,579,633,0 days 00:00:00.626653
1938,python-pillow/Pillow,1,,39,1,35,35,74,0 days 00:00:00.663045
1939,marcotcr/lime,1,,1,0,0,17,18,0 days 00:00:00.036728
1940,pxb1988/dex2jar,2, v,2,0,1,28,30,0 days 00:00:00.049095
1941,coryhouse/react-slingshot,2, v,8,3,2,7,15,0 days 00:00:00.038858
1942,socketio/socket.io-client,1,,28,2,16,97,125,0 days 00:00:00.122908
1943,balena-io/etcher,1,v,8,0,4,143,151,0 days 00:00:00.219715
1944,vega/vega,1,v,45,20,15,73,118,0 days 00:00:00.437625
1945,dromara/hutool,1,,11,1,6,102,113,0 days 00:00:00.312821
1946,pypa/pipenv,2, v,46,42,0,257,303,0 days 00:00:00.733731
1947,immerjs/immer,2, v,35,23,5,94,129,0 days 00:00:00.202477
1948,CymChad/BaseRecyclerViewAdapterHelper,4, alpha- v V,26,21,1,164,190,0 days 00:00:00.130405
1949,tj/commander.js,2, v,50,19,18,38,88,0 days 00:00:00.086159
1950,jesseduffield/lazydocker,1,v,18,11,5,27,45,0 days 00:00:00.049073
1951,dmlc/xgboost,2, v,21,1,14,12,33,0 days 00:00:00.301359
1952,ppy/osu,5, changelog- test v osu!-v,438,421,4,42,480,0 days 00:00:03.472344
1953,Netflix/Hystrix,3, v hystrix-,6,2,3,124,130,0 days 00:00:00.383897
1954,angular/components,1,,31,13,7,128,159,0 days 00:00:00.877771
1955,facebook/rocksdb,3,v rocksdb- do-not-use-me,33,16,5,186,219,0 days 00:00:00.838740
1956,alibaba/nacos,2, v,16,9,6,15,31,0 days 00:00:00.224695
1957,mattermost/mattermost-server,1,v,79,72,0,231,310,0 days 00:00:01.795175
1958,doczjs/docz,1,v,19,13,5,66,85,0 days 00:00:00.111436
1959,vercel/swr,1,,8,0,4,40,48,0 days 00:00:00.052137
1960,google/python-fire,1,v,4,0,3,6,10,0 days 00:00:00.024306
1961,labstack/echo,2, v,20,3,10,75,95,0 days 00:00:00.108399
1962,vuejs/devtools,1,v,10,4,4,36,46,0 days 00:00:00.103983
1963,alibaba/spring-cloud-alibaba,1,,1,0,0,1,2,0 days 00:00:00.109869
1964,halo-dev/halo,1,v,10,2,5,42,52,0 days 00:00:00.125541
1965,react-native-elements/react-native-elements,2, v,30,18,5,52,82,0 days 00:00:00.141105
1966,kataras/iris,1,v,2,0,0,11,13,0 days 00:00:00.094453
1967,files-community/Files,1,v,23,18,4,38,61,0 days 00:00:00.344051
1968,lovell/sharp,1,v,30,4,16,88,118,0 days 00:00:00.108548
1969,pure-css/pure,1,v,9,1,7,14,23,0 days 00:00:00.045243
1970,magento/magento2,1,,5,0,4,58,63,0 days 00:00:09.252445
1971,googleapis/google-api-nodejs-client,142, compute-v androidenterprise-v realtimebidding-v blogger-v abusiveexperiencereport-v datafusion-v chromepolicy-v firebase-v gmail-v storagetransfer-v verifiedaccess-v cloudsearch-v appsactivity-v ml-v firebasedatabase-v genomics-v gamesConfiguration-v indexing-v serviceconsumermanagement-v oauth2-v dataflow-v androiddeviceprovisioning-v accesscontextmanager-v digitalassetlinks-v script-v firebasedynamiclinks-v sourcerepo-v streetviewpublish-v sasportal-v v vault-v sql-v servicemanagement-v androidpublisher-v adexchangebuyer-v slides-v networkmanagement-v bigtableadmin-v chat-v playcustomapp-v pagespeedonline-v groupsmigration-v serviceusage-v recommendationengine-v storage-v drive-v kgsearch-v googleapis-v content-v displayvideo-v admin-v servicenetworking-v youtube-v run-v libraryagent-v dfareporting-v docs-v firebaserules-v iap-v civicinfo-v prod_tt_sasportal-v tpu-v chromemanagement-v gmailpostmastertools-v playablelocations-v plus-v firebasehosting-v youtubereporting-v remotebuildexecution-v vectortile-v siteVerification-v cloudshell-v eventarc-v sheets-v people-v analytics-v doubleclickbidmanager-v lifesciences-v identitytoolkit-v factchecktools-v homegraph-v workflowexecutions-v forms-v file-v calendar-v gamesManagement-v sts-v healthcare-v reseller-v adexchangebuyer2-v fcm-v toolresults-v safebrowsing-v cloudidentity-v searchconsole-v iam-v servicecontrol-v driveactivity-v adsense-v acceleratedmobilepageurl-v ondemandscanning-v domainsrdap-v licensing-v youtubeAnalytics-v androidmanagement-v fitness-v mybusinessaccountmanagement-v pubsublite-v adexperiencereport-v cloudkms-v analyticsreporting-v testing-v firebaseml-v cloudtasks-v alertcenter-v trafficdirector-v firebasestorage-v deploymentmanager-v adsensehost-v doubleclicksearch-v localservices-v tagmanager-v smartdevicemanagement-v books-v sqladmin-v admob-v customsearch-v chromeuxreport-v poly-v webmasters-v groupssettings-v classroom-v manufacturers-v policysimulator-v appengine-v composer-v discovery-v webfonts-v apigateway-v datamigration-v games-v,166,75,8,1004,1170,0 days 00:00:06.826545
1972,appwrite/appwrite,1,,13,1,3,30,43,0 days 00:00:00.674914
1973,seata/seata,3, v V,15,6,3,18,33,0 days 00:00:00.201215
1974,redux-saga/redux-saga,2, v,18,9,5,40,58,0 days 00:00:00.135078
1975,balderdashy/sails,3, v wl-rc,16,5,9,144,160,0 days 00:00:00.366733
1976,n8n-io/n8n,8,n8n-workflow@ n8n-editor-ui@ n8n-node-dev@ n8n-nodes-base@ n8n-design-system@ 8n-editor-ui@ n8n-core@ n8n@,178,174,0,753,931,0 days 00:00:01.346438
1977,stedolan/jq,1,jq-,7,0,4,0,7,0 days 00:00:00.075562
1978,reduxjs/react-redux,1,v,26,17,6,59,85,0 days 00:00:00.084807
1979,swagger-api/swagger-ui,3, v/ v,69,51,11,189,258,0 days 00:00:00.473911
1980,ramda/ramda,2, v,28,13,9,26,54,0 days 00:00:00.133998
1981,t4t5/sweetalert,2, v,9,2,3,23,32,0 days 00:00:00.028216
1982,signalapp/Signal-Android,3, v. v,180,163,8,860,1040,0 days 00:00:01.854115
1983,ovity/octotree,1,v,5,1,3,26,31,0 days 00:00:00.042364
1984,portainer/portainer,4, internal- v edge_m,39,14,12,71,110,0 days 00:00:00.230051
1985,dimsemenov/PhotoSwipe,1,v,5,1,2,43,48,0 days 00:00:00.043416
1986,emscripten-core/emscripten,3, webidl. llvm-svn-pre-,43,28,9,345,388,0 days 00:00:01.509888
1987,sampotts/plyr,1,v,16,6,7,195,211,0 days 00:00:00.983141
1988,guzzle/guzzle,2, v,37,16,14,96,133,0 days 00:00:00.209764
1989,fabricjs/fabric.js,2, v,34,10,14,69,103,0 days 00:00:00.256129
1990,apache/kafka,1,,22,0,16,29,51,0 days 00:00:01.352562
1991,Tencent/wepy,34,wepy-ant@ wepy-plugin-autoprefixer@ @wepy/babel-plugin-import-regenerator@ @wepy/compiler-less@ wepy-compiler-typescript@ @wepy/plugin-uglifyjs@ @wepy/compiler-sass@ @wepy/use-promisify@ wepy-redux@ wepy-compiler-sass@ wepy-compiler-pug@ wepy-cli@ @wepy/plugin-eslint@ wepy-plugin-uglifyjs@ @wepy/compiler-babel@ wepy@ @wepy/plugin-define@ x@ wepy-compiler-babel@ wepy-web@ wepy-compiler-stylus@ wepy-compiler-less@ @wepy/use-intercept@ @wepy/compiler-stylus@ wepy-plugin-imagemin@ test@ wepy-async-function@ wepy-eslint@ @wepy/redux@ wepy-plugin-filemin@ wepy-plugin-replace@ v @wepy/x@ @wepy/compiler-typescript@,3,0,2,108,111,0 days 00:00:00.150963
1992,emberjs/ember.js,1,v,68,20,4,184,252,0 days 00:00:01.821198
1993,inconshreveable/ngrok,1,,20,18,1,1,21,0 days 00:00:00.026117
1994,facebook/draft-js,2, v,11,7,3,16,27,0 days 00:00:00.071846
1995,helm/helm,2, v,32,7,12,68,100,0 days 00:00:00.615730
1996,github/hub,1,v,29,14,10,59,88,0 days 00:00:00.370422
1997,facebook/folly,2, v,34,33,0,292,326,0 days 00:00:00.941078
1998,Wox-launcher/Wox,2, v,4,0,2,34,38,0 days 00:00:00.193264
1999,feathericons/feather,1,v,39,28,3,12,51,0 days 00:00:00.147155
2000,httpie/httpie,1,,19,2,12,28,47,0 days 00:00:00.096994
2001,ehang-io/nps,3,v. v V,19,14,1,44,63,0 days 00:00:00.053495
2002,xuxueli/xxl-job,2, v,13,0,8,18,31,0 days 00:00:00.092988
2003,openfaas/faas,2, v,18,9,7,110,128,0 days 00:00:00.131016
2004,coreybutler/nvm-windows,1,,2,0,1,15,17,0 days 00:00:00.030702
2005,nsqio/nsq,1,v,3,0,2,26,29,0 days 00:00:00.117870
2006,floating-ui/floating-ui,7,@floating-ui/core@ @floating-ui/dom@  @floating-ui/react-native@ @floating-ui/react-dom@ v @floating-ui/react-dom-interactions@,32,12,13,172,204,0 days 00:00:00.176054
2007,usablica/intro.js,2, v,29,5,13,12,41,0 days 00:00:00.076387
2008,mochajs/mocha,2, v,65,28,15,110,175,0 days 00:00:00.243263
2009,bevacqua/dragula,2, v,18,14,1,49,67,0 days 00:00:00.039670
2010,vercel/pkg,1,,15,7,5,42,57,0 days 00:00:00.060883
2011,bilibili/flv.js,1,v,7,1,4,8,15,0 days 00:00:00.027516
2012,rollup/rollup,1,v,169,157,3,411,580,0 days 00:00:00.759317
2013,getredash/redash,2, v,10,0,8,19,29,0 days 00:00:00.456564
2014,NativeScript/NativeScript,5, release- webpack- v core-,35,8,6,75,110,0 days 00:00:00.772601
2015,facebookresearch/detectron2,1,v,6,0,5,5,11,0 days 00:00:00.075731
2016,conwnet/github1s,1,v,7,4,1,19,26,0 days 00:00:00.032684
2017,paularmstrong/normalizr,2, v,16,7,5,18,34,0 days 00:00:00.041025
2018,chenglou/react-motion,1,v,5,1,2,19,24,0 days 00:00:00.045941
2019,mono/mono,15, NUNIT_ MONO_ moon/ MCS_JULY_ type-reflector_ MONO_BETA monotouch- mono- cecil- C MCS_ moon- RHYS_ GMCS_MARTIN_,253,195,23,172,425,0 days 00:00:07.521231
2020,google/gson,3, gson- gson-parent-,17,1,11,23,40,0 days 00:00:00.157539
2021,qishibo/AnotherRedisDesktopManager,2, v,6,1,3,34,40,0 days 00:00:00.047577
2022,docsifyjs/docsify,1,v,44,35,6,147,191,0 days 00:00:00.153550
2023,quasarframework/quasar,14,quasar- @quasar/app-webpack-v @quasar/babel-preset-app-v @quasar/extras-v @quasar/extras- @quasar/app-v quasar-v @quasar/cli-v v extras-v @quasar/icongenie-v @quasar-extras-v @quasar/vite-plugin-v @quasar/app-vite-v,45,18,11,493,538,0 days 00:00:01.165264
2024,Kong/insomnia,29,pkg-v insomnia-plugin-os@ insomnia-plugin-base64@ test- insomnia-plugin-cookie-jar@ insomnia-httpsnippet@ insomnia-plugin-jsonpath@ insomnia-account@ insomnia-xpath@ insomnia-sync@ insomnia-prettify@ insomnia-plugin-prompt@ insomnia-plugin-uuid@ insomnia-libcurl@ insomnia-url@ lib@ insomnia-plugin-default-headers@ insomnia-importers@ core@ designer@ insomnia-plugin-now@ insomnia-cookies@ insomnia-plugin-response@ insomnia-plugin-core-themes@ insomnia-app@ insomnia-plugin-request@ v insomnia-plugin-hash@ insomnia-plugin-file@,47,17,13,559,606,0 days 00:00:00.632537
2025,photoprism/photoprism,0,,0,0,0,0,0,0 days 00:00:00.022493
2026,jlmakes/scrollreveal,1,v,10,3,5,36,46,0 days 00:00:00.155775
2027,StevenBlack/hosts,2, v,24,10,7,405,429,0 days 00:00:00.505211
2028,pugjs/pug,13, pug-linker@ pug-runtime@ pug-strip-comments@ pug@ pug-attrs@ pug-walk@ pug-code-gen@ pug-load@ pug-filters@ pug-error@ pug-lexer@ pug-parser@,55,32,6,170,225,0 days 00:00:00.309192
2029,react-bootstrap/react-bootstrap,2, v,44,24,10,108,152,0 days 00:00:00.378087
2030,slidevjs/slidev,1,v,31,27,1,143,174,0 days 00:00:00.105941
2031,dotnet-architecture/eShopOnContainers,4, netcore v vs,8,0,4,7,15,0 days 00:00:00.202016
2032,sirupsen/logrus,2, v,20,6,8,35,55,0 days 00:00:00.073336
2033,react-navigation/react-navigation,23, @react-navigation/drawer@ @react-navigation/native-stack@ @react-navigation/material-bottom-tabs@ @react-navigation/devtools@ @react-navigation/native@ react-navigation-drawer@ react-navigation-animated-switch@ react-navigation-tabs@ @react-navigation/core@ react-navigation-stack@ @react-navigation/elements@ @react-navigation/example@ react-navigation@ @react-navigation/compat@ @react-navigation/bottom-tabs@ @react-navigation/routers@ @react-navigation/stack@ react-navigation-playground@ flipper-plugin-react-navigation@ react-navigation-material-bottom-tabs@ v @react-navigation/material-top-tabs@,67,31,4,970,1037,0 days 00:00:01.634442
2034,eslint/eslint,1,v,164,153,3,103,267,0 days 00:00:00.532471
2035,yeasy/docker_practice,1,v,13,1,9,0,13,0 days 00:00:00.071142
2036,localForage/localForage,1,,19,10,7,43,62,0 days 00:00:00.076684
2037,nicolargo/glances,1,v,22,2,15,70,92,0 days 00:00:00.210904
2038,Meituan-Dianping/mpvue,1,,3,1,0,17,20,0 days 00:00:00.230889
2039,michalsnik/aos,2, v,11,4,4,24,35,0 days 00:00:00.023165
2040,vuejs/vuepress,1,v,24,14,5,50,74,0 days 00:00:00.242923
2041,postcss/autoprefixer,1,,53,27,14,133,186,0 days 00:00:00.307902
2042,ray-project/ray,3, Ray- ray-,21,6,9,41,62,0 days 00:00:00.797387
2043,jaredhanson/passport,1,v,6,0,5,26,32,0 days 00:00:00.041092
2044,microsoft/cascadia-code,1,v,18,8,3,0,18,0 days 00:00:00.025340
2045,gofiber/fiber,1,v,42,37,0,51,93,0 days 00:00:00.190465
2046,uglide/RedisDesktopManager,1,,33,19,4,38,71,0 days 00:00:00.124558
2047,goldfire/howler.js,1,v,4,0,3,50,54,0 days 00:00:00.062699
2048,homebridge/homebridge,2, v,6,1,4,51,57,0 days 00:00:00.090256
2049,k3s-io/k3s,1,v,11,8,0,6,17,0 days 00:00:00.164921
2050,petkaantonov/bluebird,1,v,24,11,7,115,139,0 days 00:00:00.165153
2051,statelyai/xstate,10,@xstate/svelte@ @xstate/immer@ xstate@ @xstate/react@ @xstate/graph@ @xstate/inspect@ v @xstate/fsm@ @xstate/vue@ @xstate/test@,53,20,8,149,202,0 days 00:00:00.322068
2052,highlightjs/highlight.js,2, stable-,64,25,13,37,101,0 days 00:00:00.420842
2053,necolas/react-native-web,1,,17,6,7,242,259,0 days 00:00:00.329027
2054,DrKLO/Telegram,1,release-,47,40,1,37,84,0 days 00:00:00.051174
2055,python-poetry/poetry,1,,14,10,3,63,77,0 days 00:00:00.142087
2056,neoclide/coc.nvim,1,v,0,0,0,81,81,0 days 00:00:00.173575
2057,apache/incubator-mxnet,2, v,15,0,11,10,25,0 days 00:00:00.685338
2058,libgdx/libgdx,2, gdx-parent-,13,3,6,38,51,0 days 00:00:00.859559
2059,avajs/ava,1,v,54,37,4,23,77,0 days 00:00:00.119734
2060,enzymejs/enzyme,12,enzyme-adapter-react-13@ enzyme-adapter-react-16@ reagent-v enzyme-example-mocha@ enzyme-adapter-react-helper@ enzyme-adapter-react-14@ v enzyme-adapter-react-15@ enzyme-test-suite@ enzyme@ enzyme-shallow-equal@ enzyme-adapter-utils@,39,17,8,138,177,0 days 00:00:00.199883
2061,ApolloAuto/apollo,1,v,10,0,7,0,10,0 days 00:00:02.293114
2062,open-mmlab/mmdetection,1,v,29,26,1,6,35,0 days 00:00:00.126315
2063,Seldaek/monolog,1,,36,9,21,26,62,0 days 00:00:00.336657
2064,numpy/numpy,1,v,26,0,25,82,108,0 days 00:00:02.036384
2065,ShareX/ShareX,1,v,50,24,11,22,72,0 days 00:00:00.473471
2066,tsenart/vegeta,3,lib/v v cli/v,39,18,6,136,175,0 days 00:00:00.088818
2067,electron-react-boilerplate/electron-react-boilerplate,1,v,32,13,10,31,63,0 days 00:00:00.076274
2068,validatorjs/validator.js,2, v,107,79,8,43,150,0 days 00:00:00.147754
2069,schollz/croc,1,v,31,15,6,106,137,0 days 00:00:00.127792
2070,mozilla/DeepSpeech,1,v,9,1,6,13,22,0 days 00:00:00.174819
2071,envoyproxy/envoy,1,v,23,0,16,53,76,0 days 00:00:00.775537
2072,marmelab/react-admin,1,v,46,32,4,168,214,0 days 00:00:01.021709
2073,youzan/vant,1,v,33,13,6,377,410,0 days 00:00:00.773089
2074,zyedidia/micro,1,v,6,1,3,22,28,0 days 00:00:00.230316
2075,js-cookie/js-cookie,1,v,10,1,7,13,23,0 days 00:00:00.050791
2076,FredKSchott/snowpack,104, @snowpack/test-config-extends@ @snowpack/plugin-sass@ @snowpack/app-template-lit-element@ @snowpack/test-error-react-workaround@ @snowpack/plugin-babel@ @snowpack/test-bugfix-named-import@ @snowpack/test-dep-exports@ app-template-svelte-typescript@ @snowpack/plugin-dotenv@ @snowpack/test-include-missing-in-package-json@ @snowpack/test-base-url@ @snowpack/test-app-template-preact@ @snowpack/test-exclude-external-packages@ @snowpack/test-include-ignore-unsupported-files@ @snowpack/web-test-runner-plugin@ @snowpack/test-dep-list-css@ v @snowpack/test-exclude@ @snowpack/plugin-build-script@ @snowpack/test-source-pika-types@ @snowpack/test-config-external@ @snowpack/test-meta-dir-local-baseurl@ @snowpack/test-dep-browser-entrypoint-object@ @snowpack/test-config-rollup@ @snowpack/test-plugin-run-script@ @snowpack/plugin-svelte@ plugin-dotenv@ @snowpack/plugin-optimize@ @snowpack/test-custom-modules-dir@ @snowpack/test-dep-remote-url@ @snowpack/test-error-file-ext@ @snowpack/app-template-preact-typescript@ @snowpack/app-template-vue-typescript@ @snowpack/test-package-react@ @snowpack/test-config-invalid@ @snowpack/test-config-custom-path@ @snowpack/test-dep-list-complex@ @snowpack/app-template-minimal@ @snowpack/app-template-svelte-typescript@ @snowpack/test-config-alias@ @snowpack/app-scripts-react@ @snowpack/test-error-react-source-pika@ @snowpack/app-template-blank-typescript@ @snowpack/test-plugin-optimize@ @snowpack/test-dep-types-only@ @snowpack/app-template-svelte@ @snowpack/test-error-node-builtin-unresolved@ @snowpack/plugin-run-script@ @snowpack/plugin-parcel@ @snowpack/test-legacy-mount-scripts@ @snowpack/test-resource-proxy@ @snowpack/app-template-vue@ @snowpack/test-error-missing-dep@ @snowpack/plugin-react-refresh@ @snowpack/test-config-named-exports@ @snowpack/test-config-minify@ @snowpack/test-source-pika-lockfile@ @snowpack/test-config-extends-plugins@ @snowpack/test-source-pika-webdependencies@ @snowpack/app-scripts-preact@ @snowpack/test-meta-dir-remote-baseurl@ @snowpack/test-package-tippy-js@ @snowpack/test-dep-list-simple@ @snowpack/test-sub-package-json@ @snowpack/test-base-url-remote@ @snowpack/app-template-blank@ @snowpack/test-dep-node-fetch@ esinstall@ @snowpack/test-config-clean@ @snowpack/app-scripts-vue@ @snowpack/test-export-maps@ @snowpack/test-include-with-alias@ @snowpack/app-template-preact@ @snowpack/test-base-url-homepage@ @snowpack/test-resolve-imports@ @snowpack/test-meta-dir@ @snowpack/test-config-with-cli-flags@ @snowpack/plugin-webpack@ @snowpack/app-template-lit-element-typescript@ @snowpack/test-plugin-build-script@ @snowpack/plugin-vue@ create-snowpack-app@ @snowpack/test-include@ @snowpack/app-template-11ty@ @snowpack/test-include-ts@ @snowpack/test-source-pika@ @snowpack/test-error-empty-dep-list@ skypack@ @snowpack/test-error-illegal-env-var@ @snowpack/test-error-no-dep-list@ @snowpack/test-cdn@ @snowpack/app-template-react@ @snowpack/test-node-env@ snowpack@ @snowpack/plugin-typescript@ @snowpack/babel-plugin-package-import@ @snowpack/app-scripts-svelte@ @snowpack/test-error-missing-exports@ @snowpack/app-scripts-lit-element@ @snowpack/plugin-postcss@ @snowpack/app-template-react-typescript@ @snowpack/test-include-with-package-name@ snowpack-install-test-top-level-imports@,51,17,2,982,1033,0 days 00:00:01.395488
2077,parse-community/parse-server,1,,34,15,12,111,145,0 days 00:00:00.251561
2078,libuv/libuv,2,node-v v,52,22,16,176,228,0 days 00:00:00.350617
2079,spf13/viper,1,v,13,2,8,13,26,0 days 00:00:00.037126
2080,apache/skywalking,1,v,20,4,6,11,31,0 days 00:00:00.372273
2081,discordjs/discord.js,6, @discordjs/rest@ @discordjs/voice@ @discordjs/collection@ v @discordjs/builders@,45,18,9,30,75,0 days 00:00:00.438841
2082,celery/celery,2, v,22,3,17,143,165,0 days 00:00:00.749777
2083,streamlit/streamlit,2, v,83,79,1,46,129,0 days 00:00:00.466239
2084,benweet/stackedit,1,v,23,17,4,104,127,0 days 00:00:00.112322
2085,afollestad/material-dialogs,3, v. v,20,12,3,98,118,0 days 00:00:00.117490
2086,mongodb/mongo,5, r release- idxv mongodb-,42,8,25,487,529,0 days 00:00:05.837987
2087,felixrieseberg/windows95,1,v,11,4,5,3,14,0 days 00:00:00.021307
2088,TeamNewPipe/NewPipe,2, v,17,3,10,100,117,0 days 00:00:00.644944
2089,google/ExoPlayer,1,r,20,1,14,84,104,0 days 00:00:00.827166
2090,segmentio/nightmare,1,,21,9,4,67,88,0 days 00:00:00.073221
2091,alibaba/Sentinel,2, v,8,2,3,16,24,0 days 00:00:00.058030
2092,codex-team/editor.js,2, v,11,3,5,16,27,0 days 00:00:00.423333
2093,robertdavidgraham/masscan,3, kali_ v,3,1,1,8,11,0 days 00:00:00.041760
2094,redisson/redisson,2,redisson- redisson-parent-,39,9,21,154,193,0 days 00:00:00.516468
2095,taichi-dev/taichi,2, v,7,1,3,96,103,0 days 00:00:00.561843
2096,jhipster/generator-jhipster,1,v,110,89,5,114,224,0 days 00:00:02.376555
2097,eligrey/FileSaver.js,2, v,3,1,1,12,15,0 days 00:00:00.027654
2098,rancher/rancher,6, agent-windows-v agent-v agent-base-v server-v v,59,47,9,297,356,0 days 00:00:01.085968
2099,locustio/locust,2, v,27,9,10,56,83,0 days 00:00:00.184961
2100,fish-shell/fish-shell,3, OpenBeta_r LastC++,22,6,14,33,55,0 days 00:00:00.788719
2101,osquery/osquery,2, v,39,13,12,80,119,0 days 00:00:00.434531
2102,winstonjs/winston,2, v,24,6,13,62,86,0 days 00:00:00.089876
2103,Popmotion/popmotion,2, v,21,14,5,131,152,0 days 00:00:00.172694
2104,vuejs/vue-router,1,v,19,9,5,59,78,0 days 00:00:00.218397
2105,graphql/graphql-js,2, v,34,12,13,88,122,0 days 00:00:00.191480
2106,telegramdesktop/tdesktop,1,v,34,11,15,542,576,0 days 00:00:01.045549
2107,jorgebucaran/hyperapp,8, @hyperapp/dom@ @hyperapp/random@ @hyperapp/html@ @hyperapp/http@ @hyperapp/svg@ @hyperapp/time@ @hyperapp/events@,24,17,3,96,120,0 days 00:00:00.117542
2108,didi/DoKit,7, flutter_ Android-V Android_V android_dokit_v c web_,15,5,9,40,55,0 days 00:00:00.133201
2109,apache/flink,1,release-,23,0,19,58,81,0 days 00:00:02.403932
2110,palantir/blueprint,30,@blueprintjs/test-commons@ @blueprintjs/stylelint-plugin@ @blueprintjs/table-dev-app@ @blueprintjs/docs-data@ @blueprintjs/eslint-config@ @blueprintjs/timezone@ @blueprintjs/karma-build-scripts@ test-react15@ release-core- @blueprintjs/node-build-scripts@ @blueprintjs/eslint-plugin@ @blueprintjs/select@ @blueprintjs/popover2@ release- release-table- @blueprintjs/docs-app@ @blueprintjs/colors@ @blueprintjs/webpack-build-scripts@ @blueprintjs/landing-app@ @blueprintjs/icons@ @blueprintjs/labs@ @blueprintjs/core@ @blueprintjs/docs@ @blueprintjs/datetime@ @blueprintjs/eslint-plugin-blueprint@ @blueprintjs/table@ @blueprintjs/demo-app@ release-datetime- @blueprintjs/docs-theme@ @blueprintjs/tslint-config@,122,45,3,1154,1276,0 days 00:00:02.322002
2111,rwightman/pytorch-image-models,1,v,0,0,0,8,8,0 days 00:00:00.071213
2112,zhongyang219/TrafficMonitor,1,V,18,8,6,4,22,0 days 00:00:00.046342
2113,python-telegram-bot/python-telegram-bot,3, v V,49,27,8,39,88,0 days 00:00:00.150129
2114,reduxjs/reselect,1,v,11,6,4,14,25,0 days 00:00:00.050664
2115,sideway/joi,2, v,92,63,11,135,227,0 days 00:00:00.185622
2116,ascoders/weekly,1,,141,140,0,0,141,0 days 00:00:00.107717
2117,chalk/chalk,1,v,16,3,8,16,32,0 days 00:00:00.028889
2118,go-delve/delve,1,v,10,0,9,13,23,0 days 00:00:00.119340
2119,jumpserver/jumpserver,2, v,31,24,5,103,134,0 days 00:00:00.674473
2120,PyTorchLightning/pytorch-lightning,1,,16,3,4,98,114,0 days 00:00:00.598623
2121,vnpy/vnpy,2, v,22,6,7,28,50,0 days 00:00:00.452532
2122,vadimdemedes/ink,1,v,16,6,6,23,39,0 days 00:00:00.038365
2123,bazelbuild/bazel,1,,47,29,8,56,103,0 days 00:00:01.952145
2124,solidjs/solid,1,v,27,16,2,137,164,0 days 00:00:00.129092
2125,pbatard/rufus,1,v,42,11,15,28,70,0 days 00:00:00.110084
2126,mpv-player/mpv,1,v,34,10,8,46,80,0 days 00:00:02.439114
2127,urfave/cli,1,v,33,16,9,34,67,0 days 00:00:00.324284
2128,mingrammer/diagrams,1,v,20,14,3,16,36,0 days 00:00:00.031920
2129,nextcloud/server,3, theming- v,29,2,23,282,311,0 days 00:00:05.639625
2130,lyswhut/lx-music-desktop,1,v,39,32,0,46,85,0 days 00:00:00.097551
2131,square/picasso,2, picasso-parent-,10,2,6,12,22,0 days 00:00:00.066123
2132,sebastianbergmann/phpunit,1,,57,0,10,520,577,0 days 00:00:01.244905
2133,jenkinsci/jenkins,7,builds/  hudson- changes/ prototype- jenkins- jenkins.,1031,1008,2,485,1516,0 days 00:00:04.845063
2134,OpenZeppelin/openzeppelin-contracts,1,v,30,10,5,22,52,0 days 00:00:00.150990
2135,appsmithorg/appsmith,3, v. v,13,7,3,129,142,0 days 00:00:00.652977
2136,recharts/recharts,1,v,26,13,6,93,119,0 days 00:00:00.257725
2137,Baseflow/PhotoView,2, v,8,2,4,12,20,0 days 00:00:00.030389
2138,PHPMailer/PHPMailer,2,phpmailer- v,11,1,8,55,66,0 days 00:00:00.107258
2139,websockets/ws,2, v,40,13,11,114,154,0 days 00:00:00.125940
2140,openssl/openssl,7,OpenSSL-engine- OpenSSL-fips- OpenSSL_ BEN_FIPS_TEST_ OpenSSL_FIPS_ FIPS_TEST_ openssl-,12,6,4,36,48,0 days 00:00:02.061730
2141,wenyan-lang/wenyan,1,v,3,1,1,12,15,0 days 00:00:00.045859
2142,asim/go-micro,106,plugins/wrapper/ratelimiter/uber/v plugins/transport/utp/v plugins/store/memory/v plugins/wrapper/trace/opencensus/v plugins/store/mysql/v plugins/store/consul/v plugins/config/source/grpc/v plugins/selector/registry/v plugins/store/cockroach/v plugins/config/encoder/hcl/v plugins/proxy/http/v plugins/wrapper/ratelimiter/ratelimit/v plugins/config/source/runtimevar/v plugins/registry/cache/v plugins/config/encoder/toml/v plugins/broker/nats/v plugins/selector/shard/v plugins/wrapper/select/roundrobin/v plugins/wrapper/breaker/hystrix/v plugins/codec/jsonrpc2/v plugins/server/http/v plugins/codec/json-iterator/v plugins/broker/stan/v plugins/broker/sqs/v v plugins/broker/mqtt/v plugins/logger/apex/v plugins/config/source/mucp/v plugins/registry/consul/v plugins/registry/kubernetes/v plugins/transport/tcp/v plugins/config/source/nacos/v plugins/store/redis/v plugins/broker/rabbitmq/v plugins/broker/grpc/v plugins/config/source/pkger/v plugins/wrapper/select/version/v plugins/broker/gocloud/v plugins/client/mock/v plugins/sync/consul/v plugins/wrapper/monitoring/prometheus/v plugins/selector/dns/v plugins/server/grpc/v plugins/config/source/etcd/v plugins/config/encoder/yaml/v plugins/logger/zerolog/v plugins/transport/quic/v cmd/protoc-gen-micro/v plugins/transport/http/v plugins/registry/multi/v plugins/wrapper/select/shard/v plugins/broker/memory/v plugins/selector/static/v plugins/registry/mdns/v plugins/sync/etcd/v plugins/transport/rabbitmq/v plugins/wrapper/trace/datadog/v plugins/registry/proxy/v plugins/transport/grpc/v plugins/registry/gossip/v plugins/wrapper/breaker/gobreaker/v plugins/server/mucp/v plugins/config/encoder/xml/v plugins/codec/msgpackrpc/v plugins/logger/zap/v plugins/registry/nats/v plugins/client/mucp/v plugins/registry/etcd/v plugins/broker/http/v plugins/acme/certmagic/v plugins/logger/windowseventlog/v plugins/broker/nsq/v plugins/codec/segmentio/v plugins/registry/memory/v plugins/transport/memory/v plugins/registry/eureka/v plugins/broker/proxy/v plugins/registry/nacos/v plugins/broker/googlepubsub/v plugins/selector/label/v plugins/logger/logrus/v plugins/store/file/v plugins/codec/bsonrpc/v plugins/wrapper/endpoint/v plugins/registry/zookeeper/v plugins/client/http/v plugins/sync/memory/v plugins/broker/stomp/v plugins/broker/snssqs/v plugins/config/source/consul/v plugins/config/source/configmap/v plugins/wrapper/validator/v plugins/wrapper/trace/awsxray/v plugins/auth/jwt/v plugins/store/memcached/v plugins/broker/redis/v plugins/wrapper/monitoring/victoriametrics/v plugins/wrapper/trace/opentracing/v plugins/config/encoder/cue/v plugins/wrapper/service/v plugins/config/source/url/v plugins/config/source/vault/v plugins/broker/kafka/v plugins/broker/segmentio/v plugins/client/grpc/v plugins/transport/nats/v,66,52,4,137,203,0 days 00:00:00.510814
2143,lensapp/lens,1,v,19,6,6,56,75,0 days 00:00:00.380755
2144,ossrs/srs,1,v,9,8,0,32,41,0 days 00:00:00.420987
2145,bcit-ci/CodeIgniter,2, v,4,0,3,30,34,0 days 00:00:00.525726
2146,pmndrs/react-three-fiber,3,@react-three/test-renderer@ v @react-three/fiber@,21,12,5,311,332,0 days 00:00:00.299891
2147,taosdata/TDengine,6,autoaddcol_ ver- TDB-ver TDB-ver- release/ver- tq-,48,38,2,117,165,0 days 00:00:02.072779
2148,dgraph-io/dgraph,1,v,13,1,9,60,73,0 days 00:00:00.446892
2149,nuysoft/Mock,1,,1,0,0,7,8,0 days 00:00:00.023427
2150,iawia002/lux,2, v,15,7,5,59,74,0 days 00:00:00.061122
2151,dapr/dapr,1,v,19,9,1,23,42,0 days 00:00:00.342367
2152,google/flatbuffers,2, v,14,0,12,8,22,0 days 00:00:00.137488
2153,philc/vimium,2, v,11,2,5,17,28,0 days 00:00:00.301808
2154,withfig/autocomplete,3,v spec-build-no# spec-build-number-,741,734,0,118,859,0 days 00:00:00.943024
2155,eggjs/egg,1,,70,51,10,43,113,0 days 00:00:00.099523
2156,go-kratos/kratos,1,v,11,2,7,21,32,0 days 00:00:00.087412
2157,zeromicro/go-zero,2,tools/goctl/v v,4,0,3,56,60,0 days 00:00:00.083688
2158,refined-github/refined-github,1,,32,29,0,248,280,0 days 00:00:00.279143
2159,wekan/wekan,2, v,610,607,2,27,637,0 days 00:00:01.119302
2160,valyala/fasthttp,1,v,43,27,4,3,46,0 days 00:00:00.221067
2161,quii/learn-go-with-tests,2, v,22,13,5,27,49,0 days 00:00:00.072316
2162,svg/svgo,2, v,20,8,11,66,86,0 days 00:00:00.084401
2163,alibaba/weex,2, v,9,0,5,5,14,0 days 00:00:00.600368
2164,PaddlePaddle/Paddle,2,lite-v v,21,5,9,25,46,0 days 00:00:02.499362
2165,magenta/magenta,2, v,7,1,3,42,49,0 days 00:00:00.076123
2166,react-dnd/react-dnd,2, v,45,25,10,100,145,0 days 00:00:00.199120
2167,louislam/uptime-kuma,1,,16,14,0,35,51,0 days 00:00:00.154245
2168,aseprite/aseprite,2, v,9,1,7,84,93,0 days 00:00:00.402540
2169,arendst/Tasmota,1,v,35,14,7,58,93,0 days 00:00:00.924318
2170,apollographql/apollo-client,8,apollo-cache-inmemory@ apollo-cache@ graphql-anywhere@ apollo-client-preset@ v apollo-client@ apollo-boost@ apollo-utilities@,35,17,5,398,433,0 days 00:00:00.996573
2171,processing/p5.js,2, v,13,0,10,70,83,0 days 00:00:00.591222
2172,typicode/lowdb,1,v,21,8,9,36,57,0 days 00:00:00.148842
2173,google/jax,2,jax-v jaxlib-v,2,0,1,110,112,0 days 00:00:00.864912
2174,NickeManarin/ScreenToGif,1,,37,16,7,43,80,0 days 00:00:00.073878
2175,HelloZeroNet/ZeroNet,2,v. v,4,0,2,19,23,0 days 00:00:00.197397
2176,CarGuo/GSYVideoPlayer,2, v,9,0,5,60,69,0 days 00:00:00.081023
2177,pubkey/rxdb,1,,58,43,2,55,113,0 days 00:00:00.541690
2178,flameshot-org/flameshot,1,v,11,3,6,30,41,0 days 00:00:00.192157
2179,google/flexbox-layout,1,,6,0,5,14,20,0 days 00:00:00.036136
2180,freqtrade/freqtrade,1,,44,35,3,14,58,0 days 00:00:00.861786
2181,goharbor/harbor,4, tile- v src/v,20,0,16,70,90,0 days 00:00:00.700839
2182,Redocly/redoc,1,v,39,33,1,56,95,0 days 00:00:00.226615
2183,SortableJS/Vue.Draggable,2,v. v,24,13,6,25,49,0 days 00:00:00.044278
2184,swoole/swoole-src,2,swoole- v,15,4,9,139,154,0 days 00:00:00.637793
2185,jsdom/jsdom,2, v,98,67,9,144,242,0 days 00:00:00.226541
2186,tzutalin/labelImg,1,v,8,0,5,17,25,0 days 00:00:00.030932
2187,facebook/flux,1,,4,1,2,9,13,0 days 00:00:00.035708
2188,nosir/cleave.js,1,v,9,2,5,57,66,0 days 00:00:00.042614
2189,google/mediapipe,2, v,4,0,1,38,42,0 days 00:00:00.022553
2190,BoostIO/BoostNote-Legacy,4, v. v prototype#,15,2,7,76,91,0 days 00:00:00.217095
2191,apache/rocketmq,1,rocketmq-all-,7,0,6,9,16,0 days 00:00:00.217264
2192,TanStack/table,1,v,36,24,6,86,122,0 days 00:00:00.112865
2193,mybatis/mybatis-3,1,mybatis-,5,0,4,32,37,0 days 00:00:00.227576
2194,ValveSoftware/Proton,0,,0,0,0,0,0,0 days 00:00:00.052331
2195,mysqljs/mysql,1,v,28,10,9,26,54,0 days 00:00:00.080896
2196,alibaba/ice,3, v V,23,17,1,57,80,0 days 00:00:00.208811
2197,jquense/yup,1,v,27,12,8,67,94,0 days 00:00:00.055466
2198,reduxjs/redux-thunk,1,v,7,0,4,7,14,0 days 00:00:00.041017
2199,pmndrs/zustand,1,v,13,4,6,56,69,0 days 00:00:00.074308
2200,linlinjava/litemall,1,v,19,10,2,3,22,0 days 00:00:00.104239
2201,BabylonJS/Babylon.js,2, v,36,16,14,36,72,0 days 00:00:02.207009
2202,Molunerfinn/PicGo,1,v,11,4,5,21,32,0 days 00:00:00.050653
2203,facebookresearch/fairseq,1,v,8,1,5,6,14,0 days 00:00:00.132869
2204,microsoft/winget-cli,1,v,0,0,0,7,7,0 days 00:00:00.049322
2205,pnpm/pnpm,30,utils/  core-loggers/ pnpm-default-reporter/ supi/ npm-resolver/ @pnpm/headless@ default-resolver/ package-requester/ tarball-fetcher/ fetch-from-npm-registry/ utils@ lifecycle/ pnpm-shrinkwrap/ supi@ default-fetcher/ tarball-fetcher/headless/ pnpm-list/ dependencies-hierarchy/ package-store/ pnpm-default-reporter@ headless/ server/ @pnpm/utils@ headless@ v default-reporter/ config/ package-requester@ @pnpm/outdated/,223,193,10,1094,1317,0 days 00:00:02.217798
2206,ai/nanoid,1,,12,5,4,73,85,0 days 00:00:00.090142
2207,oldj/SwitchHosts,1,v,9,2,5,36,45,0 days 00:00:00.106703
2208,badges/shields,1,,8,3,4,3,11,0 days 00:00:00.456169
2209,facebookresearch/faiss,1,v,6,0,3,11,17,0 days 00:00:00.090235
2210,cookiecutter/cookiecutter,1,,14,4,8,15,29,0 days 00:00:00.265587
2211,facebook/zstd,2,v zstd-,14,4,3,50,64,0 days 00:00:00.412320
2212,eclipse-theia/theia,2, v,43,37,2,33,76,0 days 00:00:00.478709
2213,tachiyomiorg/tachiyomi,1,v,13,0,10,52,65,0 days 00:00:00.386034
2214,restic/restic,1,v,13,2,7,18,31,0 days 00:00:00.436826
2215,fyne-io/fyne,1,v,7,0,5,21,28,0 days 00:00:00.259868
2216,nostra13/Android-Universal-Image-Loader,1,v,3,1,1,12,15,0 days 00:00:00.047915
2217,remix-run/remix,1,v,27,22,1,61,88,0 days 00:00:00.316945
2218,facebook/fresco,1,v,35,14,13,12,47,0 days 00:00:00.182462
2219,facebookexperimental/Recoil,1,,7,0,3,15,22,0 days 00:00:00.064974
2220,less/less.js,1,v,26,8,13,42,68,0 days 00:00:00.169332
2221,ethereum/solidity,6, testrelease preview- prerelease- test v,9,1,6,95,104,0 days 00:00:01.157049
2222,brettwooldridge/HikariCP,1,HikariCP-,17,2,10,82,99,0 days 00:00:00.265985
2223,defunkt/jquery-pjax,2, v,12,6,3,15,27,0 days 00:00:00.036830
2224,zloirock/core-js,2, v,41,26,7,156,197,0 days 00:00:00.293547
2225,angular/material,3, testtag v,12,3,4,63,75,0 days 00:00:00.232182
2226,fingerprintjs/fingerprintjs,2, v,23,11,7,50,73,0 days 00:00:00.067349
2227,gorilla/mux,1,v,8,1,5,6,14,0 days 00:00:00.030293
2228,monicahq/monica,1,v,47,32,4,39,86,0 days 00:00:00.237250
2229,framework7io/framework7,1,v,43,19,11,172,215,0 days 00:00:00.535243
2230,oracle/graal,18,graal- hcfdis- vm-ee- vm-enterprise- JDK- graal-vm- truffle- vm-ce- trufflejson- batik-all- idealgraphvisualizer- hsdis- vscode- libffi- antlr-complete- c1visualizer- vm- sdk-,107,54,17,71,178,0 days 00:00:03.825638
2231,handlebars-lang/handlebars.js,2, v,14,5,6,56,70,0 days 00:00:00.107941
2232,yudai/gotty,1,v,1,0,0,14,15,0 days 00:00:00.019514
2233,MichMich/MagicMirror,3,v. v V,20,0,19,15,35,0 days 00:00:00.224060
2234,elastic/kibana,1,v,55,16,12,190,245,0 days 00:00:06.634677
2235,handsontable/handsontable,2, v,62,27,14,117,179,0 days 00:00:00.536931
2236,grafana/k6,1,v,36,12,6,36,72,0 days 00:00:00.251955
2237,plotly/dash,1,v,42,29,3,33,75,0 days 00:00:00.439415
2238,sqlitebrowser/sqlitebrowser,4, rc v sqlb-,14,1,8,12,26,0 days 00:00:00.197315
2239,testing-library/react-testing-library,1,v,57,43,2,110,167,0 days 00:00:00.088612
2240,stretchr/testify,1,v,8,0,7,9,17,0 days 00:00:00.044432
2241,derailed/k9s,2, v,25,17,2,155,180,0 days 00:00:00.125661
2242,dropzone/dropzone,1,v,32,15,12,83,115,0 days 00:00:00.357062
2243,PanJiaChen/vue-admin-template,2, v,8,0,5,2,10,0 days 00:00:00.021976
2244,responsively-org/responsively-app,1,v,18,14,3,10,28,0 days 00:00:00.079845
2245,twitter/typeahead.js,1,v,4,1,2,11,15,0 days 00:00:00.032946
2246,GoogleChromeLabs/squoosh,1,v,10,4,5,17,27,0 days 00:00:00.063955
2247,gchq/CyberChef,1,v,119,106,4,273,392,0 days 00:00:00.436582
2248,Tencent/tinker,1,v,7,3,2,46,53,0 days 00:00:00.054981
2249,jamiebuilds/react-loadable,1,v,13,8,3,16,29,0 days 00:00:00.019498
2250,nginx/nginx,1,release-,32,10,20,516,548,0 days 00:00:00.813614
2251,facebook/hhvm,4,nightly- gcc- HHVM- HPHP-,184,147,5,1449,1633,0 days 00:00:07.313581
2252,SBoudrias/Inquirer.js,3, v inquirer@,38,9,14,86,124,0 days 00:00:00.081451
2253,nfl/react-helmet,1,,15,5,4,18,33,0 days 00:00:00.031839
2254,bokeh/bokeh,1,,23,1,14,50,73,0 days 00:00:01.004904
2255,backstage/backstage,10,release-2022-01- release-2021-03- release-2021-11- release-2021-01- release-2021-06- release-2021-05- release-2021-07- v release-2021-04- release-2021-10-,85,60,8,83,168,0 days 00:00:02.112821
2256,joewalnes/websocketd,1,v,11,3,1,15,26,0 days 00:00:00.031266
2257,radareorg/radare2,2, release-,42,22,6,43,85,0 days 00:00:01.323399
2258,hubotio/hubot,1,v,26,7,12,68,94,0 days 00:00:00.105808
2259,aFarkas/lazysizes,1,,21,10,7,45,66,0 days 00:00:00.064181
2260,matomo-org/matomo,1,,64,20,21,130,194,0 days 00:00:01.935387
2261,tensorflow/tfjs,18, tfjs-layers-v tfjs-converter-v tfjs-backend-cpu-v tfjs-automl-v tfjs-node-v tfjs-backend-wasm-v tfjs-data-v test tfjs-v tfjs-tflite-v v tfjs-node-gpu-v tfjs-core-v tfjs-backend-webgl-v tfjs-vis-v tfjs-react-native-v tfjs-converter/-v,52,32,4,331,383,0 days 00:00:00.618712
2262,sanic-org/sanic,2, v,21,2,13,49,70,0 days 00:00:00.160564
2263,material-components/material-components-web,32,@material/form-field@ @material/select@ @material/radio@ @material/grid-list@ @material/rtl@ @material/button@ @material/slider@ @material/fab@ @material/toolbar@ @material/card@ @material/typography@ @material/selection-control@ @material/drawer@ @material/auto-init@ @material/list@ @material/tabs@ @material/switch@ @material/layout-grid@ @material/base@ @material/ripple@ @material/menu@ @material/textfield@ @material/checkbox@ @material/linear-progress@ @material/snackbar@ @material/animation@ v @material/elevation@ material-components-web@ @material/icon-toggle@ @material/theme@ @material/dialog@,65,32,4,538,603,0 days 00:00:00.769061
2264,Shopify/draggable,0,,0,0,0,0,0,0 days 00:00:00.011668
2265,zadam/trilium,2, v,14,11,1,134,148,0 days 00:00:00.297722
2266,matryer/xbar,2, v,9,5,2,5,14,0 days 00:00:00.286079
2267,ionic-team/ionicons,2, v,21,9,10,51,72,0 days 00:00:00.055769
2268,grpc/grpc-go,2,cmd/protoc-gen-go-grpc/v v,46,22,3,57,103,0 days 00:00:00.459154
2269,nondanee/UnblockNeteaseMusic,1,v,23,17,1,34,57,0 days 00:00:00.033390
2270,v2fly/v2ray-core,1,v,185,168,4,217,402,0 days 00:00:00.486984
2271,nginx-proxy/nginx-proxy,1,,11,1,7,5,16,0 days 00:00:00.057220
2272,saleor/saleor,4, demo/v demo/ v,32,21,7,95,127,0 days 00:00:01.322215
2273,grafana/loki,1,v,17,4,4,8,25,0 days 00:00:00.203618
2274,notepad-plus-plus/notepad-plus-plus,2, v,42,7,11,159,201,0 days 00:00:00.461290
2275,dvajs/dva,7, dva-react-router-3@ dva-immer@ dva-core@ dva-loading@ dva-no-router@ dva@,16,1,3,129,145,0 days 00:00:00.088683
2276,visionmedia/superagent,2, v,50,23,13,84,134,0 days 00:00:00.277220
2277,directus/directus,4, aug- v LATEST_STABLE_,26,18,5,76,102,0 days 00:00:01.348840
2278,trojan-gfw/trojan,1,v,24,15,4,19,43,0 days 00:00:00.037506
2279,amark/gun,2, v,5,0,4,24,29,0 days 00:00:00.100043
2280,youzan/vant-weapp,1,v,16,7,4,91,107,0 days 00:00:00.154058
2281,cocos2d/cocos2d-x,1,cocos2d-x-,20,2,8,17,37,0 days 00:00:02.277592
2282,filebrowser/filebrowser,1,v,34,23,6,62,96,0 days 00:00:00.140848
2283,EastWorld/wechat-app-mall,2, v,14,6,4,8,22,0 days 00:00:00.032248
2284,uber-go/zap,1,v,22,11,8,6,28,0 days 00:00:00.041840
2285,knex/knex,2, v,25,2,17,146,171,0 days 00:00:00.379224
2286,WordPress/WordPress,1,,41,0,37,534,575,0 days 00:00:03.873175
2287,qbittorrent/qBittorrent,1,release-,24,5,16,145,169,0 days 00:00:00.968573
2288,jaegertracing/jaeger,1,v,40,24,3,13,53,0 days 00:00:00.094753
2289,artf/grapesjs,1,v,0,0,0,124,124,0 days 00:00:00.303565
2290,briannesbitt/Carbon,1,,99,80,7,79,178,0 days 00:00:00.198098
2291,react-grid-layout/react-grid-layout,2, v,22,9,8,86,108,0 days 00:00:00.086510
2292,wagerfield/parallax,1,v,6,2,2,5,11,0 days 00:00:00.018123
2293,oblador/react-native-vector-icons,1,v,37,14,10,42,79,0 days 00:00:00.054978
2294,apache/shardingsphere,2, shardingsphere-ui-,13,2,8,20,33,0 days 00:00:01.869026
2295,spotify/luigi,2, v,13,4,8,46,59,0 days 00:00:00.205925
2296,buger/goreplay,2, v,18,5,10,23,41,0 days 00:00:00.071138
2297,semantic-release/semantic-release,2, v,62,48,9,206,268,0 days 00:00:00.173891
2298,simdjson/simdjson,1,v,12,1,5,26,38,0 days 00:00:00.278905
2299,ustbhuangyi/better-scroll,3, v. v,17,6,4,41,58,0 days 00:00:00.092852
2300,outline/outline,2, v,64,54,1,39,103,0 days 00:00:00.367209
2301,nikic/PHP-Parser,1,v,24,7,12,41,65,0 days 00:00:00.073927
2302,binux/pyspider,1,v,3,0,1,10,13,0 days 00:00:00.045100
2303,dotnet/maui,3, release- rui-,7,0,4,8,15,0 days 00:00:00.573868
2304,gentilkiwi/mimikatz,0,,0,0,0,0,0,0 days 00:00:00.010810
2305,motdotla/dotenv,1,v,33,17,11,26,59,0 days 00:00:00.039686
2306,openzipkin/zipkin,3, v zipkin-,57,47,5,136,193,0 days 00:00:00.218338
2307,infernojs/inferno,2, v,38,29,6,160,198,0 days 00:00:00.412922
2308,jasmine/jasmine,1,v,28,5,17,29,57,0 days 00:00:00.117493
2309,JedWatson/classnames,1,v,4,1,2,16,20,0 days 00:00:00.022896
2310,jhao104/proxy_pool,1,,10,1,6,2,12,0 days 00:00:00.035618
2311,zulip/zulip,3, enterprise- shared-,30,12,11,55,85,0 days 00:00:02.704722
2312,janl/mustache.js,2, v,20,5,12,23,43,0 days 00:00:00.064845
2313,wulkano/Kap,1,v,13,2,5,14,27,0 days 00:00:00.065650
2314,teambit/bit,1,v,18,7,5,121,139,0 days 00:00:00.320602
2315,airbnb/visx,1,v,29,25,1,200,229,0 days 00:00:00.257947
2316,auth0/node-jsonwebtoken,1,v,29,13,9,42,71,0 days 00:00:00.045263
2317,ipython/ipython,3,rel-  dev-,76,37,17,50,126,0 days 00:00:01.638000
2318,matplotlib/matplotlib,2, v,17,0,16,45,62,0 days 00:00:02.575549
2319,KaTeX/KaTeX,1,v,15,3,10,41,56,0 days 00:00:00.131437
2320,redis/node-redis,9,json@ client@ time-series@ v graph@ redis@ bloom@ search@ v.,24,7,14,85,109,0 days 00:00:00.361324
2321,tailwindlabs/heroicons,1,v,4,1,2,15,19,0 days 00:00:00.020948
2322,facebook/yoga,2, v,19,6,8,23,42,0 days 00:00:00.293357
2323,huiyadanli/RevokeMsgPatcher,1,,15,6,3,0,15,0 days 00:00:00.022475
2324,quantopian/zipline,2, v,10,0,8,16,26,0 days 00:00:00.324717
2325,dotnet/roslyn,15,Visual-Studio-2019-Version- perf-assets-v Visual-Studio-2017-Version- Visual-Studio- Oss.Scan. toolset_ NetFx.Toolset. v Visual-Studio-2017-Preview-Version- version- Visual-Studio-2017-Preview-2-Version- Visual-Studio-2017-Preview-1-Version- Visual-Studio-2022-Version- Visual-Studio-2017-Preview-6-Version- Visual-Studio-2017-Preview-3-Version-,47,3,22,193,240,0 days 00:00:04.899444
2326,catchorg/Catch2,3,v. v V,24,7,7,62,86,0 days 00:00:00.248173
2327,ueberdosis/tiptap,5,tiptap-extensions@ v tiptap-utils@ tiptap@ tiptap-commands@,59,17,0,305,364,0 days 00:00:00.564878
2328,lottie-react-native/lottie-react-native,1,v,16,2,9,37,53,0 days 00:00:00.050192
2329,cool-RR/PySnooper,1,,7,1,5,10,17,0 days 00:00:00.022400
2330,bower/bower,2, v,18,8,4,83,101,0 days 00:00:00.153526
2331,tailwindlabs/headlessui,4,@headlessui/vue@v @headlessui/tailwindcss@v v @headlessui/react@v,10,4,2,33,43,0 days 00:00:00.041273
2332,icsharpcode/ILSpy,2, v,16,2,11,9,25,0 days 00:00:00.520906
2333,fullcalendar/fullcalendar,1,v,44,14,18,72,116,0 days 00:00:00.299935
2334,designmodo/Flat-UI,1,,5,1,3,5,10,0 days 00:00:00.020831
2335,DapperLib/Dapper,1,,31,22,6,13,44,0 days 00:00:00.096785
2336,pouchdb/pouchdb,2, v,24,7,8,47,71,0 days 00:00:00.379706
2337,airbnb/react-sketchapp,2, v,20,11,5,27,47,0 days 00:00:00.059165
2338,flatpickr/flatpickr,2, v,23,10,4,121,144,0 days 00:00:00.180116
2339,ChainSafe/web3.js,2, v,25,16,7,54,79,0 days 00:00:00.335666
2340,2dust/v2rayNG,1,,8,1,5,111,119,0 days 00:00:00.051341
2341,emotion-js/emotion,56,create-emotion-server@ @emotion/native@ @emotion/babel-preset-css-prop@ @emotion/primitives-core@ @emotion/core@ @emotion/babel-plugin-jsx-pragmatic@ @emotion/styled.macro@ @emotion/unitless@ @emotion/weak-memoize@ emotion-server@ @emotion/babel-plugin@ create-emotion@ babel-preset-emotion-dev@ @emotion/is-prop-valid@ jest-emotion@ old-babel-tester@ @emotion/hash@ @emotion/serialize@ @emotion/stylis@ @emotion/styled@ @emotion/css.macro@ emotion@ babel-tester@ @emotion/snapshot-serializer@ @emotion/eslint-plugin@ emotion-theming@ @emotion/preact-core@ eslint-plugin-emotion@ @emotion/sheet@ @emotion/primitives@ babel-plugin-emotion@ build@ @emotion/server@ babel-plugin-macros-register@ @emotion/react@ emotion-site@ benchmarks@ @emotion/css-prettifier@ ssr-benchmarks@ my-razzle-app@ @emotion/memoize@ @emotion/jest@ test-utils@ example@ @emotion/utils@ @emotion/babel-utils@ @emotion/babel-plugin-core@ @emotion/css@ @emotion/preact-styled@ v @emotion/compat-cache@ @emotion/preact-styled-base@ babel-plugin-emotion-test@ @emotion/provider@ @emotion/cache@ @emotion/styled-base@,40,16,6,637,677,0 days 00:00:00.773529
2342,appium/appium,17,@appium/base-plugin@  @appium/docutils@ @appium/schema@ @appium/fake-driver@ @appium/gulp-plugins@ @appium/support@ @appium/types@ @appium/base-driver@ @appium/eslint-config-appium@ @appium/test-support@ @appium/doctor@ @appium/fake-plugin@ @appium/execute-driver-plugin@ v @appium/images-plugin@ @appium/opencv@,136,90,16,415,551,0 days 00:00:01.371420
2343,LMAX-Exchange/disruptor,1,,9,1,4,22,31,0 days 00:00:00.052562
2344,acdlite/recompose,3, v rx-recompose-v,29,19,4,32,61,0 days 00:00:00.049291
2345,netlify/netlify-cms,38, netlify-cms-widget-date@ netlify-cms-default-exports@ netlify-cms-widget-markdown@ netlify-cms-backend-github@ netlify-cms-widget-datetime@ netlify-cms-core@ netlify-cms-widget-select@ netlify-cms-proxy-server@ netlify-cms-backend-git-gateway@ netlify-cms-widget-object@ netlify-cms-app@ netlify-cms-widget-colorstring@ netlify-cms-locales@ netlify-cms-backend-azure@ netlify-cms-backend-bitbucket@ netlify-cms-backend-test@ netlify-cms-media-library-uploadcare@ netlify-cms-media-library-cloudinary@ netlify-cms@ netlify-cms-widget-file@ netlify-cms-ui-default@ netlify-cms-lib-util@ netlify-cms-lib-auth@ netlify-cms-widget-relation@ netlify-cms-widget-number@ netlify-cms-widget-boolean@ netlify-cms-widget-map@ ember-legacy- netlify-cms-widget-code@ netlify-cms-widget-string@ netlify-cms-backend-proxy@ netlify-cms-backend-gitlab@ netlify-cms-editor-component-image@ netlify-cms-widget-text@ netlify-cms-lib-widgets@ netlify-cms-widget-list@ netlify-cms-widget-image@,102,26,4,1659,1761,0 days 00:00:03.351076
2346,jellyfin/jellyfin,1,v,8,2,4,30,38,0 days 00:00:01.100756
2347,cloudreve/Cloudreve,1,,7,1,5,14,21,0 days 00:00:00.052076
2348,yaronn/blessed-contrib,1,v,0,0,0,10,10,0 days 00:00:00.025120
2349,microsoft/react-native-windows,1,react-native-windows_v,8,0,4,146,154,0 days 00:00:00.517454
2350,kovidgoyal/kitty,1,v,25,8,9,58,83,0 days 00:00:00.693911
2351,allinurl/goaccess,1,v,10,0,9,31,41,0 days 00:00:00.281761
2352,keystonejs/keystone-classic,2, v,3,0,2,63,66,0 days 00:00:00.504718
2353,Anuken/Mindustry,1,v,136,129,4,0,136,0 days 00:00:00.800549
2354,pyg-team/pytorch_geometric,1,,9,1,5,22,31,0 days 00:00:00.362510
2355,nhn/tui.editor,6, editor-plugin-table-merged-cell@ editor@ editor-plugin-color-syntax@ v vue-editor@,27,11,7,125,152,0 days 00:00:00.270820
2356,nodemailer/nodemailer,1,v,47,20,15,170,217,0 days 00:00:00.132677
2357,JaidedAI/EasyOCR,3, v pre-v,4,0,3,12,16,0 days 00:00:00.037529
2358,desktop/desktop,1,release-,22,6,8,136,158,0 days 00:00:01.770976
2359,riot/riot,1,v,44,16,10,155,199,0 days 00:00:00.353072
2360,gabime/spdlog,1,v,19,4,10,15,34,0 days 00:00:00.168906
2361,Tencent/ncnn,1,,32,9,3,0,32,0 days 00:00:00.112445
2362,jina-ai/jina,2, v,25,19,0,280,305,0 days 00:00:00.655294
2363,pqrs-org/Karabiner-Elements,1,v,28,11,5,0,28,0 days 00:00:00.311825
2364,Eloston/ungoogled-chromium,1,,0,0,0,2,2,0 days 00:00:00.029282
2365,framer/motion,1,v,60,51,3,243,303,0 days 00:00:00.328990
2366,you-dont-need/You-Dont-Need-Lodash-Underscore,1,v,14,5,6,6,20,0 days 00:00:00.035288
2367,kivy/kivy,1,,13,0,8,13,26,0 days 00:00:00.823599
2368,plotly/plotly.js,1,v,72,54,3,133,205,0 days 00:00:01.468669
2369,Tencent/vConsole,2, v,24,13,7,34,58,0 days 00:00:00.063066
2370,magic-wormhole/magic-wormhole,1,,12,2,6,22,34,0 days 00:00:00.077054
2371,node-red/node-red,2, v,26,3,18,99,125,0 days 00:00:00.408912
2372,iovisor/bcc,1,v,24,1,6,9,33,0 days 00:00:00.330706
2373,ampproject/amphtml,2, test-,1178,1172,0,0,1178,0 days 00:00:02.929163
2374,browsh-org/browsh,1,v,5,2,2,45,50,0 days 00:00:00.147200
2375,hashcat/hashcat,1,v,17,4,9,8,25,0 days 00:00:00.328224
2376,Tencent/MMKV,1,v,2,0,1,29,31,0 days 00:00:00.061215
2377,facebook/prophet,2, v,8,0,7,2,10,0 days 00:00:00.035006
2378,go-redis/redis,4,extra/redisotel/v extra/rediscensus/v v extra/rediscmd/v,53,30,9,191,244,0 days 00:00:00.204001
2379,antonmedv/fx,1,,27,18,4,34,61,0 days 00:00:00.040716
2380,frappe/charts,2, v,5,1,3,13,18,0 days 00:00:00.033888
2381,mkdocs/mkdocs,1,,20,9,9,27,47,0 days 00:00:00.095842
2382,facebookarchive/prepack,2, v,0,0,0,47,47,0 days 00:00:00.235338
2383,chrislusf/seaweedfs,2, v,218,211,2,0,218,0 days 00:00:00.538873
2384,joke2k/faker,1,v,95,84,9,138,233,0 days 00:00:00.240332
2385,hdodenhof/CircleImageView,1,v,9,1,7,6,15,0 days 00:00:00.019838
2386,doocs/leetcode,1,v,1,0,0,18,19,0 days 00:00:00.193411
2387,cayleygraph/cayley,1,v,5,0,3,10,15,0 days 00:00:00.071409
2388,sweetalert2/sweetalert2,1,v,129,115,3,544,673,0 days 00:00:00.827075
2389,fmtlib/fmt,2, v,23,2,14,16,39,0 days 00:00:00.461501
2390,checkly/headless-recorder,1,v,8,4,3,10,18,0 days 00:00:00.030429
2391,InstaPy/InstaPy,2, v,6,2,1,37,43,0 days 00:00:00.187271
2392,krisk/Fuse,2, v,25,12,11,50,75,0 days 00:00:00.056826
2393,erusev/parsedown,2, v,17,10,5,51,68,0 days 00:00:00.055871
2394,localtunnel/localtunnel,1,v,13,3,6,20,33,0 days 00:00:00.022775
2395,greensock/GSAP,1,,26,5,17,72,98,0 days 00:00:00.048291
2396,jarun/nnn,1,v,34,11,4,2,36,0 days 00:00:00.336297
2397,esp8266/Arduino,1,,9,0,6,13,22,0 days 00:00:00.217880
2398,aframevr/aframe,1,v,13,0,9,14,27,0 days 00:00:00.328298
2399,barryvdh/laravel-debugbar,2,v V,24,11,10,99,123,0 days 00:00:00.090895
2400,micropython/micropython,1,v,19,4,10,31,50,0 days 00:00:00.620785
2401,iBotPeaches/Apktool,1,v,12,3,8,23,35,0 days 00:00:00.102759
2402,browserify/browserify,2, v,149,129,7,264,413,0 days 00:00:00.376276
2403,google/filament,1,v,23,13,5,70,93,0 days 00:00:00.400180
2404,darkreader/darkreader,1,v,1,0,0,46,47,0 days 00:00:00.305697
2405,Kr328/ClashForAndroid,2, v,18,10,1,94,112,0 days 00:00:00.088034
2406,dogecoin/dogecoin,2, v,17,3,10,64,81,0 days 00:00:01.118827
2407,vitessio/vitess,2,vitess-parent- v,20,0,10,39,59,0 days 00:00:01.607791
2408,feathersjs/feathers,25, generator-feathers@ @feathersjs/socketio@ @feathersjs/authentication-client@ @feathersjs/express@ @feathersjs/configuration@ @feathersjs/adapter-tests@ @feathersjs/errors@ @feathersjs/socketio-client@ @feathersjs/client@ @feathersjs/transport-commons@ @feathersjs/authentication-oauth2@ @feathersjs/authentication-jwt@ @feathersjs/feathers@ generator-feathers-plugin@ @feathersjs/authentication-oauth1@ @feathersjs/authentication-local@ @feathersjs/adapter-commons@ @feathersjs/cli@ @feathersjs/authentication@ @feathersjs/primus@ v @feathersjs/commons@ @feathersjs/rest-client@ @feathersjs/primus-client@,22,2,11,211,233,0 days 00:00:00.247296
2409,kubernetes/kops,2, v,20,0,12,63,83,0 days 00:00:01.313018
2410,sass/sass,17,proposal.import-configuration.draft- proposal.slash-separator.draft- proposal.nested-map-functions.draft- proposal.min-max.draft- proposal.module-system.draft- proposal.css-imports.draft- proposal.content-args.draft- proposal.identifier-escapes.draft- proposal.supports-general.draft- proposal.new-js-importer.draft- proposal.at-rule-interpolation.draft- proposal.more-math-functions.draft- proposal.new-functions-and-values-api.draft- proposal.color-4-rgb-hsl.draft- proposal.logger.draft- proposal.forward-with.draft- proposal.media-ranges.draft-,15,4,6,26,41,0 days 00:00:00.033232
2411,be5invis/Iosevka,1,v,59,45,8,163,222,0 days 00:00:00.371315
2412,RasaHQ/rasa,1,,33,15,7,233,266,0 days 00:00:01.877558
2413,FormidableLabs/webpack-dashboard,2, v,12,3,8,31,43,0 days 00:00:00.030030
2414,aosp-mirror/platform_frameworks_base,27,android-r-preview- android-n-preview- android-wear-n-preview- afw-test-harness- android-sdk-adt_r android-m-preview- android-n-iot-release-polk-at android-o-mr1-iot-release- android-r-beta- android-n-iot-release-lg-thinq-wk platform-tools- android-sdk-support_r android-wear-o-preview- android-s-preview- android-n-iot-release-smart-display-r android-n-iot-release-ihome-igv android-n-iot-preview- android-l-preview_r android-o-iot-preview- gradle_ android-q-preview- android-t-preview- android-p-preview- studio- android-o-preview- android-s-beta- android-wear-p-preview-,17,1,9,73,90,0 days 00:00:47.821882
2415,bootstrap-vue/bootstrap-vue,2, v,47,38,2,66,113,0 days 00:00:00.326366
2416,rsms/inter,2,display-beta- v,38,24,4,3,41,0 days 00:00:00.087838
2417,infinitered/ignite,2, v,52,42,6,94,146,0 days 00:00:00.123556
2418,AvaloniaUI/Avalonia,2, nuget-release-,7,0,6,32,39,0 days 00:00:01.082882
2419,alibaba/ARouter,1,,4,1,2,16,20,0 days 00:00:00.028649
2420,google/libphonenumber,2,v libphonenumber-,20,10,5,149,169,0 days 00:00:00.154164
2421,medcl/elasticsearch-analysis-ik,1,v,42,5,11,130,172,0 days 00:00:00.067323
2422,microsoft/LightGBM,1,v,9,1,6,19,28,0 days 00:00:00.317992
2423,janpaepke/ScrollMagic,1,v,5,2,2,21,26,0 days 00:00:00.044193
2424,uNetworking/uWebSockets,1,v,66,52,5,26,92,0 days 00:00:00.107513
2425,CopyTranslator/CopyTranslator,2, v,6,1,3,14,20,0 days 00:00:00.064952
2426,marcuswestin/store.js,1,v,4,1,2,31,35,0 days 00:00:00.035142
2427,yiisoft/yii2,1,,1,0,0,61,62,0 days 00:00:01.196724
2428,gpujs/gpu.js,1,,21,15,3,55,76,0 days 00:00:00.086571
2429,hapijs/hapi,2, v,129,104,12,194,323,0 days 00:00:00.565119
2430,koel/koel,1,v,18,6,6,38,56,0 days 00:00:00.124568
2431,Qv2ray/Qv2ray,1,v,15,11,2,32,47,0 days 00:00:00.146616
2432,containers/podman,1,v,21,5,4,95,116,0 days 00:00:01.186090
2433,docker-slim/docker-slim,1,,38,21,10,17,55,0 days 00:00:00.048300
2434,material-components/material-components-android,1,,7,0,6,1,8,0 days 00:00:00.224492
2435,wangeditor-team/wangEditor,12,@wangeditor/editor-for-vue@ @wangeditor/editor-cattle@ @wangeditor/table-module@ @wangeditor/basic-modules@ @wangeditor/code-highlight@ v @wangeditor/video-module@ @wangeditor/core@ @wangeditor/editor@ @wangeditor/upload-image-module@ @wangeditor/list-module@ @wangeditor/editor-for-react@,91,11,6,458,549,0 days 00:00:00.551757
2436,wting/autojump,1,release-v,31,14,9,22,53,0 days 00:00:00.173300
2437,Tencent/QMUI_Android,1,,4,0,3,20,24,0 days 00:00:00.066321
2438,thomaspark/bootswatch,1,v,15,0,13,34,49,0 days 00:00:00.121151
2439,commitizen/cz-cli,2, v,16,6,7,58,74,0 days 00:00:00.044400
2440,kamranahmedse/driver.js,2, v,8,3,1,27,35,0 days 00:00:00.038236
2441,xbmc/xbmc,11,Dharma_beta Frodo_rc Gotham_beta Gotham_alpha Eden_rc Gotham_rc Frodo_beta Eden_beta Frodo_alpha Gotham-beta Dharma_rc,12,8,3,29,41,0 days 00:00:01.415176
2442,infinitered/reactotron,1,v,46,36,3,40,86,0 days 00:00:00.095609
2443,foreversd/forever,2, v,17,1,10,51,68,0 days 00:00:00.055894
2444,graphql/graphiql,22, graphql-language-service-utils@ codemirror-graphql@ graphiql@ example-graphiql-create-react-app@ monaco-graphql@ graphql-language-service-cli@ example-monaco-graphql-webpack@ graphql-language-service-parser@ graphql-language-service-interface@ example-graphiql-cdn@ @graphiql/react@ graphql-language-service-types@ graphql-language-service-server@ graphiql-example-webpack@ graphiql-parcel-example@ graphiql-example-cdn@ graphql-language-service@ v example-graphiql-webpack@ graphiql-2-rfc-context@ @graphiql/toolkit@,44,5,7,473,517,0 days 00:00:00.668001
2445,markdown-it/markdown-it,1,,29,13,10,47,76,0 days 00:00:00.067902
2446,hyperledger/fabric,2,baseimage-v v,10,0,8,34,44,0 days 00:00:00.939237
2447,hashicorp/packer,2, v,21,5,15,82,103,0 days 00:00:01.278058
2448,vuejs/vue,2, v,15,4,7,145,160,0 days 00:00:00.378246
2449,ipfs/go-ipfs,2,floodsub- v,12,1,6,40,52,0 days 00:00:00.921735
2450,facebook/react,2, v,36,8,14,58,94,0 days 00:00:01.061279
2451,airbnb/javascript,2,eslint-config-airbnb-base-v eslint-config-airbnb-v,39,20,13,62,101,0 days 00:00:00.130635
2452,prestodb/presto,1,,272,266,0,51,323,0 days 00:00:01.233597
2453,twbs/bootstrap,1,v,23,3,15,36,59,0 days 00:00:01.287198
2454,facebook/react-native,2, v,67,52,8,144,211,0 days 00:00:01.660242
2455,d3/d3,1,v,91,58,12,197,288,0 days 00:00:00.383920
2456,ytdl-org/youtube-dl,1,,0,0,0,1113,1113,0 days 00:00:02.752614
2457,facebook/create-react-app,13,react-dev-utils@ babel-plugin-named-asset-import@ react-scripts@ cra-template@ react-error-overlay@ timer-react-scripts@ react-app-polyfill@ v babel-preset-react-app@ eslint-config-react-app@ create-react-app@ confusing-browser-globals@ cra-template-typescript@,40,4,1,370,410,0 days 00:00:00.317154
2458,axios/axios,2, v,27,10,10,30,57,0 days 00:00:00.068002
2459,electron/electron,1,v,113,74,19,595,708,0 days 00:00:02.777692
2460,microsoft/vscode,7, vsda-v master-with-conflict- bad v release/ translation/,92,77,2,118,210,0 days 00:00:05.891246
2461,vercel/next.js,2, v,33,11,8,122,155,0 days 00:00:01.133204
2462,microsoft/terminal,2, v,3,0,2,91,94,0 days 00:00:00.253802
2463,tensorflow/tensorflow,3, v tflite-v,33,7,11,53,86,0 days 00:00:07.889512
2464,nodejs/node,2,v heads/tags/v,254,203,31,449,703,0 days 00:00:05.626883
2465,mrdoob/three.js,1,r,132,108,5,0,132,0 days 00:00:02.548951
2466,angular/angular,4, ngcontainer_ zone.js- v,42,16,12,257,299,0 days 00:00:02.340027
2467,golang/go,7,release.r weekly.2010-10- go weekly.2011-03- weekly.2010-12- weekly.2011-02- weekly.2009-11-,35,9,19,152,187,0 days 00:00:07.367922
2468,puppeteer/puppeteer,1,v,61,49,1,33,94,0 days 00:00:00.195634
2469,iluwatar/java-design-patterns,1,,19,3,13,0,19,0 days 00:00:00.186090
2470,mui/material-ui,6, olivier-material-ui-codemod@ olivier-material-ui-lab@ v olivier-eslint-plugin-material-ui@ olivier-material-ui-icons@,57,39,10,177,234,0 days 00:00:01.330028
2471,tensorflow/models,2,v. v,19,3,9,6,25,0 days 00:00:00.895930
2472,ant-design/ant-design,1,,79,66,4,329,408,0 days 00:00:01.578255
2473,nvbn/thefuck,1,,79,64,8,4,83,0 days 00:00:00.120170
2474,microsoft/PowerToys,2, v,28,19,3,31,59,0 days 00:00:00.293906
2475,FortAwesome/Font-Awesome,2, v,30,6,15,40,70,0 days 00:00:00.072410
2476,kubernetes/kubernetes,1,v,45,20,19,329,374,0 days 00:00:07.958721
2477,microsoft/TypeScript,1,v,12,2,2,120,132,0 days 00:00:02.345984
2478,Genymobile/scrcpy,1,v,25,9,5,2,27,0 days 00:00:00.287020
2479,laravel/laravel,1,v,40,19,17,134,174,0 days 00:00:00.549040
2480,huggingface/transformers,2, v,46,41,1,49,95,0 days 00:00:00.593332
2481,django/django,1,,19,0,15,248,267,0 days 00:00:02.260955
2482,storybookjs/storybook,1,v,107,90,13,323,430,0 days 00:00:02.968819
2483,typicode/json-server,2, v,17,4,10,106,123,0 days 00:00:00.080205
2484,opencv/opencv,1,,14,0,13,64,78,0 days 00:00:01.936637
2485,bitcoin/bitcoin,1,v,25,3,20,82,107,0 days 00:00:02.806035
2486,hakimel/reveal.js,1,,27,2,19,11,38,0 days 00:00:00.139352
2487,moby/moby,5, builder/ v upstream/ autorun/,30,10,9,114,144,0 days 00:00:02.801631
2488,gin-gonic/gin,1,v,13,3,8,13,26,0 days 00:00:00.088330
2489,webpack/webpack,1,v,152,134,8,224,376,0 days 00:00:01.179523
2490,angular/angular.js,1,v,11,0,9,136,147,0 days 00:00:00.838207
2491,gohugoio/hugo,1,v,93,72,10,101,194,0 days 00:00:00.455324
2492,netdata/netdata,4, poc v issue_,40,14,11,19,59,0 days 00:00:00.739137
2493,spring-projects/spring-boot,1,v,4,0,3,35,39,0 days 00:00:02.364311
2494,reduxjs/redux,1,v,26,16,6,42,68,0 days 00:00:00.142210
2495,pallets/flask,1,,16,5,10,25,41,0 days 00:00:00.423442
2496,tailwindlabs/tailwindcss,1,v,21,9,8,127,148,0 days 00:00:00.281210
2497,sveltejs/svelte,1,v,134,119,2,244,378,0 days 00:00:00.747917
2498,expressjs/express,1,,61,40,12,185,246,0 days 00:00:00.403052
2499,fatedier/frp,1,v,42,23,11,30,72,0 days 00:00:00.076629
2500,chartjs/Chart.js,2, v,21,7,10,31,52,0 days 00:00:00.247616
2501,jquery/jquery,1,,23,1,21,63,86,0 days 00:00:00.497287
2502,socketio/socket.io,1,,30,5,15,118,148,0 days 00:00:00.161640
2503,521xueweihan/HelloGitHub,1,vol.,19,16,1,0,19,0 days 00:00:00.019144
2504,adam-p/markdown-here,1,v,15,8,6,34,49,0 days 00:00:00.056897
2505,keras-team/keras,2, v,15,0,11,40,55,0 days 00:00:00.447369
2506,apple/swift,6,release- ran tranch ran- tranche smokes,9,5,3,2,11,0 days 00:00:04.222677
2507,atom/atom,2, v,271,256,2,104,375,0 days 00:00:02.624145
2508,shadowsocks/shadowsocks-windows,1,,13,4,7,49,62,0 days 00:00:00.094197
2509,protocolbuffers/protobuf,1,v,29,6,13,46,75,0 days 00:00:00.519565
2510,coder/code-server,2, v,20,9,4,22,42,0 days 00:00:00.248024
2511,redis/redis,3, v twitter-,14,1,11,157,171,0 days 00:00:00.980473
2512,lodash/lodash,1,,48,35,3,59,107,0 days 00:00:00.721386
2513,pytorch/pytorch,17,ciflow/cpu/ ciflow/nightly/ ciflow/macos/ ciflow/none/ ciflow/libtorch/ ciflow/slow-gradcheck/ ciflow/periodic/ ci/binaries/ ciflow/slow/ ciflow/linux/ v ciflow/binaries_conda/ ciflow/trunk/ ciflow/cuda/ ciflow/all/ ciflow/android/ ciflow/binaries/,119,89,14,49,168,0 days 00:00:03.292902
2514,h5bp/html5-boilerplate,2, v,19,2,13,10,29,0 days 00:00:00.091786
2515,apache/echarts,1,,29,5,14,64,93,0 days 00:00:00.671963
2516,elastic/elasticsearch,1,v,67,22,15,231,298,0 days 00:00:08.065439
2517,godotengine/godot,0,,0,0,0,0,0,0 days 00:00:00.042398
2518,ansible/ansible,2, v,26,4,13,174,200,0 days 00:00:03.304311
2519,azl397985856/leetcode,2, v,35,25,3,5,40,0 days 00:00:00.096947
2520,scikit-learn/scikit-learn,2, sprint,26,0,19,30,56,0 days 00:00:01.797365
2521,home-assistant/core,1,,129,126,0,397,526,0 days 00:00:03.462006
2522,psf/requests,2, v,43,11,22,101,144,0 days 00:00:00.320362
2523,mermaid-js/mermaid,3, real- v,21,8,8,76,97,0 days 00:00:00.272243
2524,spring-projects/spring-framework,1,v,1,0,0,20,21,0 days 00:00:01.481995
2525,ionic-team/ionic-framework,2, v,43,27,10,140,183,0 days 00:00:01.186037
2526,nestjs/nest,2, v,33,18,5,167,200,0 days 00:00:00.994661
2527,remix-run/react-router,1,v,39,22,11,76,115,0 days 00:00:00.441528
2528,moment/moment,1,,40,15,12,46,86,0 days 00:00:00.215700
2529,tiangolo/fastapi,2, v,77,68,3,52,129,0 days 00:00:00.151112
2530,ReactiveX/RxJava,3, v rxjava-,25,10,8,183,208,0 days 00:00:00.418048
2531,tesseract-ocr/tesseract,1,,15,1,10,8,23,0 days 00:00:00.478568
2532,grafana/grafana,2, v,46,7,9,181,227,0 days 00:00:03.032784
2533,apache/superset,4, v airbnb_prod. superset-helm-chart-,82,51,8,191,273,0 days 00:00:01.003965
2534,syncthing/syncthing,2,phabricator/diff/ v,36,17,11,240,276,0 days 00:00:00.559483
2535,google/guava,3,jdk5-backport-v failureaccess-v v,44,8,20,15,59,0 days 00:00:00.493305
2536,junegunn/fzf,1,,27,8,13,76,103,0 days 00:00:00.142267
2537,soimort/you-get,1,v,3,1,1,143,146,0 days 00:00:00.181125
2538,3b1b/manim,2, v,8,1,1,10,18,0 days 00:00:00.506922
2539,strapi/strapi,1,v,16,7,3,79,95,0 days 00:00:01.350610
2540,scrapy/scrapy,1,,32,7,17,58,90,0 days 00:00:00.598686
2541,prettier/prettier,2, v,39,20,8,71,110,0 days 00:00:00.486688
2542,serverless/serverless,3,v. v beta,181,174,3,175,356,0 days 00:00:01.073962
2543,juliangarnier/anime,2, v,8,2,5,6,14,0 days 00:00:00.046227
2544,prometheus/prometheus,2, v,67,35,6,79,146,0 days 00:00:00.719643
2545,vitejs/vite,8,create-app@ plugin-react-refresh@ plugin-react@ create-vite@ plugin-vue-jsx@ v plugin-vue@ plugin-legacy@,21,12,2,261,282,0 days 00:00:00.494651
2546,square/okhttp,2, parent-,39,11,12,56,95,0 days 00:00:00.331547
2547,meteor/meteor,59,release/oplog-limits-preview-blaze- release/galaxy-zdt- release/test-fooz release/WINDOWS-PREVIEW@ release/template-engine-preview- release/galaxy- release/bundler-profile- release/GITHUBBLE@ release/ANUBHAV-ERROR-APP-TEST@ release/GLASSER-TEST@ accounts-password@ release/node-no-fsevents- release/SLAVA-TEST@ ejson@ release/fix- release/blaze-test-rc release/mongo-new-devbundle- release/proxy-minimum-tags- release/redis-wip- temp release/nim-pull-requests-test- release/METEOR@ release/OPLOG-BACKLOG@ test release/galaxy-appconfig- release/test-slow-tests- release/EACH-IN@ release/PLUGINS-PREVIEW@ release/oplog-limits-preview- release/METEOR@cordova- release/TEMPLATE-CURRENT-DATA@ release/blaze-refactor-rc release-fixed/CORDOVA-PREVIEW@ release/emily-test-old release/galaxy-sso- release/template-engine-preview-release- release/METEOR@refreshpolicy-test. release/download-test- mother-dev-bundle-node- release/CORDOVA-PREVIEW@ release/METEOR@new-version-solver- release/selftest-built- release/test-fix- release/sso- release/TMEASDAY-RELEASE-TESTING@ release/linker-pre note release/fix-issue- release/blaze-rc release/invalidation-key-v release/GLASSER-TEST@maybe-rc release/METEOR@CORDOVA- release/oplog-preview- v release/ release/ANUBHAV-TEST@ release/rendering-preview- release/galaxy-follower- release/oplog-alpha,68,27,26,328,396,0 days 00:00:02.310833
2548,localstack/localstack,2,v localstack-,8,0,4,41,49,0 days 00:00:00.182275
2549,ColorlibHQ/AdminLTE,2, v,13,4,6,47,60,0 days 00:00:00.354243
2550,babel/babel,1,v,90,67,9,606,696,0 days 00:00:01.435388
2551,parcel-bundler/parcel,11,@parcel/fs@ @parcel/test-utils@ @parcel/utils@ @react-spectrum/actiongroup@ parcel-bundler@ @parcel/watcher@ v @parcel/logger@ @parcel/babel-register@ @parcel/integration-tests@ @parcel/workers@,19,13,4,52,71,0 days 00:00:00.427753
2552,caddyserver/caddy,1,v,14,2,10,49,63,0 days 00:00:00.224433
2553,yarnpkg/yarn,2, v,50,38,1,114,164,0 days 00:00:00.188419
2554,nuxt/nuxt.js,1,v,30,17,7,112,142,0 days 00:00:00.428523
2555,python/cpython,2, v,24,0,22,171,195,0 days 00:00:07.355085
2556,gogs/gogs,1,v,11,4,6,51,62,0 days 00:00:00.245465
2557,git/git,2,v gitgui-,89,25,33,438,527,0 days 00:00:04.836468
2558,square/retrofit,2, parent-,25,2,11,19,44,0 days 00:00:00.112646
2559,TryGhost/Ghost,2, v,170,154,8,318,488,0 days 00:00:01.404905
2560,danielmiessler/SecLists,1,,16,0,10,1,17,0 days 00:00:00.088190
2561,v2ray/v2ray-core,1,v,168,154,3,182,350,0 days 00:00:00.488225
2562,iamkun/dayjs,1,v,11,5,4,99,110,0 days 00:00:00.114481
2563,etcd-io/etcd,11, client/v etcdutl/v pkg/v server/v etcdctl/v client/pkg/v v api/v raft/v tests/v,16,0,11,207,223,0 days 00:00:01.379242
2564,facebook/jest,2, v,68,45,10,143,211,0 days 00:00:00.585274
2565,Dogfalo/materialize,2, v,17,10,3,20,37,0 days 00:00:00.221376
2566,nwjs/nw.js,2,v nw-v,60,22,11,207,267,0 days 00:00:00.810182
2567,vercel/hyper,2, v,18,9,6,43,61,0 days 00:00:00.182884
2568,mozilla/pdf.js,3,milestone-  v,2,0,0,57,59,0 days 00:00:01.167254
2569,ocornut/imgui,1,v,72,44,5,2,74,0 days 00:00:00.570330
2570,x64dbg/x64dbg,0,,0,0,0,0,0,0 days 00:00:00.013869
2571,cypress-io/cypress,13,@cypress/react-v @cypress/webpack-dev-server-v @cypress/vite-dev-server-v @cypress/mount-utils-v @cypress/vue-v @cypress/rollup-dev-server-v @cypress/schematic-v @cypress/webpack-preprocessor-v v @cypress/eslint-plugin-dev-v @cypress/webpack-batteries-included-preprocessor-v create-cypress-tests-v @cypress/design-system-v,99,69,16,351,450,0 days 00:00:01.318835
2572,microsoft/playwright,1,v,32,28,0,37,69,0 days 00:00:00.519449
2573,obsproject/obs-studio,1,,30,1,13,89,119,0 days 00:00:00.664171
2574,traefik/traefik,1,v,16,0,14,128,144,0 days 00:00:00.335619
2575,Textualize/rich,3, v. v,66,64,0,73,139,0 days 00:00:00.315879
2576,impress/impress.js,1,,8,4,3,4,12,0 days 00:00:00.028290
2577,styled-components/styled-components,4, sandbox@ v styled-components@,28,14,8,106,134,0 days 00:00:00.197506
2578,apache/dubbo,2, dubbo-,8,3,3,83,91,0 days 00:00:00.585866
2579,ethereum/go-ethereum,5, buildbot-testing-tag- poc v PoC,14,0,12,169,183,0 days 00:00:01.013797
2580,FiloSottile/mkcert,1,v,6,3,2,8,14,0 days 00:00:00.019967
2581,dcloudio/uni-app,2, v,8,2,1,8,16,0 days 00:00:00.547324
2582,ventoy/Ventoy,1,v,0,0,0,69,69,0 days 00:00:00.057049
2583,PhilJay/MPAndroidChart,1,v,8,2,4,33,41,0 days 00:00:00.109767
2584,pixijs/pixijs,3, v project_v,27,4,14,109,136,0 days 00:00:00.483927
2585,commaai/openpilot,1,v,8,1,6,62,70,0 days 00:00:00.081006
2586,hexojs/hexo,1,,38,14,12,101,139,0 days 00:00:00.214070
2587,Leaflet/Leaflet,1,v,16,1,13,27,43,0 days 00:00:00.352079
2588,vuetifyjs/vuetify,1,v,23,7,8,284,307,0 days 00:00:00.905170
2589,pandas-dev/pandas,2, v,28,1,22,56,84,0 days 00:00:01.861469
2590,PowerShell/PowerShell,2,SD/ v,24,17,6,40,64,0 days 00:00:00.733189
2591,grpc/grpc,4, release- v objective-c-v,55,19,3,109,164,0 days 00:00:03.094538
2592,alvarotrigo/fullPage.js,3, v. v,7,0,6,76,83,0 days 00:00:00.117373
2593,supabase/supabase,2, v,0,0,0,20,20,0 days 00:00:00.339595
2594,minio/minio,1,release-,1,0,0,0,1,0 days 00:00:00.319997
2595,facebook/docusaurus,1,v,14,8,1,37,51,0 days 00:00:00.502172
2596,sahat/hackathon-starter,1,,8,2,4,6,14,0 days 00:00:00.126966
2597,shadowsocks/shadowsocks,1,,4,1,2,14,18,0 days 00:00:00.044869
2598,videojs/video.js,2, v,70,38,15,220,290,0 days 00:00:00.361155
2599,Eugeny/tabby,1,v,0,0,0,116,116,0 days 00:00:00.339662
2600,NationalSecurityAgency/ghidra,0,,0,0,0,0,0,0 days 00:00:00.022207
2601,airbnb/lottie-android,2,v. v,21,8,9,42,63,0 days 00:00:00.089597
2602,rclone/rclone,1,v,69,36,11,21,90,0 days 00:00:00.432667
2603,quilljs/quill,1,v,23,12,5,99,122,0 days 00:00:00.485874
2604,lerna/lerna,1,v,39,26,6,70,109,0 days 00:00:00.179068
2605,d2l-ai/d2l-zh,1,v,9,5,3,0,9,0 days 00:00:00.158344
2606,koajs/koa,1,,43,23,13,44,87,0 days 00:00:00.207678
2607,BVLC/caffe,3, rc v,10,2,5,0,10,0 days 00:00:00.222426
2608,bumptech/glide,1,v,21,6,11,15,36,0 days 00:00:00.157622
2609,shadowsocks/shadowsocks-android,1,v,24,8,11,156,180,0 days 00:00:00.363137
2610,gulpjs/gulp,2, v,6,2,3,13,19,0 days 00:00:00.073568
2611,hashicorp/terraform,2, v,18,2,12,158,176,0 days 00:00:02.005970
2612,zenorocha/clipboard.js,1,v,9,5,3,33,42,0 days 00:00:00.033535
2613,marktext/marktext,1,v,7,2,4,20,27,0 days 00:00:00.077060
2614,ant-design/ant-design-pro,2, v,18,6,6,12,30,0 days 00:00:00.124111
2615,wg/wrk,1,,10,1,6,11,21,0 days 00:00:00.013253
2616,wagoodman/dive,1,v,10,5,2,15,25,0 days 00:00:00.035013
2617,immutable-js/immutable-js,2, v,16,11,3,39,55,0 days 00:00:00.105410
2618,evanw/esbuild,1,v,12,5,2,284,296,0 days 00:00:00.253646
2619,RocketChat/Rocket.Chat,1,,103,94,1,245,348,0 days 00:00:01.364971
2620,agalwood/Motrix,1,v,2,0,1,22,24,0 days 00:00:00.050026
2621,preactjs/preact,4,server-  v server-v,60,39,13,162,222,0 days 00:00:00.302583
2622,photonstorm/phaser,2, v,39,20,11,59,98,0 days 00:00:00.971971
2623,google/zx,1,,23,21,1,19,42,0 days 00:00:00.029251
2624,XX-net/XX-Net,1,,51,36,5,285,336,0 days 00:00:00.272522
2625,nolimits4web/swiper,1,v,49,13,13,139,188,0 days 00:00:00.209118
2626,php/php-src,12,MODERN_SYMMETRIC_SESSION_BEHAVIOUR_ ZEND_OPTIMIZER_B php BEFORE_SAPIFICATION_FEB_ ZO_B SQLITE_ oci8- BEFORE_IMPORT_OF_MYSQLND_IN_ BEFORE_REMOVING_GC_STEP RELEASE_ php- yaf-,41,5,30,434,475,0 days 00:00:07.906425
2627,pingcap/tidb,5, Beta v rc beta,14,1,5,99,113,0 days 00:00:01.209611
2628,Blankj/AndroidUtilCode,1,,27,12,7,89,116,0 days 00:00:00.081116
2629,nativefier/nativefier,2, v,56,42,9,90,146,0 days 00:00:00.092150
2630,NervJS/taro,1,v,12,2,5,272,284,0 days 00:00:00.946994
2631,jaredpalmer/formik,4, formik@ formik-native@ v,19,10,4,100,119,0 days 00:00:00.265539
2632,gorhill/uBlock,2, npm_,70,40,9,228,298,0 days 00:00:00.689946
2633,carbon-app/carbon,1,,24,14,4,194,218,0 days 00:00:00.272535
2634,bilibili/ijkplayer,3,k n wk,10,0,7,63,73,0 days 00:00:00.115946
2635,skylot/jadx,1,v,10,0,9,11,21,0 days 00:00:00.081925
2636,SheetJS/sheetjs,1,v,10,0,7,98,108,0 days 00:00:00.057340
2637,nlohmann/json,2, v,15,2,8,36,51,0 days 00:00:00.218828
2638,vuejs/core,1,v,3,0,1,52,55,0 days 00:00:00.304502
2639,istio/istio,1,,22,4,12,143,165,0 days 00:00:01.347304
2640,go-gitea/gitea,1,v,17,0,13,91,108,0 days 00:00:00.762812
2641,getsentry/sentry,2, v,102,90,9,294,396,0 days 00:00:02.989886
2642,microsoft/monaco-editor,2, v,28,11,10,36,64,0 days 00:00:00.142466
2643,streamich/react-use,1,v,134,130,3,117,251,0 days 00:00:00.196934
2644,zxing/zxing,4,ZXingTest- BSGlass- BS- zxing-,10,2,5,19,29,0 days 00:00:00.391234
2645,jeecgboot/jeecg-boot,2, v,6,0,3,16,22,0 days 00:00:00.040388
2646,laurent22/joplin,25, @joplin/plugins@ plugin-repo-cli-v cloud-v server-v android-v @joplin/turndown-plugin-gfm@ @joplin/renderer@ @joplin/fork-htmlparser2@ generator-joplin@ @joplin/app-clipper@ @joplin/fork-sax@ @joplin/tools@ @joplin/turndown@ clipper- joplin@ @joplin/app-mobile@ @joplin/app-desktop@ @joplin/plugin-repo-cli@ ios-v @joplin/lib@ @joplin/server@ v cli-v plugin-generator-v,3,1,1,894,897,0 days 00:00:02.026702
2647,netty/netty,0,,0,0,0,0,0,0 days 00:00:00.072067
2648,vuejs/vue-cli,22,@vue/eslint-config-prettier@ @vue/cli-plugin-babel@ @vue/cli-ui-addon-widgets@ @vue/cli-ui@ @vue/cli-upgrade@ @vue/cli-test-utils@ @vue/cli-plugin-typescript@ @vue/cli-service-global@ @vue/cli-plugin-e2e-nightwatch@ @vue/cli-service@ @vue/cli@ @vue/cli-plugin-pwa@ @vue/cli-plugin-unit-mocha@ @vue/cli-plugin-unit-jest@ @vue/cli-plugin-e2e-cypress@ @vue/cli-shared-utils@ @vue/cli-ui-addon-webpack@ @vue/eslint-config-typescript@ @vue/cli-plugin-eslint@ vue-cli-version-marker@ v @vue/cli-init@,30,16,6,107,137,0 days 00:00:00.322881
2649,alibaba/arthas,2, arthas-all-,6,0,4,35,41,0 days 00:00:00.084154
2650,google/leveldb,2, v,21,7,7,0,21,0 days 00:00:00.027303
2651,jgraph/drawio,2,testDeploy v,111,97,6,726,837,0 days 00:00:01.086071
2652,2dust/v2rayN,1,,117,111,1,2,119,0 days 00:00:00.080900
2653,ariya/phantomjs,1,,12,0,10,11,23,0 days 00:00:00.122558
2654,certbot/certbot,1,v,68,54,2,31,99,0 days 00:00:00.568049
2655,fxsjy/jieba,1,v,23,2,5,5,28,0 days 00:00:00.032413
2656,date-fns/date-fns,2,v. v,77,62,7,42,119,0 days 00:00:00.293410
2657,cli/cli,1,v,36,31,0,31,67,0 days 00:00:00.412960
2658,react-boilerplate/react-boilerplate,1,v,17,6,6,13,30,0 days 00:00:00.093294
2659,react-hook-form/react-hook-form,2, v,103,99,0,410,513,0 days 00:00:00.495881
2660,typeorm/typeorm,1,,3,0,2,79,82,0 days 00:00:00.352844
2661,go-gorm/gorm,1,v,5,0,4,77,82,0 days 00:00:00.113750
2662,beego/beego,1,v,16,3,10,24,40,0 days 00:00:00.233504
2663,jashkenas/backbone,2, v,10,2,7,22,32,0 days 00:00:00.280039
2664,tastejs/todomvc,2, v,7,1,3,6,13,0 days 00:00:00.146296
2665,nocodb/nocodb,2, v,9,5,2,86,95,0 days 00:00:00.184293
2666,mitmproxy/mitmproxy,2, v,30,4,17,35,65,0 days 00:00:00.564620
2667,openai/gym,2, v,15,7,6,34,49,0 days 00:00:00.086529
2668,markedjs/marked,2, v,16,2,11,94,110,0 days 00:00:00.142809
2669,dotnet/aspnetcore,8, blazor-wasm- blazor-wasm-rc blazor-wasm-preview v release/ rc beta,13,1,6,116,129,0 days 00:00:03.084957
2670,caolan/async,2, v,25,13,10,52,77,0 days 00:00:00.128329
2671,vuejs/vuex,1,v,21,7,7,24,45,0 days 00:00:00.170166
2672,Dreamacro/clash,1,v,28,10,3,14,42,0 days 00:00:00.044701
2673,square/leakcanary,1,v,14,4,9,10,24,0 days 00:00:00.100450
2674,alibaba/p3c,4,eclipse-plugin- idea-plugin- p3c-pmd- eclipse-pmd-,2,0,1,25,27,0 days 00:00:00.023134
2675,kenwheeler/slick,2, v,8,3,3,43,51,0 days 00:00:00.051524
2676,jesseduffield/lazygit,2, v,33,21,5,151,184,0 days 00:00:00.247404
2677,psf/black,1,,2,0,0,0,2,0 days 00:00:00.081275
2678,tannerlinsley/react-query,1,v,77,73,2,294,371,0 days 00:00:00.292858
2679,ReactiveX/rxjs,1,,19,7,6,45,64,0 days 00:00:00.274804
2680,atlassian/react-beautiful-dnd,2, v,24,15,4,46,70,0 days 00:00:00.187379
2681,FFmpeg/FFmpeg,3,v n ffmpeg-,29,0,24,303,332,0 days 00:00:06.498114
2682,standard/standard,1,v,66,55,8,87,153,0 days 00:00:00.141479
2683,naptha/tesseract.js,2, v,4,1,2,28,32,0 days 00:00:00.037916
2684,apolloconfig/apollo,2, v,19,2,9,16,35,0 days 00:00:00.134587
2685,spf13/cobra,2, v,5,0,4,13,18,0 days 00:00:00.045984
2686,airbnb/lottie-web,2,v. v,24,9,9,144,168,0 days 00:00:00.135611
2687,JetBrains/kotlin,10, native-merge- idea idea13- build- mercury-test- v m8- mercury-test M,19,4,10,3219,3238,0 days 00:00:27.438548
2688,composer/composer,1,,15,1,11,110,125,0 days 00:00:00.522416
2689,typicode/husky,1,v,34,16,11,88,122,0 days 00:00:00.073975
2690,aria2/aria2,1,release-,53,22,18,87,140,0 days 00:00:00.264536
2691,dbeaver/dbeaver,1,,24,0,22,138,162,0 days 00:00:01.131578
2692,google/googletest,1,release-,11,0,8,3,14,0 days 00:00:00.314191
2693,webtorrent/webtorrent,1,v,125,112,9,284,409,0 days 00:00:00.318524
2694,jashkenas/underscore,1,,20,5,13,54,74,0 days 00:00:00.889598
2695,topjohnwu/Magisk,2,v manager-v,80,42,6,43,123,0 days 00:00:00.247699
2696,laravel/framework,2, v,163,148,13,630,793,0 days 00:00:02.984767
2697,denysdovhan/wtfjs,1,v,23,13,6,16,39,0 days 00:00:00.033297
2698,postcss/postcss,1,,20,4,10,207,227,0 days 00:00:00.260552
2699,sequelize/sequelize,2, v,137,107,19,334,471,0 days 00:00:00.897524
2700,docker/compose,2, v,41,12,15,67,108,0 days 00:00:00.530866
2701,layui/layui,2, v,7,1,4,41,48,0 days 00:00:00.030978
2702,iamadamdev/bypass-paywalls-chrome,1,v,4,0,3,28,32,0 days 00:00:00.038675
2703,niklasvh/html2canvas,2, v,7,3,3,17,24,0 days 00:00:00.054790
2704,hankcs/HanLP,1,v,9,2,5,44,53,0 days 00:00:00.066054
2705,symfony/symfony,2,v vPR,31,5,21,497,528,0 days 00:00:04.798835
2706,JakeWharton/butterknife,2, butterknife-parent-,26,9,9,19,45,0 days 00:00:00.080880
2707,apache/airflow,81, providers-google/ providers-cloudant/ providers-microsoft-psrp/ backport-providers- providers-jdbc/ providers-apache-druid/ providers-apache-cassandra/ providers-apache-sqoop/ providers-telegram/ providers-salesforce/ providers-celery/ providers-mysql/ providers-apache-hive/ providers-jira/ providers-amazon/ providers-apache-kylin/ providers-microsoft-winrm/ providers-zendesk/ providers-trino/ v providers-sqlite/ providers-http/ providers-singularity/ providers-qubole/ providers-grpc/ providers-oracle/ providers-yandex/ providers-arangodb/ providers-opsgenie/ providers-dbt-cloud/ providers-airbyte/ providers-alibaba/ providers-slack/ providers-microsoft-azure/ providers-apache-beam/ providers-hashicorp/ airbnb_prod. providers-imap/ providers-apache-livy/ providers-jenkins/ providers-docker/ providers-facebook/ providers-segment/ providers-dingding/ providers-github/ providers-discord/ providers-apache-drill/ providers-mongo/ providers-tableau/ providers-snowflake/ providers-pagerduty/ constraints- providers-apache-spark/ providers-papermill/ providers-apache-pig/ providers-samba/ providers-apache-pinot/ providers-postgres/ providers-redis/ providers-influxdb/ providers-databricks/ providers-microsoft-mssql/ providers-elasticsearch/ providers-sendgrid/ providers-exasol/ providers-neo4j/ providers-openfaas/ providers-ftp/ providers-sftp/ providers-presto/ providers-apache-hdfs/ providers-odbc/ providers-asana/ helm-chart/ providers-plexus/ providers-ssh/ providers-datadog/ providers-cncf-kubernetes/ upgrade-check/ providers-vertica/,50,9,6,788,838,0 days 00:00:02.003497
2708,request/request,1,v,73,55,6,71,144,0 days 00:00:00.128990
2709,bannedbook/fanqiang,3,FQNews-v v ChromeGo-v,12,4,4,12,24,0 days 00:00:00.080442
2710,yt-dlp/yt-dlp,1,,0,0,0,55,55,0 days 00:00:01.061327
2711,alibaba/druid,1,,3,0,2,78,81,0 days 00:00:00.611879
2712,github/fetch,1,v,21,10,9,19,40,0 days 00:00:00.048355
2713,select2/select2,1,,9,2,5,27,36,0 days 00:00:00.139071
2714,angular/angular-cli,4, temporary-tag- v. v,36,14,7,279,315,0 days 00:00:00.763161
2715,mobxjs/mobx,7, mobx-react-lite@ mobx-undecorate@ v mobx@ eslint-plugin-mobx@ mobx-react@,65,38,5,238,303,0 days 00:00:00.375644
2716,chakra-ui/chakra-ui,78,chakra-nextjs-ts@ @chakra-ui/react-env@ @chakra-ui/stat@ @chakra-ui/accordion@ @chakra-ui/tag@ @chakra-ui/close-button@ @chakra-ui/system@ @chakra-ui/button@ @chakra-ui/cli@ @chakra-ui/theme@ @chakra-ui/counter@ @chakra-ui/table@ @chakra-ui/media-query@ @chakra-ui/layout@ next-js@ @chakra-ui/focus-lock@ @chakra-ui/input@ @chakra-ui/css-reset@ @chakra-ui/popper@ @chakra-ui/menu@ @chakra-ui/modal@ @chakra-ui/visually-hidden@ @chakra-ui/control-box@ @chakra-ui/babel-plugin@ with-chakra-ui@ @chakra-ui/icons@ @chakra-ui/toast@ @chakra-ui/core@ @chakra-ui/utils@ @chakra-ui/breadcrumb@ @chakra-ui/alert@ @chakra-ui/cra-template@ @chakra-ui/skeleton@ @chakra-ui/anatomy@ chakra-nextjs@ @chakra-ui/checkbox@ @chakra-ui/cra-template-typescript@ @chakra-ui/clickable@ @chakra-ui/switch@ @chakra-ui/react-utils@ gatsby-starter-chakra-ui@ @chakra-ui/radio@ @chakra-ui/provider@ gatsby-plugin-chakra-ui@ @chakra-ui/number-input@ @chakra-ui/slider@ @chakra-ui/tooltip@ @chakra-ui/image@ @chakra-ui/styled-system@ @chakra-ui/select@ @chakra-ui/spinner@ @chakra-ui/theme-tools@ create-react-app@ @chakra-ui/gatsby-plugin@ @chakra-ui/storybook-addon@ @chakra-ui/skip-nav@ @chakra-ui/color-mode@ @chakra-ui/avatar@ @chakra-ui/live-region@ @chakra-ui/machine@ @chakra-ui/hooks@ @chakra-ui/props-docs@ @chakra-ui/icon@ @chakra-ui/progress@ storybook-addon@ @chakra-ui/react@ @chakra-ui/textarea@ @chakra-ui/pin-input@ @chakra-ui/descendant@ @chakra-ui/popover@ @chakra-ui/editable@ @chakra-ui/tabs@ @chakra-ui/portal@ @chakra-ui/form-control@ @chakra-ui/docs@ @chakra-ui/test-utils@ chakra-cra@ @chakra-ui/transition@,32,1,1,1907,1939,0 days 00:00:04.362990
2717,Modernizr/Modernizr,1,v,20,4,13,23,43,0 days 00:00:00.118672
2718,cheeriojs/cheerio,2, v,22,7,7,30,52,0 days 00:00:00.059562
2719,rethinkdb/rethinkdb,4,javascript-v v ruby-v windows-alpha,24,7,8,80,104,0 days 00:00:01.669133
2720,harness/drone,1,v,31,17,9,44,75,0 days 00:00:00.181900
2721,codemirror/CodeMirror,3, v beta,122,103,7,45,167,0 days 00:00:00.502333
2722,tmux/tmux,1,,25,1,19,0,25,0 days 00:00:00.477268
2723,SortableJS/Sortable,1,,17,2,11,18,35,0 days 00:00:00.055656
2724,GitbookIO/gitbook,1,,22,17,2,68,90,0 days 00:00:00.112690
2725,curl/curl,3,tiny-curl- curl- c-ares-,84,1,23,86,170,0 days 00:00:01.430612
2726,GoogleChrome/lighthouse,2, v,56,40,4,42,98,0 days 00:00:00.394882
2727,hashicorp/consul,4,sdk/v v api/v internal/v,22,2,15,151,173,0 days 00:00:01.128837
2728,nektos/act,1,v,2,0,1,34,36,0 days 00:00:00.063815
2729,JedWatson/react-select,3, react-select@ v,28,14,10,73,101,0 days 00:00:00.192380
2730,alibaba/fastjson,1,,1,0,0,94,95,0 days 00:00:00.325267
2731,ianstormtaylor/slate,19,slate-prop-types@ slate-base64-serializer@ slate-dev-warning@ slate@ slate-react-placeholder@ slate-hyperscript@ slate-schema@ slate-dev-environment@ slate-dev-test-utils@ slate-simulator@ slate-schema-violations@ slate-dev-benchmark@ slate-plain-serializer@ slate-dev-logger@ slate-history@ slate-react@ slate-hotkeys@ v slate-html-serializer@,76,35,7,1634,1710,0 days 00:00:03.177183
2732,cockroachdb/cockroach,8,beta- staging-202011191818-v staging-202011251758-v v @cockroacklabs/cluster-ui@ @cockroachlabs/cluster-ui@ @cockroachlabs/clusterui@ staging-202011251240-v,55,41,10,138,193,0 days 00:00:04.801937
2733,ajaxorg/ace,3, v cloud,8,0,7,46,54,0 days 00:00:00.326128
2734,parallax/jsPDF,3, v. v,9,1,7,26,35,0 days 00:00:00.103859
2735,rstacruz/nprogress,2, v,2,0,1,8,10,0 days 00:00:00.016718
2736,YMFE/yapi,2, v,9,2,3,68,77,0 days 00:00:00.545929
2737,transloadit/uppy,49,@uppy/screen-capture@ @uppy/informer@ @uppy/xhr-upload@ @uppy/dropbox@ @uppy/locales@ @uppy/react-native@ @uppy/thumbnail-generator@ @uppy/box@ uppy@ @uppy/google-drive@ @uppy/form@ @uppy/angular@ @uppy/store-redux@ @uppy/image-editor@ @uppy/vue@ @uppy/core@ remark-lint-uppy@ @uppy/facebook@ @uppy/audio@ @uppy/unsplash@ @uppy/redux-dev-tools@ test-edgly @uppy/utils@ @uppy/tus@ @uppy/compressor@ @uppy/drag-drop@ @uppy/server-utils@ @uppy/instagram@ @uppy/onedrive@ @uppy/store-default@ @uppy/status-bar@ @uppy/companion@ @uppy/svelte@ @uppy/transloadit@ @uppy/dashboard@ @uppy/file-input@ @uppy/aws-s3-multipart@ @uppy/robodog@ @uppy/webcam@ @uppy/golden-retriever@ @uppy/progress-bar@ @uppy/provider-views@ @uppy/zoom@ @uppy/aws-s3@ @uppy/companion-client@ v @uppy/drop-target@ @uppy/react@ @uppy/url@,82,14,0,2258,2340,0 days 00:00:07.361478
2738,CMU-Perceptual-Computing-Lab/openpose,1,v,8,0,5,4,12,0 days 00:00:00.035211
2739,Binaryify/NeteaseCloudMusicApi,2, v,52,36,7,102,154,0 days 00:00:00.129026
2740,ccxt/ccxt,1,,0,0,0,505,505,0 days 00:00:04.791570
2741,remy/nodemon,1,v,20,7,9,101,121,0 days 00:00:00.320831
2742,lenve/vhr,1,v,12,9,1,0,12,0 days 00:00:00.016357
2743,Automattic/mongoose,2, v,58,15,20,646,704,0 days 00:00:01.373032
2744,OAI/OpenAPI-Specification,1,,2,0,1,3,5,0 days 00:00:00.082769
2745,hashicorp/vault,11,api/auth/userpass/v api/auth/approle/v sdk/v api/auth/ldap/v api/auth/aws/v api/auth/azure/v v api/v api/auth/gcp/v api/auth/kubernetes/v old-stable-website-,23,1,17,145,168,0 days 00:00:01.023675
2746,bvaughn/react-virtualized,2, v,71,65,3,129,200,0 days 00:00:00.144871
2747,kubernetes/minikube,1,v,61,43,1,45,106,0 days 00:00:01.123168
2748,ggreer/the_silver_searcher,1,,37,17,8,12,49,0 days 00:00:00.239955
2749,akveo/ngx-admin,1,v,19,2,9,8,27,0 days 00:00:00.204873
2750,ClickHouse/ClickHouse,1,,39,30,0,0,39,0 days 00:00:00.756404
2751,alibaba/easyexcel,2, v,3,0,2,26,29,0 days 00:00:00.049637
2752,scwang90/SmartRefreshLayout,1,V,3,0,2,10,13,0 days 00:00:00.064589
2753,cmderdev/cmder,1,v,4,0,2,24,28,0 days 00:00:00.068024
2754,sqlmapproject/sqlmap,1,,11,0,8,72,83,0 days 00:00:00.463567
2755,encode/django-rest-framework,1,,22,1,17,106,128,0 days 00:00:00.372792
2756,explosion/spaCy,2, v,28,14,11,72,100,0 days 00:00:00.838265
2757,CodeHubApp/CodeHub,1,,15,10,3,13,28,0 days 00:00:00.041141
2758,fastify/fastify,1,v,104,96,1,90,194,0 days 00:00:00.314636
2759,go-kit/kit,1,v,12,0,9,0,12,0 days 00:00:00.071972
2760,pmndrs/react-spring,1,v,22,15,3,150,172,0 days 00:00:00.328722
2761,alibaba/canal,2,v canal-,1,0,0,15,16,0 days 00:00:00.076360
2762,hammerjs/hammer.js,2, v,3,0,1,22,25,0 days 00:00:00.054161
2763,SeleniumHQ/selenium,7,atoms-base-  ide- atoms- selenium- core- rc-,76,44,15,28,104,0 days 00:00:02.131229
2764,prisma/prisma,1,,44,43,0,35,79,0 days 00:00:00.417313
2765,influxdata/influxdb,2, v,26,6,14,133,159,0 days 00:00:01.860855
2766,torvalds/linux,1,v,60,0,1,28,88,0 days 00:01:24.360086
2767,jupyterlab/jupyterlab,182,@jupyterlab/apputils@ @jupyterlab/docregistry@ @jupyterlab/test-inspector@ @jupyterlab/mime-extension-test@ @jupyterlab/logconsole-extension@ @jupyterlab/vdom-extension@ @jupyterlab/application-extension@ @jupyterlab/statusbar@ @jupyterlab/test-root@ @jupyterlab/example-console@ @jupyterlab/services-extension@ @jupyterlab/builder@ @jupyterlab/buildutils@ @jupyterlab/console-extension@ @jupyterlab/editorwidget-extension@ @jupyterlab/launcher@ @jupyterlab/mainmenu-extension@ @jupyterlab/javascript-extension@ @jupyterlab/test-services@ @jupyterlab/mock-provider@ @jupyterlab/nbconvert-css@ @jupyterlab/rendermime@ @jupyterlab/imageviewer@ @jupyterlab/toc@ @jupyterlab/completer@ @jupyterlab/example-federated@ @jupyterlab/htmlviewer@ @jupyterlab/inspector@ @jupyterlab/debugger-extension@ @jupyterlab/console@ @jupyterlab/docmanager@ @jupyterlab/fileeditor-extension@ @jupyterlab/test-docmanager@ @jupyterlab/test-completer@ jupyterlab-example-terminal@ @jupyterlab/test-application@ @jupyterlab/main@ @jupyterlab/example-cell@ @jupyterlab/mathjax2-extension@ @jupyterlab/docmanager-extension@ @jupyterlab/testutils@ @jupyterlab/csvviewer@ @jupyterlab/chatbox@ @jupyterlab/celltags-extension@ @jupyterlab/toc-extension@ @jupyterlab/json-extension@ @jupyterlab/template@ @jupyterlab/shared-models@ @jupyterlab/fileeditor@ browser-example@ @jupyterlab/mock-consumer@ @jupyterlab/test-all@ v @jupyterlab/completer-extension@ @jupyterlab/vdom@ @jupyterlab/terminal@ @jupyterlab/chatbox-extension@ @jupyterlab/settingeditor-extension@ @jupyterlab/services@ @jupyterlab/default-theme@ @jupyterlab/observables@ @jupyterlab/template-for-tests@ @jupyterlab/theme-dark-extension@ @jupyterlab/mock-token@ @jupyterlab/markdownwidget@ jupyterlab-example-filebrowser@ @jupyterlab/pdf-extension@ node-example@ @jupyterlab/debugger@ @jupyterlab/settingregistry@ @jupyterlab/notebook-extension@ @jupyterlab/statedb@ @jupyterlab/extensionmanager-extension@ @jupyterlab/galata@ @jupyterlab/markdownviewer@ @jupyterlab/example-filebrowser@ @jupyterlab/test-rendermime@ @jupyterlab/application-top@ @jupyterlab/terminal-extension@ @jupyterlab/application@ @jupyterlab/hub-extension@ @jupyterlab/test-cells@ @jupyterlab/test-terminal@ @jupyterlab/about-extension@ @jupyterlab/notebook@ @jupyterlab/vega3-extension@ @jupyterlab/docprovider@ @jupyterlab/imagewidget-extension@ @jupyterlab/ui-components@ @jupyterlab/editorwidget@ @jupyterlab/nbformat@ @jupyterlab/mathjax2@ @jupyterlab/documentsearch@ @jupyterlab/markdownwidget-extension@ @jupyterlab/example-services-browser@ @jupyterlab/test-fileeditor@ @jupyterlab/example-federated-core@ @jupyterlab/example-terminal@ @jupyterlab/mock-extension@ @jupyterlab/theme-light-extension@ @jupyterlab/test-settingregistry@ @jupyterlab/test-console@ @jupyterlab/extensionmanager@ @jupyterlab/codemirror@ typescript-browser-with-output@ @jupyterlab/test-statusbar@ @jupyterlab/csvwidget-extension@ @jupyterlab/celltags@ @jupyterlab/metapackage@ @jupyterlab/test-nbformat@ @jupyterlab/landing-extension@ @jupyterlab/vega5-extension@ @jupyterlab/test-outputarea@ @jupyterlab/test-imageviewer@ @jupyterlab/shortcuts-extension@ @jupyterlab/filebrowser@ @jupyterlab/example-federated-md@ @jupyterlab/test-apputils@ @jupyterlab/htmlviewer-extension@ @jupyterlab/mainmenu@ @jupyterlab/documentsearch-extension@ @jupyterlab/settingeditor@ @jupyterlab/example-app@ @jupyterlab/test-codemirror@ @jupyterlab/apputils-extension@ @jupyterlab/test-observables@ @jupyterlab/test-mainmenu@ @jupyterlab/faq-extension@ jupyterlab-example-console@ @jupyterlab/test-statedb@ @jupyterlab/mock-mime-extension@ @jupyterlab/tooltip-extension@ @jupyterlab/test-logconsole@ @jupyterlab/vega2-extension@ @jupyterlab/codeeditor@ @jupyterlab/help-extension@ @jupyterlab/cell-toolbar-extension@ @jupyterlab/rendermime-extension@ @jupyterlab/markdownviewer-extension@ @jupyterlab/rendermime-interfaces@ @jupyterlab/tabmanager-extension@ @jupyterlab/cells@ @jupyterlab/docregistry-extension@ @jupyterlab/translation-extension@ @jupyterlab/example-federated-middle@ jupyterlab-example-app@ @jupyterlab/extension-builder@ @jupyterlab/csvviewer-extension@ @jupyterlab/vega4-extension@ @jupyterlab/theming@ jupyterlab-example-notebook@ @jupyterlab/example-services-outputarea@ @jupyterlab/running-extension@ @jupyterlab/attachments@ @jupyterlab/cell-toolbar@ @jupyterlab/logconsole@ @jupyterlab/test-csvviewer@ @jupyterlab/test-coreutils@ @jupyterlab/coreutils@ @jupyterlab/imageviewer-extension@ @jupyterlab/running@ @jupyterlab/statusbar-extension@ @jupyterlab/property-inspector@ @jupyterlab/test-docregistry@ @jupyterlab/launcher-extension@ @jupyterlab/example-notebook@ @jupyterlab/test-ui-components@ @jupyterlab/all-packages@ @jupyterlab/ui-components-extension@ @jupyterlab/csvwidget@ @jupyterlab/imagewidget@ @jupyterlab/inspector-extension@ @jupyterlab/docprovider-extension@ @jupyterlab/test-notebook@ @jupyterlab/codemirror-extension@ @jupyterlab/test-codeeditor@ @jupyterlab/filebrowser-extension@ @jupyterlab/tooltip@ @jupyterlab/test-filebrowser@ @jupyterlab/translation@ @jupyterlab/outputarea@ @jupyterlab/example-federated-phosphor@,79,29,3,12902,12981,0 days 00:04:53.416631
2768,jitsi/jitsi-meet,7, android- stable/jitsi-meet_ ios- ios-sdk- jitsi-meet_ android-sdk-,7115,984,8,4680,11795,0 days 00:04:09.543401
2769,microsoft/fluentui,132,@fluentui/react-window-provider_v @uifabric/mdl2-theme_v @fluentui/react-shared-contexts_v @fluentui/react-menu_v @fluentui/examples_v @fluentui/react-proptypes_v @fluentui/styles_v @fluentui/react-theme-provider_v @uifabric/codepen-loader_v @fluentui/merge-styles_v @uifabric/tslint-rules_v @fluentui/react-icon-provider_v @fluentui/jest-serializer-merge-styles_v @fluentui/react-toggle_v @fluentui/date-time-utilities_v '@fluentui/react-northstar_v' lts- @fluentui/storybook_v @fluentui/scheme-utilities_v fluentui_v @fluentui/react-icons-northstar_v @uifabric/api-docs_v @fluentui/react-cards_v @fluentui/react-examples_v @uifabric/prettier-rules_v @uifabric/jest-serializer-merge-styles_v @fluentui/public-docsite_v @fluentui/dom-utilities_v @fluentui/react-utils_v @fluentui/react-text_v @fluentui/ie11-polyfills_v @fluentui/public-docsite-setup_v v 'fluentuizero_v' @fluentui/react-avatar_v @uifabric/react-hooks_v office-ui-fabric-react_v @uifabric/charting_v @uifabric/migration_v @fluentui/state_v @uifabric/example-app-base_v @fluentui/react-date-time_v @fluentui/bundle-size_v @fluentui/react-image_v @fluentui/make-styles_v @uifabric/foundation_v @fluentui/eslint-plugin_v @fluentui/web-components_v @fluentui/test-utilities_v @fluentui/react-hooks_v @fluentui/react-flex_v @fluentui/react_v @uifabric/experiments_v @fluentui/utilities_v @fluentui/example-data_v @uifabric/monaco-editor_v @fluentui/react-telemetry_v @fluentui/react-northstar_v @uifabric/styling_v @fluentui/make-styles-webpack-loader_v @uifabric/foundation-scenarios_v @uifabric/tsx-editor_v @fluentui/react-checkbox_v @uifabric/set-version_v @fluentui/react-conformance_v @fluentui/react-component-ref_v @uifabric/react-cards_v @fluentui/set-version_v @fluentui/react-slider_v @fluentui/react-file-type-icons_v @fluentui/react-button_v @fluentui/react-builder_v @fluentui/docs-components_v @uifabric/utilities_v @uifabric/file-type-icons_v @fluentui/react-component-event-listener_v @fluentui/react-provider_v @fluentui/api-docs_v @fluentui/theme_v @fluentui/theme-samples_v @fluentui/webpack-utilities_v @uifabric/fabric-website-resources_v @uifabric/test-utilities_v @fluentui/react-focus_v @fluentui/react-icons_v @fluentui/foundation-legacy_v @fluentui/playground_v @fluentui/codemods_v @fluentui/react-make-styles_v @fluentui/react-component-nesting-registry_v @fluentui/react-compose_v @fluentui/cra-template_v @fluentui/common-styles_v @uifabric/dashboard_v @uifabric/dashboard-grid-layout_v fluentuizero_v @fluentui/react-theming_v @uifabric/webpack-utils_v @uifabric/theme-samples_v @fluentui/react-context-selector_v @fluentui/react-stylesheets_v @fluentui/react-link_v @fluentui/accessibility_v @uifabric/azure-themes_v @fluentui/monaco-editor_v @fluentui/react-northstar-styles-renderer_v @uifabric/fluent-theme_v @fluentui/react-utilities_v @uifabric/pr-deploy-site_v @fluentui/react-theme_v @uifabric/fabric-website_v @uifabric/merge-styles_v @fluentui/react-bindings_v @fluentui/public-docsite-resources_v @fluentui/react-northstar-fela-renderer_v @fluentui/style-utilities_v @fluentui/azure-themes_v fabric-website_v @uifabric/example-data_v @fluentui/react-northstar-emotion-renderer_v @fluentui/react-monaco-editor_v @fluentui/react-docsite-components_v @uifabric/date-time_v @fluentui/react-tabs_v @fluentui/code-sandbox_v @fluentui/react-badge_v @fluentui/react-icons-mdl2-branded_v @fluentui/react-charting_v @fluentui/react-experiments_v @uifabric/icons_v @uifabric/variants_v @fluentui/keyboard-key_v,827,213,3,12663,13490,0 days 00:05:30.638421
2770,gatsbyjs/gatsby,140, gatsby-source-shopify@ gatsby-link@ gatsby-plugin-catch-links@ gatsby-react-router-scroll@ gatsby-transformer-yaml@ gatsby-transformer-json@ gatsby-telemetry@ gatsby-plugin-netlify-cms@ gatsby-plugin-nprogress@ gatsby-source-npm-package-search@ create-gatsby@ gatsby-plugin-canonical-urls@ gatsby-plugin-google-analytics@ gatsby-source-drupal@ gatsby-parcel-config@ gatsby-plugin-typescript@ gatsby-transformer-docx@ gatsby-remark-copy-linked-files@ gatsby-legacy-polyfills@ gatsby-dev-cli@ gatsby-plugin-create-client-paths@ gatsby@ gatsby-plugin-flow@ gatsby-graphiql-explorer@ cypress-gatsby@ gatsby-transformer-react-docgen@ gatsby-plugin-layout@ gatsby-source-faker@ gatsby-plugin-stylus@ gatsby-plugin-gatsby-cloud@ gatsby-plugin-no-sourcemaps@ gatsby-plugin-utils@ v @gatsbyjs/parcel-namer-relative-to-cwd@ gatsby-plugin-subfont@ graphql-skip-limit@ gatsby-transformer-javascript-frontmatter@ gatsby-plugin-preact@ gatsby-plugin-glamorous@ gatsby-transformer-csv@ gatsby-source-lever@ gatsby-plugin-sharp@ gatsby-plugin-cxs@ gatsby-source-wordpress@ gatsby-remark-katex@ gatsby-plugin-facebook-analytics@ gatsby-codemods@ gatsby-source-wordpress-com@ gatsby-plugin-fullstory@ gatsby-remark-prismjs@ gatsby-transformer-xml@ gatsby-script@ gatsby-plugin-guess-js@ gatsby-plugin-styled-components@ gatsby-transformer-sharp@ gatsby-theme-blog-core@ gatsby-plugin-google-gtag@ gatsby-remark-responsive-iframe@ gatsby-source-mongodb@ gatsby-cypress@ gatsby-transformer-remark@ gatsby-module-loader@ babel-preset-gatsby-package@ gatsby-remark-graphviz@ gatsby-plugin-page-creator@ gatsby-theme-workspace@ gatsby-1-config-extract-plugin@ gatsby-source-medium@ gatsby-transformer-documentationjs@ gatsby-plugin-sass@ babel-preset-gatsby@ gatsby-transformer-sqip@ gatsby-plugin-lodash@ gatsby-remark-images-contentful@ gatsby-cli@ gatsby-transformer-excel@ gatsby-plugin-benchmark-reporting@ gatsby-remark-code-repls@ gatsby-plugin-glamor@ gatsby-transformer-asciidoc@ gatsby-plugin-react-helmet@ gatsby-plugin-preload-fonts@ gatsby-source-wikipedia@ gatsby-plugin-emotion@ gatsby-sharp@ gatsby-design-tokens@ gatsby-plugin-postcss@ gatsby-remark-custom-blocks@ gatsby-theme-ui-preset@ gatsby-remark-smartypants@ gatsby-plugin-netlify-headers@ gatsby-source-contentful@ gatsby-plugin-react-css-modules@ gatsby-plugin-netlify@ gatsby-source-graphql@ gatsby-source-hacker-news@ gatsby-remark-embed-snippet@ gatsby-plugin-typography@ gatsby-image@ gatsby-plugin-feed@ gatsby-plugin-remove-trailing-slashes@ gatsby-plugin-mdx@ gatsby-transformer-javascript-static-exports@ gatsby-plugin-manifest@ gatsby-theme-notes@ gatsby-transformer-toml@ gatsby-remark-images@ gatsby-parcel-namer-relative-to-cwd@ gatsby-remark-autolink-headers@ gatsby-page-utils@ gatsby-plugin-aphrodite@ gatsby-plugin-schema-snapshot@ gatsby-plugin-twitter@ gatsby-recipes@ gatsby-starter-default@ gatsby-transformer-hjson@ gatsby-plugin-offline@ gatsby-plugin-image@ gatsby-theme-blog@ babel-plugin-remove-graphql-queries@ gatsby-plugin-postcss-sass@ gatsby-source-filesystem@ gatsby-transformer-pdfimages@ gatsby-plugin-sitemap@ gatsby-plugin-google-tagmanager@ gatsby-core-utils@ gatsby-plugin-jss@ gatsby-plugin-graphql-config@ gatsby-worker@ gatsby-transformer-screenshot@ gatsby-plugin-styletron@ gatsby-theme@ gatsby-transformer-pdf@ gatsby-plugin-react-next@ gatsby-plugin-styled-jsx@ gatsby-plugin-coffeescript@ gatsby-1-config-css-modules@ gatsby-plugin-less@ gatsby-admin@,156,17,4,16855,17011,0 days 00:08:22.418769
2771,v8/v8,3, lkgr/ test_tag,89,63,4,21687,21776,0 days 00:20:45.352910
