,project,prefixes,prefixes_names,main_releases,rapid_releases,trad_releases,patches,releases,time
0,allegro/bigcache,1,v,7,0,2,15,22,0 days 00:00:00.030475
1,robinvdvleuten/vuex-persistedstate,1,v,21,1,6,14,35,0 days 00:00:00.035636
2,lambci/docker-lambda,13,build-nodejs build-java build-provided.al build-ruby build-dotnetcore java ruby python provided.al v dotnetcore nodejs build-python,19,0,2,30,49,0 days 00:00:00.045024
3,mindoc-org/mindoc,1,v,14,8,3,17,31,0 days 00:00:00.050835
4,expressjs/session,1,v,17,1,5,45,62,0 days 00:00:00.056912
5,ratchetphp/Ratchet,1,v,4,0,3,23,27,0 days 00:00:00.059367
6,webpy/webpy,3, webpy- v,15,0,10,2,17,0 days 00:00:00.072579
7,1adrianb/face-alignment,1,v,5,1,2,5,10,0 days 00:00:00.020352
8,soldair/node-qrcode,3, issue- v,14,1,6,17,31,0 days 00:00:00.034120
9,bytedance/IconPark,1,v,4,0,0,32,36,0 days 00:00:00.027777
10,jquense/react-big-calendar,1,v,37,4,5,77,114,0 days 00:00:00.164497
11,FaisalUmair/udemy-downloader-gui,1,v,9,3,1,12,21,0 days 00:00:00.022296
12,telegraf/telegraf,2, v,68,11,5,112,180,0 days 00:00:00.237530
13,VirusTotal/yara,1,v,17,1,12,16,33,0 days 00:00:00.253125
14,googleapis/google-api-python-client,1,v,60,8,3,52,112,0 days 00:00:00.213749
15,infinitered/nsfwjs,1,v,6,0,4,5,11,0 days 00:00:00.041163
16,stevenjoezhang/live2d-widget,1,v,8,1,0,9,17,0 days 00:00:00.015722
17,lokesh/lightbox2,2, v,7,0,6,9,16,0 days 00:00:00.027673
18,microsoft/VFSForGit,1,v,0,0,0,31,31,0 days 00:00:00.153004
19,kickstarter/android-oss,1,v,36,14,5,36,72,0 days 00:00:00.352842
20,bblanchon/ArduinoJson,1,v,42,10,7,56,98,0 days 00:00:00.100068
21,Yelp/dumb-init,1,v,8,2,3,14,22,0 days 00:00:00.026035
22,weolar/miniblink49,1,,5,0,0,27,32,0 days 00:00:00.097766
23,midwayjs/midway,3,serverless- serverless-v v,47,16,1,337,384,0 days 00:00:00.546331
24,google/gops,1,v,3,0,0,24,27,0 days 00:00:00.022720
25,Netflix/metaflow,3, rec_ nflx-,7,0,3,54,61,0 days 00:00:00.053793
26,kubernetes/autoscaler,5,vertical-pod-autoscaler/v addon-resizer- cluster-autoscaler-chart- vertical-pod-autoscaler- cluster-autoscaler-,49,9,17,134,183,0 days 00:00:00.571725
27,kalcaddle/KodExplorer,2, v,31,2,6,3,34,0 days 00:00:00.023080
28,shaka-project/shaka-player,1,v,18,1,10,119,137,0 days 00:00:00.644043
29,operator-framework/operator-sdk,2,scorecard-kuttl/v v,42,30,0,47,89,0 days 00:00:00.217902
30,apache/zeppelin,1,v,5,0,4,10,15,0 days 00:00:00.381200
31,botman/botman,2, v,17,8,4,44,61,0 days 00:00:00.062190
32,vuejs/apollo,2, v,5,1,1,8,13,0 days 00:00:00.055595
33,listen1/listen1_desktop,1,v,26,3,1,40,66,0 days 00:00:00.031006
34,projectdiscovery/subfinder,2, v,10,3,4,24,34,0 days 00:00:00.063346
35,ecrmnn/collect.js,1,,35,2,1,154,189,0 days 00:00:00.107217
36,lets-blade/blade,1,,1,0,0,1,2,0 days 00:00:00.018935
37,substack/tape,1,v,50,2,10,85,135,0 days 00:00:00.092207
38,yzhao062/pyod,3,V v. v,4,0,2,24,28,0 days 00:00:00.104742
39,HashLips/hashlips_art_engine,0,,0,0,0,0,0,0 days 00:00:00.013263
40,go-yaml/yaml,1,v,6,1,1,10,16,0 days 00:00:00.035742
41,bchavez/Bogus,1,v,7,0,0,97,104,0 days 00:00:00.071554
42,capstone-engine/capstone,1,,5,2,2,9,14,0 days 00:00:00.260003
43,encode/apistar,1,,6,0,0,88,94,0 days 00:00:00.067632
44,facebook/facebook-android-sdk,2,sdk-version- v,95,30,3,44,139,0 days 00:00:00.265109
45,eternnoir/pyTelegramBotAPI,1,,15,3,7,37,52,0 days 00:00:00.139478
46,springfox/springfox,6, swagger-springmvc- CI-master- v pre- swagger-springmvc-parent-,21,5,14,54,75,0 days 00:00:00.306360
47,assaf/zombie,2, v,21,8,5,111,132,0 days 00:00:00.122078
48,imba/imba,4, typescript-imba-plugin@ vsimba@ v,6,0,4,51,57,0 days 00:00:00.233401
49,matthewmueller/x-ray,1,,5,0,2,13,18,0 days 00:00:00.021381
50,neutralinojs/neutralinojs,1,v,26,18,4,4,30,0 days 00:00:00.070001
51,joeyespo/grip,1,v,15,2,10,9,24,0 days 00:00:00.143053
52,graphql-editor/graphql-editor,2, v,19,0,0,127,146,0 days 00:00:00.067541
53,lightbend/config,1,v,9,0,3,19,28,0 days 00:00:00.058660
54,lmcinnes/umap,2, v,4,0,3,20,24,0 days 00:00:00.084373
55,ory/kratos,0,,0,0,0,0,0,0 days 00:00:00.022925
56,docker/docker-py,1,,40,7,11,63,103,0 days 00:00:00.193960
57,maaslalani/slides,1,v,8,3,0,8,16,0 days 00:00:00.018748
58,ml5js/ml5-library,3, V v,9,3,1,45,54,0 days 00:00:00.193050
59,xamarin/Xamarin.Forms,4,release-  tag-test rui-,9,0,3,9,18,0 days 00:00:00.217665
60,Xhofe/alist,1,v,9,5,2,33,42,0 days 00:00:00.041295
61,arkenfox/user.js,1,,52,23,0,0,52,0 days 00:00:00.118561
62,berty/berty,1,v,390,53,1,579,969,0 days 00:00:01.568184
63,Dman95/SASM,1,v,15,1,5,11,26,0 days 00:00:00.023088
64,lua/lua,1,v,15,0,13,15,30,0 days 00:00:00.323413
65,OpenNMT/OpenNMT-py,2, v,15,5,7,14,29,0 days 00:00:00.234878
66,SixLabors/ImageSharp,1,v,3,1,1,6,9,0 days 00:00:01.145181
67,thephpleague/omnipay,2, v,12,3,4,18,30,0 days 00:00:00.043728
68,roots/bedrock,1,,21,0,4,82,103,0 days 00:00:00.062811
69,Richasy/Bili.Uwp,1,v,1,0,0,23,24,0 days 00:00:00.029728
70,datreeio/datree,1,,14,3,1,93,107,0 days 00:00:00.195109
71,tijsverkoyen/CssToInlineStyles,1,,9,2,2,20,29,0 days 00:00:00.024597
72,golden-layout/golden-layout,2, v,7,1,3,25,32,0 days 00:00:00.046273
73,chainer/chainer,1,v,60,44,3,18,78,0 days 00:00:01.796928
74,tipsy/javalin,3, javalin- javalin-parent-,42,22,4,42,84,0 days 00:00:00.107532
75,MikeMcl/bignumber.js,2, v,20,0,3,27,47,0 days 00:00:00.024759
76,datahub-project/datahub,2,RC-v v,6,1,3,42,48,0 days 00:00:00.339837
77,vuejs/vetur,2, v,23,12,7,47,70,0 days 00:00:00.204764
78,doctrine/collections,2, v,7,0,5,9,16,0 days 00:00:00.034876
79,tilt-dev/tilt,1,v,30,16,5,172,202,0 days 00:00:00.299386
80,kyleconroy/sqlc,2, v,15,6,3,1,16,0 days 00:00:00.048135
81,Respect/Validation,1,,11,1,8,108,119,0 days 00:00:00.269664
82,dthree/vorpal,1,v,4,0,0,57,61,0 days 00:00:00.029832
83,zaphoyd/websocketpp,1,,6,0,4,3,9,0 days 00:00:00.081746
84,lebab/lebab,1,v,14,8,2,28,42,0 days 00:00:00.056233
85,Alluxio/alluxio,2,alluxio-parent- v,26,1,23,28,54,0 days 00:00:01.957603
86,modulz/stitches,1,v,5,1,0,22,27,0 days 00:00:00.064784
87,Lexikos/AutoHotkey_L,2,L v,56,6,0,146,202,0 days 00:00:00.203638
88,haifengl/smile,1,v,12,3,6,10,22,0 days 00:00:00.111594
89,nodeca/js-yaml,1,,23,2,11,51,74,0 days 00:00:00.168440
90,graphql-java/graphql-java,2, v,40,6,12,2,42,0 days 00:00:00.251410
91,aimeos/aimeos-laravel,1,,3,0,1,112,115,0 days 00:00:00.109809
92,filamentgroup/tablesaw,1,v,5,0,3,27,32,0 days 00:00:00.043192
93,documentationjs/documentation,1,v,36,3,4,49,85,0 days 00:00:00.083674
94,mit-pdos/xv6-public,0,,0,0,0,0,0,0 days 00:00:00.011257
95,carbon-design-system/carbon,8, carbon-components-react@ @carbon/elements@ carbon-components@ v @carbon/icons-angular@ @carbon/themes@ @carbon/sketch@,204,61,0,513,717,0 days 00:00:01.162540
96,doctrine/common,2, v,18,0,14,31,49,0 days 00:00:00.393214
97,tensorflow/serving,2, r,25,5,10,27,52,0 days 00:00:00.411138
98,artilleryio/artillery,2, v,5,0,3,43,48,0 days 00:00:00.104442
99,MinecraftForge/MinecraftForge,2, v,59,22,13,10,69,0 days 00:00:00.560064
100,google/ios-webkit-debug-proxy,2, v,9,1,5,9,18,0 days 00:00:00.018698
101,sockeqwe/mosby,1,,7,3,2,8,15,0 days 00:00:00.036395
102,antonioru/beautiful-react-hooks,1,,5,0,1,6,11,0 days 00:00:00.032678
103,flarum/framework,1,v,4,0,3,6,10,0 days 00:00:00.866186
104,gzu-liyujiang/AndroidPicker,1,,11,0,3,45,56,0 days 00:00:00.038846
105,webiny/webiny-js,82,@webiny/mongo-http-client@ @webiny/serverless-function@ webiny-integration-cookie-policy@v @webiny/serverless-app@ @webiny/http-handler@ @webiny/api-page-builder@ @webiny/app-cookie-policy@ @webiny/app-page-builder-theme@ @webiny/serverless-template@ @webiny/api-plugin-commodo-db-proxy@ @webiny/app-plugin-security-cognito-theme@ webiny-integration-typeform@v @webiny/serverless-aws-api-gateway@ @webiny/form@ @webiny/api-files@ @webiny/api-form-builder@ @webiny/serverless-files@ @webiny/project-utils@ @webiny/app-form-builder@ @webiny/app@ @webiny/app-admin@ @webiny/api-plugin-page-builder-resolvers-mongodb@ @webiny/i18n-react@ @webiny/serverless-api-gateway@ webiny-app-typeform@v @webiny/api-i18n@ @webiny/api-plugin-security-cognito@ @webiny/app-forms@ @webiny/commodo-graphql@ @webiny/commodo@ @webiny/app-typeform@ @webiny/app-page-builder@ @webiny/api-mailchimp@ @webiny/api-plugin-create-apollo-handler@ @webiny/serverless-aws-cloudfront@ webiny-api-cookie-policy@v @webiny/app-mailchimp@ @webiny/cli@ @webiny/serverless-page-builder@ @webiny/api-plugin-commodo-mongodb@ @webiny/app-i18n@ @webiny/serverless-db-proxy@ @webiny/serverless-deploy@ @webiny/ui@ @webiny/api-plugin-files-resolvers-mongodb@ @webiny/app-security@ @webiny/i18n@ @webiny/serverless-apollo-service@ @webiny/app-form-builder-theme@ @webiny/http-handler-index@ @webiny/api-security@ @webiny/webpack-externals@ webiny-app-mailchimp@v @webiny/api-plugin-form-builder-resolvers-mongodb@ webiny-api-mailchimp@v @webiny/plugins@ webiny-integration-google-tag-manager@v @webiny/validation@ webiny-integration-mailchimp@v @webiny/api-google-tag-manager@ @webiny/app-google-tag-manager@ @webiny/serverless-aws-lambda@ @webiny/http-handler-files@ @webiny/http-handler-ssr@ webiny-api-google-tag-manager@v @webiny/api-forms@ webiny-app-google-tag-manager@v @webiny/app-plugin-security-cognito@ @webiny/storybook-utils@ @webiny/api-plugin-forms-resolvers-mongodb@ @webiny/api-cookie-policy@ @webiny/api@ @webiny/serverless-form-builder@ @webiny/serverless-apollo-gateway@ @webiny/api-cms@ webiny-app-cookie-policy@v @webiny/serverless-aws-cognito-user-pool@ @webiny/react-router@ @webiny/api-plugin-create-apollo-gateway@ @webiny/tracking@ v @webiny/commodo-fields-storage-db-proxy@,78,52,1,1147,1225,0 days 00:00:02.319092
106,pagekit/pagekit,1,,4,0,2,31,35,0 days 00:00:00.242258
107,NLog/NLog,5, V NLog- Build- v,24,1,13,67,91,0 days 00:00:00.406001
108,dotnetcore/CAP,1,v,22,4,10,30,52,0 days 00:00:00.100001
109,graphite-project/graphite-web,1,,2,0,1,22,24,0 days 00:00:00.374758
110,swoft-cloud/swoft,1,v,3,0,2,25,28,0 days 00:00:00.076381
111,mledoze/countries,1,v,14,0,8,10,24,0 days 00:00:00.043969
112,benbusby/whoogle-search,2, v,7,1,2,15,22,0 days 00:00:00.045040
113,dinerojs/dinero.js,2, v,13,7,3,17,30,0 days 00:00:00.033971
114,robolectric/robolectric,4,Release robolectric- Robolectric robolectric-bazel-,28,3,19,37,65,0 days 00:00:00.722994
115,microsoft/reverse-proxy,1,v,2,0,1,1,3,0 days 00:00:00.046919
116,LawnchairLauncher/lawnchair,26, android-n-iot-release-polk-at android-s-preview- android-n-iot-preview- android-wear-o-preview- Pixel-v android-wear-n-preview- cm- android-n-preview- platform-tools- android-o-iot-preview- android-q-preview- android-wear-p-preview- android-l-preview_r android-p-preview- android-s-beta- android-o-mr1-iot-release- android-o-preview- android-m-preview- android-n-iot-release-smart-display-r android-r-beta- android-t-preview- android-n-iot-release-lg-thinq-wk v android-n-iot-release-ihome-igv android-r-preview-,66,16,10,90,156,0 days 00:00:02.617605
117,nl8590687/ASRT_SpeechRecognition,1,v,10,3,2,4,14,0 days 00:00:00.022067
118,EasyDarwin/EasyDarwin,1,v,2,0,0,8,10,0 days 00:00:00.097534
119,johnkerl/miller,2, v,29,15,8,23,52,0 days 00:00:00.477609
120,apache/beam,4,dataflow_runner_v sdks/v jupyterlab-sidepanel-v v,53,19,7,26,79,0 days 00:00:02.282292
121,aws/aws-sdk-php,1,,234,16,2,1228,1462,0 days 00:00:03.094702
122,express-validator/express-validator,1,v,55,6,7,60,115,0 days 00:00:00.180492
123,octokit/octokit.js,1,v,8,0,0,9,17,0 days 00:00:00.018384
124,pachyderm/pachyderm,6, debug_rtd_sidebar_ v vv debug_rtd_styles gf-,28,8,12,232,260,0 days 00:00:02.027343
125,hashicorp/serf,1,v,9,3,2,22,31,0 days 00:00:00.109836
126,brndnmtthws/conky,2, v,7,0,6,21,28,0 days 00:00:00.202266
127,smacke/ffsubsync,2, v,2,0,0,27,29,0 days 00:00:00.026097
128,bfenetworks/bfe,1,v,18,10,3,0,18,0 days 00:00:00.062557
129,expressjs/cors,1,v,11,0,1,23,34,0 days 00:00:00.023097
130,jackc/pgx,1,v,36,5,14,18,54,0 days 00:00:00.267117
131,mikaelbr/node-notifier,1,v,24,3,10,45,69,0 days 00:00:00.051272
132,weaveworks/scope,2, v,31,15,5,30,61,0 days 00:00:00.287207
133,missive/emoji-mart,1,v,20,4,7,40,60,0 days 00:00:00.055497
134,lutris/lutris,2, v,3,1,1,63,66,0 days 00:00:00.565240
135,jrnl-org/jrnl,2, v,13,3,4,24,37,0 days 00:00:00.080907
136,persepolisdm/persepolis,1,,5,0,4,6,11,0 days 00:00:00.068334
137,nanomsg/nanomsg,1,,3,0,2,5,8,0 days 00:00:00.075895
138,angular-ui/ui-grid,1,v,24,7,7,86,110,0 days 00:00:00.261876
139,jbaysolutions/vue-grid-layout,1,,5,1,1,29,34,0 days 00:00:00.031058
140,iovisor/bpftrace,1,v,8,0,6,11,19,0 days 00:00:00.131719
141,serilog/serilog,1,v,19,3,7,13,32,0 days 00:00:00.083978
142,SpiderLabs/ModSecurity,1,v,7,0,6,46,53,0 days 00:00:00.200911
143,evernote/android-job,1,v,4,0,2,36,40,0 days 00:00:00.037070
144,jaywcjlove/hotkeys,1,v,12,2,3,62,74,0 days 00:00:00.037454
145,juicedata/juicefs,2, v,8,5,0,17,25,0 days 00:00:00.164803
146,algolia/places,1,v,34,10,3,69,103,0 days 00:00:00.079983
147,dotnet/reactive,3,rxnet-v ixnet-v v,8,0,6,17,25,0 days 00:00:00.273470
148,valor-software/ngx-bootstrap,2, v,31,11,7,81,112,0 days 00:00:00.319932
149,jonls/redshift,2, v,17,3,7,2,19,0 days 00:00:00.038428
150,trinodb/trino,1,,297,265,0,12,309,0 days 00:00:01.628874
151,NVIDIA/TensorRT,2, v,27,8,0,6,33,0 days 00:00:00.028739
152,tidwall/evio,1,v,2,0,0,8,10,0 days 00:00:00.017631
153,JesusFreke/smali,2,smalidea-v v,23,4,8,38,61,0 days 00:00:00.233454
154,gcanti/io-ts,1,,20,2,0,84,104,0 days 00:00:00.055421
155,sqlalchemy/sqlalchemy,1,rel_,14,0,13,194,208,0 days 00:00:01.031554
156,PX4/PX4-Autopilot,6,fixedwing_ NuttX- auterion-v alpha_ v FF-v,14,0,8,41,55,0 days 00:00:02.139176
157,asaskevich/govalidator,2, v,11,0,8,3,14,0 days 00:00:00.169795
158,nextapps-de/winbox,1,,2,1,0,17,19,0 days 00:00:00.146114
159,alan-turing-institute/sktime,1,v,10,0,4,14,24,0 days 00:00:00.160949
160,dagger/dagger,1,v,2,0,0,12,14,0 days 00:00:00.205472
161,anishathalye/dotbot,1,v,20,0,3,28,48,0 days 00:00:00.032129
162,nathancahill/split,2, v,10,1,2,38,48,0 days 00:00:00.028930
163,seek-oss/vanilla-extract,14,@vanilla-extract/babel-plugin@ @vanilla-extract/dynamic@ @vanilla-extract/next-plugin@ @vanilla-extract/integration@ @vanilla-extract/css-utils@ @vanilla-extract/private@ @vanilla-extract/snowpack-plugin@ @vanilla-extract/esbuild-plugin@ @vanilla-extract/css@ @vanilla-extract/vite-plugin@ @vanilla-extract/recipes@ @vanilla-extract/sprinkles@ @vanilla-extract/rollup-plugin@ @vanilla-extract/webpack-plugin@,18,0,0,182,200,0 days 00:00:00.090851
164,mwouts/jupytext,3, v. v,20,5,6,75,95,0 days 00:00:00.135030
165,adazzle/react-data-grid,2, v,1,0,0,180,181,0 days 00:00:00.151920
166,jonschlinkert/remarkable,2, v,9,5,2,13,22,0 days 00:00:00.034522
167,samber/lo,1,v,22,8,0,3,25,0 days 00:00:00.026173
168,plopjs/plop,4, plop@ node-plop@ v,42,3,15,50,92,0 days 00:00:00.078182
169,FreeTubeApp/FreeTube,1,,1,0,0,0,1,0 days 00:00:00.021463
170,log4js-node/log4js-node,1,v,32,9,7,90,122,0 days 00:00:00.235504
171,ppoffice/hexo-theme-icarus,2, v,22,2,7,9,31,0 days 00:00:00.035049
172,docker/docker-ce,1,v,2,0,1,24,26,0 days 00:00:02.730085
173,oatpp/oatpp,1,,4,0,3,10,14,0 days 00:00:00.082331
174,developit/unfetch,2, isomorphic-,7,0,3,8,15,0 days 00:00:00.023597
175,lucidrains/DALLE2-pytorch,2, v,6,0,0,178,184,0 days 00:00:00.086601
176,fatih/color,1,v,16,0,2,1,17,0 days 00:00:00.016904
177,chyroc/WechatSogou,1,v,8,0,0,15,23,0 days 00:00:00.022833
178,google/glog,1,v,6,0,3,8,14,0 days 00:00:00.049493
179,ly525/luban-h5,1,v,18,6,2,14,32,0 days 00:00:00.215039
180,agentejo/cockpit,1,,8,1,5,27,35,0 days 00:00:00.156924
181,goproxyio/goproxy,1,v,2,0,0,7,9,0 days 00:00:00.015136
182,containers/buildah,3, V v,42,18,3,70,112,0 days 00:00:00.364224
183,kaorun343/vue-property-decorator,1,v,24,4,5,16,40,0 days 00:00:00.028968
184,redis/hiredis,1,v,7,0,5,11,18,0 days 00:00:00.050575
185,reach/reach-ui,17,@reach/window-size@ @reach/menu-button@ @reach/tooltip@ @reach/dialog@ @reach/utils@ @reach/alert@ @reach/rect@ @reach/skip-nav@ @reach/auto-id@ @reach/tabs@ @reach/portal@ @reach/combobox@ @reach/popover@ @reach/component-component@ v @reach/visually-hidden@ @reach/alert-dialog@,16,5,5,137,153,0 days 00:00:00.139478
186,django-oscar/django-oscar,1,,19,0,15,80,99,0 days 00:00:00.501995
187,LSPosed/LSPosed,1,v,6,0,2,41,47,0 days 00:00:00.319344
188,Snapchat/KeyDB,1,v,6,1,2,16,22,0 days 00:00:01.418724
189,arachnys/cabot,1,,6,1,1,33,39,0 days 00:00:00.050370
190,NicolasHug/Surprise,1,v,2,0,1,9,11,0 days 00:00:00.130480
191,kubernetes-sigs/external-dns,2,external-dns-helm-chart- v,20,6,6,41,61,0 days 00:00:00.157332
192,go-acme/lego,1,v,34,12,7,17,51,0 days 00:00:00.071222
193,go-flutter-desktop/go-flutter,1,v,39,4,1,15,54,0 days 00:00:00.032262
194,gorakhargosh/watchdog,1,v,12,2,6,35,47,0 days 00:00:00.075203
195,open-cli-tools/concurrently,2, v,27,1,3,18,45,0 days 00:00:00.030882
196,gogo/protobuf,1,v,9,0,8,4,13,0 days 00:00:00.061812
197,mixn/carbon-now-cli,2, v,5,2,1,7,12,0 days 00:00:00.139779
198,bytedance/xgplayer,1,v,4,0,1,44,48,0 days 00:00:00.054323
199,rappasoft/laravel-boilerplate,4, Laravel_ update_readme_ v,65,11,8,242,307,0 days 00:00:00.286134
200,ExactTarget/fuelux,1,,25,9,5,59,84,0 days 00:00:00.166916
201,micronaut-projects/micronaut-core,1,v,16,0,6,80,96,0 days 00:00:00.741012
202,tealeg/xlsx,4,go go.r go.go v,11,2,3,13,24,0 days 00:00:00.066201
203,oauth2-proxy/oauth2-proxy,1,v,18,1,10,9,27,0 days 00:00:00.107516
204,PyGithub/PyGithub,2, v,62,31,6,23,85,0 days 00:00:00.104010
205,devicons/devicon,1,v,17,4,5,4,21,0 days 00:00:00.060119
206,barryvdh/laravel-dompdf,1,v,10,0,2,24,34,0 days 00:00:00.024492
207,jpillora/cloud-torrent,1,,3,0,0,34,37,0 days 00:00:00.017492
208,mapstruct/mapstruct,0,,0,0,0,0,0,0 days 00:00:00.017155
209,encode/uvicorn,1,,17,0,4,119,136,0 days 00:00:00.090774
210,django/channels,1,,20,7,7,44,64,0 days 00:00:00.082727
211,tjanczuk/edge,1,v,11,2,4,23,34,0 days 00:00:00.044451
212,i-tu/Hasklig,2, v,12,3,3,0,12,0 days 00:00:00.032571
213,ecomfe/zrender,2, v,20,0,11,65,85,0 days 00:00:00.141562
214,rectorphp/rector,2, v,13,1,9,351,364,0 days 00:00:01.111240
215,scribejava/scribejava,2, scribejava-,41,15,10,41,82,0 days 00:00:00.082628
216,unicorn-engine/unicorn,1,,2,0,1,3,5,0 days 00:00:00.107250
217,domlysz/BlenderGIS,2, v,3,0,2,0,3,0 days 00:00:00.030421
218,leongersen/noUiSlider,1,,45,7,13,58,103,0 days 00:00:00.083058
219,alibaba/transmittable-thread-local,2, v,18,5,8,31,49,0 days 00:00:00.051033
220,FastLED/FastLED,4, archive/FastSPI_LED archive/FastLED v,8,0,6,20,28,0 days 00:00:00.091727
221,arturbien/React95,1,v,13,0,2,6,19,0 days 00:00:00.038153
222,zotero/zotero,1,,7,0,6,246,253,0 days 00:00:00.949254
223,phan/phan,1,,33,12,10,127,160,0 days 00:00:00.391036
224,frohoff/ysoserial,2, v,0,0,0,10,10,0 days 00:00:00.012949
225,tzapu/WiFiManager,2, v,16,5,3,0,16,0 days 00:00:00.022865
226,sachinchoolur/lightgallery.js,1,,5,0,0,11,16,0 days 00:00:00.014126
227,achael/eht-imaging,1,v,3,0,2,7,10,0 days 00:00:00.110958
228,mher/flower,1,v,9,1,6,15,24,0 days 00:00:00.072872
229,remarkjs/remark,5, remark-stringify@ remark-parse@ remark@ remark-cli@,56,15,3,95,151,0 days 00:00:00.143953
230,moby/buildkit,2,dockerfile/ v,13,1,5,32,45,0 days 00:00:00.334412
231,crowdsecurity/crowdsec,1,v,7,0,3,39,46,0 days 00:00:00.064664
232,h6ah4i/android-advancedrecyclerview,1,,8,1,6,22,30,0 days 00:00:00.045732
233,crossplane/crossplane,1,v,23,11,3,34,57,0 days 00:00:00.408244
234,substack/minimist,1,,6,0,0,20,26,0 days 00:00:00.014957
235,graphql-dotnet/graphql-dotnet,2, v,42,12,6,45,87,0 days 00:00:00.252652
236,wasabeef/Blurry,1,,6,0,3,7,13,0 days 00:00:00.017434
237,dmlc/gluon-cv,1,v,10,0,8,0,10,0 days 00:00:00.056936
238,mailcow/mailcow-dockerized,0,,0,0,0,0,0,0 days 00:00:00.012414
239,crazycodeboy/react-native-splash-screen,1,v,6,0,4,6,12,0 days 00:00:00.017991
240,serialport/node-serialport,18, @serialport/parser-readline@ @serialport/parser-slip-encoder@ @serialport/stream@ @serialport/parser-byte-length@ @serialport/repl@ @serialport/parser-regex@ @serialport/terminal@ @serialport/binding-mock@ @serialport/list@ serialport@ @serialport/parser-cctalk@ @serialport/parser-ready@ @serialport/bindings@ @serialport/parser-inter-byte-timeout@ v @serialport/binding-abstract@ @serialport/parser-delimiter@,24,1,3,180,204,0 days 00:00:00.286684
241,chrisbanes/tivi,2,build-number- v,7,1,3,42,49,0 days 00:00:00.275628
242,muaz-khan/RecordRTC,1,,5,0,1,38,43,0 days 00:00:00.039953
243,svaarala/duktape,2,convert-makedist-to-python- v,30,7,16,25,55,0 days 00:00:00.561623
244,release-it/release-it,1,,84,18,5,176,260,0 days 00:00:00.314146
245,kubernetes-sigs/kubebuilder,5,tools- v1beta v release- v1alpha,15,4,5,22,37,0 days 00:00:00.259388
246,liamg/traitor,1,v,0,0,0,14,14,0 days 00:00:00.015331
247,blender/blender,2,softbody-stable-v v,63,5,39,35,98,0 days 00:00:06.541563
248,nodegit/nodegit,1,v,27,8,10,67,94,0 days 00:00:00.190105
249,librosa/librosa,2, v,9,0,8,13,22,0 days 00:00:00.163650
250,naver/billboard.js,1,,21,1,13,54,75,0 days 00:00:00.180109
251,StackExchange/StackExchange.Redis,2, v,2,0,1,35,37,0 days 00:00:00.106456
252,kartik-v/bootstrap-fileinput,1,v,26,6,3,61,87,0 days 00:00:00.085542
253,go-task/task,1,v,26,7,6,26,52,0 days 00:00:00.064697
254,sachinchoolur/lightGallery,2, v,16,2,4,66,82,0 days 00:00:00.066214
255,vrana/adminer,1,v,17,4,11,35,52,0 days 00:00:00.189533
256,junit-team/junit5,2,prototype- r,11,1,8,17,28,0 days 00:00:00.427090
257,onionshare/onionshare,2, v,18,5,11,9,27,0 days 00:00:00.235859
258,flowable/flowable-engine,1,flowable-,10,0,9,9,19,0 days 00:00:00.768326
259,arkime/arkime,1,v,32,2,16,70,102,0 days 00:00:00.234967
260,bee-san/pyWhat,1,,13,11,0,6,19,0 days 00:00:00.040594
261,wix/react-native-interactable,2, v,1,0,0,11,12,0 days 00:00:00.020886
262,nhn/tui.image-editor,2, v,21,5,7,17,38,0 days 00:00:00.051529
263,bestiejs/benchmark.js,1,,5,1,3,19,24,0 days 00:00:00.062815
264,snorkel-team/snorkel,1,v,4,1,2,11,15,0 days 00:00:00.129694
265,wangyu-/udp2raw,1,,38,17,2,0,38,0 days 00:00:00.040505
266,microsoft/Windows-driver-samples,1,,609,0,0,0,609,0 days 00:00:00.425904
267,arwes/arwes,0,,0,0,0,0,0,0 days 00:00:00.011666
268,hiroppy/fusuma,1,v,37,10,1,59,96,0 days 00:00:00.076060
269,share/sharedb,1,v,23,5,4,111,134,0 days 00:00:00.109047
270,GoogleChrome/lighthouse-ci,1,v,9,1,4,24,33,0 days 00:00:00.056692
271,standard-things/esm,1,,29,24,1,160,189,0 days 00:00:00.487887
272,reviewdog/reviewdog,2, v,6,1,4,21,27,0 days 00:00:00.145431
273,davidhalter/jedi,1,v,13,0,10,14,27,0 days 00:00:00.475045
274,windicss/windicss,1,v,13,5,0,81,94,0 days 00:00:00.070371
275,caronc/apprise,1,v,3,0,2,32,35,0 days 00:00:00.042324
276,johannesjo/super-productivity,1,v,58,45,3,296,354,0 days 00:00:00.682213
277,yarnpkg/berry,41,@yarnpkg/eslint-config/ @yarnpkg/plugin-pack/ @yarnpkg/parsers/ @yarnpkg/plugin-patch/ @yarnpkg/cli/ @yarnpkg/plugin-interactive-tools/ @yarnpkg/plugin-stage/ @yarnpkg/doctor/ @yarnpkg/plugin-nm/ @yarnpkg/libzip/ @yarnpkg/plugin-pnp/ @yarnpkg/plugin-node-modules/ @yarnpkg/pnp/ @yarnpkg/shell/ @yarnpkg/plugin-essentials/ @yarnpkg/builder/ @yarnpkg/plugin-http/ @yarnpkg/pnpify/ @yarnpkg/esbuild-plugin-pnp/ @yarnpkg/plugin-npm-cli/ @yarnpkg/plugin-npm/ @yarnpkg/plugin-version/ @yarnpkg/plugin-compat/ @yarnpkg/sdks/ @yarnpkg/plugin-git/ @yarnpkg/json-proxy/ @yarnpkg/plugin-link/ @yarnpkg/libui/ @yarnpkg/fslib/ @yarnpkg/plugin-dlx/ @yarnpkg/plugin-exec/ @yarnpkg/plugin-constraints/ @yarnpkg/plugin-github/ @yarnpkg/plugin-pnpm/ vscode-zipfs/ @yarnpkg/plugin-init/ @yarnpkg/plugin-typescript/ @yarnpkg/plugin-file/ @yarnpkg/nm/ @yarnpkg/plugin-workspace-tools/ @yarnpkg/core/,18,1,1,316,334,0 days 00:00:00.422396
278,RicoSuter/NSwag,2,NSwag-Build- v,388,120,2,12,400,0 days 00:00:00.614632
279,lancedikson/bowser,2, v,26,8,8,33,59,0 days 00:00:00.067182
280,ai/size-limit,1,,45,9,2,101,146,0 days 00:00:00.190880
281,rmax/scrapy-redis,2, v,6,0,1,12,18,0 days 00:00:00.020969
282,openpgpjs/openpgpjs,1,v,40,10,9,109,149,0 days 00:00:00.159960
283,airbnb/knowledge-repo,1,v,4,0,2,27,31,0 days 00:00:00.063901
284,maximegris/angular-electron,2, angular,47,6,4,52,99,0 days 00:00:00.055239
285,tporadowski/redis,7, msopentech_ win_ win win- v Win,6,0,5,99,105,0 days 00:00:00.582274
286,vuejs/v2.vuejs.org,1,v,8,2,3,9,17,0 days 00:00:00.032674
287,timolins/react-hot-toast,1,v,7,2,2,5,12,0 days 00:00:00.022564
288,reactchartjs/react-chartjs-2,3, v. v,24,2,2,51,75,0 days 00:00:00.046321
289,laravel/socialite,1,v,18,0,5,62,80,0 days 00:00:00.061468
290,duckdb/duckdb,1,v,3,0,2,22,25,0 days 00:00:00.785683
291,lesspass/lesspass,6, site-v pure-v mobile-v web-extension-v cli-v,11,1,1,43,54,0 days 00:00:00.130275
292,PrismLibrary/Prism,6,Prism.Formsv WPFv v Prism.Windows Prism.v Prismv,7,0,6,4,11,0 days 00:00:00.154468
293,msiemens/tinydb,2, v,34,5,11,26,60,0 days 00:00:00.045752
294,luraproject/lura,2, v,15,1,11,12,27,0 days 00:00:00.053388
295,jarun/buku,2, v,36,15,6,3,39,0 days 00:00:00.112157
296,healthchecks/healthchecks,2, v,28,10,1,8,36,0 days 00:00:00.130661
297,reek/anti-adblock-killer,1,v,31,12,1,0,31,0 days 00:00:00.157666
298,expressjs/body-parser,1,,21,2,8,47,68,0 days 00:00:00.043405
299,nhn/tui.chart,2, v,38,17,5,60,98,0 days 00:00:00.547595
300,quartznet/quartznet,1,v,12,0,10,27,39,0 days 00:00:00.187766
301,jvm-profiling-tools/async-profiler,1,v,14,2,9,9,23,0 days 00:00:00.038393
302,btraceio/btrace,3,release-  v,5,0,2,34,39,0 days 00:00:00.078421
303,minbrowser/min,2, v,26,4,8,31,57,0 days 00:00:00.265593
304,TommyLemon/Android-ZBLibrary,1,,21,1,4,4,25,0 days 00:00:00.033096
305,mautic/mautic,1,,30,6,13,59,89,0 days 00:00:01.310591
306,go-pg/pg,4,extra/pgsegment/v extra/pgotel/v extra/pgdebug/v v,59,6,3,305,364,0 days 00:00:00.407815
307,journeyapps/zxing-android-embedded,1,v,15,2,10,7,22,0 days 00:00:00.068561
308,pypa/pipx,1,,15,1,3,36,51,0 days 00:00:00.042031
309,laravel-mix/laravel-mix,1,v,27,16,2,105,132,0 days 00:00:00.124895
310,JoeDog/siege,1,v,2,0,0,9,11,0 days 00:00:00.040908
311,timber/timber,2, v,32,10,14,96,128,0 days 00:00:00.250616
312,microsoft/FASTER,2,FASTER_ v,5,0,1,53,58,0 days 00:00:00.073193
313,flask-admin/flask-admin,2, v,6,0,4,17,23,0 days 00:00:00.143995
314,spectreconsole/spectre.console,1,,44,8,1,3,47,0 days 00:00:00.042446
315,futurepress/epub.js,3, alpha- v,2,0,0,34,36,0 days 00:00:00.073412
316,duo-labs/cloudmapper,1,,5,0,2,21,26,0 days 00:00:00.057669
317,espnet/espnet,1,v.,11,1,6,32,43,0 days 00:00:00.877348
318,Mailtrain-org/mailtrain,1,v,25,9,2,10,35,0 days 00:00:00.073112
319,ankidroid/Anki-Android,5, api-v cardCustomize-alpha v pull,24,1,18,64,88,0 days 00:00:00.868078
320,wiremock/wiremock,2,release- ,55,17,15,28,83,0 days 00:00:00.132582
321,SigmaHQ/sigma,1,,19,6,6,10,29,0 days 00:00:00.532394
322,bitnami-labs/sealed-secrets,3,sealed-secrets- helm-v v,21,6,6,41,62,0 days 00:00:00.073165
323,ZipArchive/ZipArchive,2, v,17,1,8,80,97,0 days 00:00:00.059405
324,uber/prototool,1,v,18,9,2,2,20,0 days 00:00:00.029137
325,istanbuljs/nyc,1,v,58,15,2,56,114,0 days 00:00:00.175953
326,microsoft/MixedRealityToolkit-Unity,2, v,10,0,5,26,36,0 days 00:00:01.289549
327,lukeed/polka,1,v,5,1,2,9,14,0 days 00:00:00.019473
328,zhaojun1998/zfile,1,,32,8,3,11,43,0 days 00:00:00.030976
329,kedacore/keda,1,v,14,3,4,3,17,0 days 00:00:00.082468
330,json5/json5,1,v,10,1,6,8,18,0 days 00:00:00.028426
331,uNetworking/uWebSockets.js,1,v,59,32,3,6,65,0 days 00:00:00.062114
332,arrow-kt/arrow,7, arrow-site- arrow-libs-core- arrow-libs-ank- arrow-libs-fx- arrow-libs-optics- v,13,3,7,40,53,0 days 00:00:00.404558
333,material-shell/material-shell,2, v,11,5,2,0,11,0 days 00:00:00.052321
334,ponylang/ponyc,2, release-,51,31,9,56,107,0 days 00:00:00.374500
335,Angel-ML/angel,2,v Release-,14,2,6,4,18,0 days 00:00:00.139394
336,panjf2000/gnet,1,v,8,2,4,35,43,0 days 00:00:00.046248
337,cookieY/Yearning,2, v,0,0,0,3,3,0 days 00:00:00.014374
338,kubeedge/kubeedge,1,v,14,1,10,11,25,0 days 00:00:00.335593
339,google/benchmark,1,v,8,0,7,9,17,0 days 00:00:00.073155
340,PaddlePaddle/models,2,develop-align-v v,6,1,2,2,8,0 days 00:00:00.235773
341,rauchg/slackin,1,,14,2,2,26,40,0 days 00:00:00.157261
342,ServiceStack/ServiceStack,1,v,17,1,12,41,58,0 days 00:00:00.838415
343,canonical/microk8s,2,installer-v v,11,0,7,4,15,0 days 00:00:00.061275
344,reactjs/react-rails,2, v,24,7,7,31,55,0 days 00:00:00.085912
345,pedroslopez/whatsapp-web.js,1,v,18,5,2,39,57,0 days 00:00:00.040764
346,docker/machine,2, v,16,2,8,16,32,0 days 00:00:00.258141
347,universal-ctags/ctags,1,p,0,0,0,86,86,0 days 00:00:00.490373
348,telepresenceio/telepresence,4, chart-v rpc/v v,116,61,7,88,204,0 days 00:00:00.644850
349,meetecho/janus-gateway,1,v,11,1,7,53,64,0 days 00:00:00.265077
350,hajimehoshi/ebiten,1,v,17,2,13,66,83,0 days 00:00:00.436967
351,roadrunner-server/roadrunner,2, v,22,6,7,81,103,0 days 00:00:00.303030
352,fengyuanchen/viewerjs,1,v,21,4,5,28,49,0 days 00:00:00.034613
353,greenplum-db/gpdb,4, REL PG95- Release_,62,27,20,115,177,0 days 00:00:03.172003
354,LonamiWebs/Telethon,1,v,44,21,4,91,135,0 days 00:00:00.248973
355,boto/boto,2, v,50,25,9,29,79,0 days 00:00:00.342495
356,vitalets/x-editable,1,,6,4,1,9,15,0 days 00:00:00.033291
357,opencart/opencart,1,,11,3,4,24,35,0 days 00:00:00.686097
358,pyeve/eve,1,v,11,0,7,33,44,0 days 00:00:00.166272
359,vmware/clarity,6, clr release-v v v. web,27,4,11,316,343,0 days 00:00:00.370019
360,go-admin-team/go-admin,1,v,6,1,3,27,33,0 days 00:00:00.181298
361,Workiva/go-datastructures,1,v,1,0,0,53,54,0 days 00:00:00.045789
362,mobxjs/mobx-state-tree,2, v,38,21,6,64,102,0 days 00:00:00.255059
363,google/closure-compiler,5,webpack-v closure-compiler-maven-v v closure-compiler-parent-v maven-release-v,141,104,2,24,165,0 days 00:00:01.149025
364,sghall/react-move,1,v,28,8,4,21,49,0 days 00:00:00.038370
365,ocrmypdf/OCRmyPDF,1,v,63,26,7,115,178,0 days 00:00:00.216836
366,yugabyte/yugabyte-db,2, v,18,0,11,73,91,0 days 00:00:00.996317
367,glidejs/glide,1,v,8,1,3,25,33,0 days 00:00:00.049804
368,gocd/gocd,1,,69,47,4,2,71,0 days 00:00:00.761856
369,invoiceninja/invoiceninja,1,v,41,20,5,387,428,0 days 00:00:01.429380
370,360Controller/360Controller,1,v,1,0,0,11,12,0 days 00:00:00.078672
371,li-xiaojun/XPopup,3, dialog- v,19,3,0,159,178,0 days 00:00:00.114434
372,0x7c13/Notepads,1,v,14,3,2,42,56,0 days 00:00:00.058521
373,hotoo/pinyin,1,,13,1,6,28,41,0 days 00:00:00.042351
374,VictoriaMetrics/VictoriaMetrics,2,pmm-6401-v v,75,53,0,189,264,0 days 00:00:00.364333
375,electerm/electerm,2, v,35,2,1,292,327,0 days 00:00:00.207473
376,php-pm/php-pm,1,,6,0,1,15,21,0 days 00:00:00.050115
377,electronicarts/EASTL,1,,14,0,1,31,45,0 days 00:00:00.062152
378,mltframework/shotcut,1,v,49,41,0,85,134,0 days 00:00:00.355487
379,optuna/optuna,1,v,36,27,2,4,40,0 days 00:00:00.721413
380,AGWA/git-crypt,1,,7,0,4,2,9,0 days 00:00:00.028881
381,HospitalRun/hospitalrun-frontend,2, v,3,0,2,25,28,0 days 00:00:00.209371
382,wilsonpage/fastdom,2, v,8,1,2,23,31,0 days 00:00:00.025789
383,alibaba/lowcode-engine,2,@alilc/lowcode-code-generator@ v,1,0,0,12,13,0 days 00:00:00.022563
384,baconjs/bacon.js,1,,9,2,2,200,209,0 days 00:00:00.263707
385,mRemoteNG/mRemoteNG,2, v,17,4,7,23,40,0 days 00:00:00.281203
386,doctrine/annotations,2, v,14,0,9,20,34,0 days 00:00:00.455320
387,mbdavid/LiteDB,2,v. v,8,1,3,27,35,0 days 00:00:00.134884
388,sebastianbergmann/exporter,1,,7,0,1,12,19,0 days 00:00:00.024874
389,zo0r/react-native-push-notification,2, v,16,5,2,19,35,0 days 00:00:00.051043
390,zendesk/android-floating-action-button,1,,11,3,0,4,15,0 days 00:00:00.016900
391,kelektiv/node.bcrypt.js,2, v,11,0,8,39,50,0 days 00:00:00.061796
392,flask-restful/flask-restful,2, v,3,0,2,28,31,0 days 00:00:00.062696
393,darktable-org/darktable,4,release-  release post,32,0,18,59,91,0 days 00:00:02.318187
394,houtianze/bypy,1,,5,0,1,69,74,0 days 00:00:00.055996
395,FreeRDP/FreeRDP,1,,9,2,4,8,17,0 days 00:00:00.720721
396,opensearch-project/OpenSearch,1,,5,0,2,6,11,0 days 00:00:03.388153
397,microsoft/playwright-python,1,v,24,9,0,28,52,0 days 00:00:00.107468
398,TechEmpower/FrameworkBenchmarks,3,R round- v,16,1,13,1,17,0 days 00:00:00.734986
399,rs/zerolog,1,v,27,0,3,16,43,0 days 00:00:00.038683
400,vuelidate/vuelidate,3,@vuelidate/components@ test-project@ v,7,1,2,43,50,0 days 00:00:00.116188
401,baldurk/renderdoc,1,v,39,1,12,0,39,0 days 00:00:00.904683
402,linkedin/css-blocks,2, v,17,6,4,22,39,0 days 00:00:00.102757
403,xournalpp/xournalpp,2, v,2,0,1,13,15,0 days 00:00:00.417071
404,sindresorhus/caprine,2, v,70,11,0,43,113,0 days 00:00:00.059489
405,Squirrel/Squirrel.Windows,1,,17,5,6,48,65,0 days 00:00:00.055940
406,appleboy/gorush,2, v,16,6,7,15,31,0 days 00:00:00.194423
407,ValdikSS/GoodbyeDPI,1,,2,0,1,19,21,0 days 00:00:00.031128
408,GrenderG/Toasty,1,,5,0,3,14,19,0 days 00:00:00.029396
409,rancher/os,1,v,15,3,6,43,58,0 days 00:00:00.360220
410,BYVoid/OpenCC,1,ver.,4,0,3,18,22,0 days 00:00:00.057556
411,sebastianbergmann/environment,1,,11,0,1,27,38,0 days 00:00:00.070572
412,kpdecker/jsdiff,1,v,15,2,8,24,39,0 days 00:00:00.023845
413,the-benchmarker/web-frameworks,2, v,3,1,1,13,16,0 days 00:00:00.100652
414,conventional-changelog/standard-version,1,v,24,1,7,13,37,0 days 00:00:00.030286
415,apache/storm,2, v,11,0,9,26,37,0 days 00:00:00.821842
416,ramboxapp/community-edition,1,,7,2,3,36,43,0 days 00:00:00.071457
417,openwall/john,2, JOHN_,3,0,2,2,5,0 days 00:00:00.117017
418,isomorphic-git/isomorphic-git,1,v,96,4,0,238,334,0 days 00:00:00.224822
419,mde/ejs,1,v,0,0,0,45,45,0 days 00:00:00.326725
420,NanoHttpd/nanohttpd,3,nanohttpd-project- Release- v,7,0,3,5,12,0 days 00:00:00.036566
421,conventional-changelog/conventional-changelog,33,conventional-changelog-eslint@ conventional-changelog-v conventional-changelog-core-v gulp-conventional-changelog@ conventional-changelog-jshint@ conventional-changelog@ conventional-changelog-cli@ conventional-changelog-jquery@ conventional-changelog-core@ git-raw-commits@ standard-changelog@ conventional-recommended-bump-v conventional-commits-parser@ conventional-changelog-preset-loader@ git-semver-tags@ conventional-changelog-ember@ conventional-changelog-atom@ conventional-recommended-bump@ conventional-changelog-preset-loader-v conventional-changelog-express@ conventional-changelog-conventionalcommits-v conventional-commits-filter@ conventional-changelog-codemirror@ conventional-changelog-cli-v conventional-changelog-writer@ conventional-changelog-conventionalcommits@ conventional-changelog-angular@ git-raw-commits-v conventional-changelog-writer-v conventional-commits-parser-v v @marionebl/conventional-commits-parser@ conventional-changelog-angular-v,32,1,2,657,689,0 days 00:00:00.683652
422,getsentry/sentry-javascript,4, raven-node@ raven-js@ v,102,51,5,230,332,0 days 00:00:00.498729
423,weaveworks/weave,2,fast-datapath-preview- v,25,8,10,49,74,0 days 00:00:00.384090
424,dylanaraps/pywal,1,,17,8,2,65,82,0 days 00:00:00.078290
425,Radarr/Radarr,2, v,99,43,13,13,112,0 days 00:00:00.649592
426,ElectronNET/Electron.NET,2, v,0,0,0,14,14,0 days 00:00:00.046983
427,vmware-tanzu/velero,1,v,17,2,8,43,60,0 days 00:00:00.177037
428,simeji/jid,2, v,7,1,0,14,21,0 days 00:00:00.017745
429,graphql/express-graphql,1,v,12,0,6,31,43,0 days 00:00:00.049824
430,Uberi/speech_recognition,1,,16,0,5,29,45,0 days 00:00:00.029257
431,miekg/dns,1,v,2,0,1,64,66,0 days 00:00:00.187786
432,automl/auto-sklearn,3, v. v,12,2,6,21,33,0 days 00:00:00.294342
433,PrestaShop/PrestaShop,1,,30,16,4,83,113,0 days 00:00:04.302255
434,bookshelf/bookshelf,2, start-es,17,2,11,68,85,0 days 00:00:00.110036
435,benbjohnson/litestream,1,v,3,2,0,8,11,0 days 00:00:00.024011
436,concourse/concourse,1,v,134,104,4,81,215,0 days 00:00:01.554826
437,feross/simple-peer,1,v,50,9,6,71,121,0 days 00:00:00.090138
438,apache/incubator-shenyu,2, v,2,0,1,8,10,0 days 00:00:00.156802
439,Cyan4973/xxHash,2,r v,12,3,4,11,23,0 days 00:00:00.069734
440,NixOS/nix,1,,37,4,23,53,90,0 days 00:00:00.786924
441,elasticsearch-dump/elasticsearch-dump,2, v,113,12,2,137,250,0 days 00:00:00.165431
442,katspaugh/wavesurfer.js,2, v,26,1,7,105,131,0 days 00:00:00.104388
443,gitextensions/gitextensions,3, master_Net v,111,30,15,30,141,0 days 00:00:00.900076
444,symfony/translation,1,v,26,4,21,462,488,0 days 00:00:00.432473
445,arc298/instagram-scraper,2, v,11,0,0,68,79,0 days 00:00:00.038120
446,dotnetcore/FastGithub,1,,5,3,0,31,36,0 days 00:00:00.045789
447,PHPOffice/PHPWord,1,,12,3,7,8,20,0 days 00:00:00.098578
448,JanDeDobbeleer/oh-my-posh,1,v,350,6,0,383,733,0 days 00:00:00.779862
449,node-formidable/formidable,2, v,12,0,1,33,45,0 days 00:00:00.043862
450,maxogden/menubar,1,v,18,0,1,47,65,0 days 00:00:00.034910
451,eclipse/mosquitto,1,v,4,0,3,55,59,0 days 00:00:00.163247
452,jackocnr/intl-tel-input,2, v,62,17,5,262,324,0 days 00:00:00.228033
453,i18next/i18next,2, v,91,11,5,222,313,0 days 00:00:00.227020
454,doccano/doccano,1,v,8,2,3,19,27,0 days 00:00:00.233135
455,imgproxy/imgproxy,2,actionstest v,26,11,4,55,81,0 days 00:00:00.080214
456,pmndrs/use-gesture,6, V @use-gesture/core@ @use-gesture/react@ @use-gesture/vanilla@ v,9,0,4,111,120,0 days 00:00:00.258312
457,albertlauncher/albert,1,v,17,9,5,64,81,0 days 00:00:00.073310
458,hyperopt/hyperopt,1,,2,0,1,9,11,0 days 00:00:00.063906
459,99designs/aws-vault,1,v,34,6,9,32,66,0 days 00:00:00.073447
460,alteryx/featuretools,2,dev_v v,37,19,2,36,73,0 days 00:00:00.081623
461,dtm-labs/dtm,1,v,21,18,1,35,56,0 days 00:00:00.070966
462,JetBrains/Exposed,1,,8,1,2,78,86,0 days 00:00:00.099712
463,sebastianbergmann/global-state,1,,6,0,5,8,14,0 days 00:00:00.033318
464,AirtestProject/Airtest,1,v,2,0,1,17,19,0 days 00:00:00.042367
465,amoffat/sh,1,,34,9,4,17,51,0 days 00:00:00.188416
466,vanhauser-thc/thc-hydra,2, v,10,0,7,1,11,0 days 00:00:00.045080
467,tensorpack/tensorpack,3, doc-v v,12,5,4,27,39,0 days 00:00:00.517082
468,react-native-video/react-native-video,2, v,24,8,6,49,73,0 days 00:00:00.080174
469,techfort/LokiJS,1,v,3,0,2,33,36,0 days 00:00:00.097700
470,citusdata/citus,1,v,25,0,13,82,107,0 days 00:00:00.421891
471,StackExchange/blackbox,1,v,18,3,8,0,18,0 days 00:00:00.030035
472,yocontra/react-responsive,1,v,8,2,2,28,36,0 days 00:00:00.026877
473,kubernetes/client-go,2,kubernetes- v,38,1,16,330,368,0 days 00:00:00.442495
474,sebastianbergmann/recursion-context,1,,4,0,1,8,12,0 days 00:00:00.020383
475,RichardKnop/machinery,1,v,11,1,3,86,97,0 days 00:00:00.074757
476,sebastianbergmann/version,1,,3,0,0,9,12,0 days 00:00:00.011436
477,s3fs-fuse/s3fs-fuse,2,Pre-v v,18,0,13,1,19,0 days 00:00:00.097921
478,Zizaco/entrust,1,,10,1,4,8,18,0 days 00:00:00.026346
479,google/skia,3,pathkit/ canvaskit/ chrome/m,17,7,1,3,20,0 days 00:00:03.929159
480,medialize/URI.js,2,v. v,20,4,8,54,74,0 days 00:00:00.058441
481,jquery/sizzle,1,,11,0,7,43,54,0 days 00:00:00.065331
482,gitalk/gitalk,1,v,5,0,2,16,21,0 days 00:00:00.020056
483,go-resty/resty,1,v,34,5,10,7,41,0 days 00:00:00.035893
484,yagop/node-telegram-bot-api,1,v,26,5,4,13,39,0 days 00:00:00.043501
485,maxence-charriere/go-app,2, v,37,7,1,69,106,0 days 00:00:00.162534
486,DIYgod/APlayer,2, v,6,2,2,15,21,0 days 00:00:00.024250
487,shentao/vue-multiselect,2, v,5,1,1,20,25,0 days 00:00:00.029262
488,processing/processing,37,processing-0220- processing-0219- processing-0221- processing-0225- processing-0270- processing-0223- processing-0256- processing-0247- processing-0260- processing-0268- processing-0249- processing-0262- processing-0254- processing-0265- processing-0224- processing-0264- release- processing-0251- processing-0250- processing-0226- mobile- processing-0259- processing-0252- processing-0248- processing-0267- processing-0257- processing-0266- processing-0227- processing-0246- processing-0253- processing-0269- processing-0261- processing- processing-0218- processing-0258- processing-0255- processing-0263-,211,105,16,47,258,0 days 00:00:01.483750
489,golang/tools,2,gopls/v v,8,0,4,45,53,0 days 00:00:00.604969
490,jiaaro/pydub,1,v,17,0,9,19,36,0 days 00:00:00.042968
491,bpmn-io/bpmn-js,2, v,75,23,3,155,230,0 days 00:00:00.216359
492,stanfordnlp/stanza,2, v,6,0,5,7,13,0 days 00:00:00.111131
493,gruntwork-io/terratest,1,v,39,5,4,296,335,0 days 00:00:00.260647
494,thephpleague/oauth2-server,1,,25,3,10,72,97,0 days 00:00:00.234688
495,snipe/snipe-it,3, V v,30,12,13,130,160,0 days 00:00:00.792211
496,beanstalkd/beanstalkd,3,r dev v,24,5,9,13,37,0 days 00:00:00.047068
497,baskerville/bspwm,1,,9,4,1,15,24,0 days 00:00:00.067442
498,any86/any-rule,1,v,2,0,0,19,21,0 days 00:00:00.029227
499,dataarts/dat.gui,2, v,6,0,2,18,24,0 days 00:00:00.039618
500,software-mansion/react-native-reanimated,1,,23,5,2,19,42,0 days 00:00:00.088139
501,swaggo/swag,2,v. v,9,0,4,23,32,0 days 00:00:00.046300
502,redux-offline/redux-offline,2, v,7,0,4,9,16,0 days 00:00:00.032932
503,vernesong/OpenClash,1,v,5,0,0,7,12,0 days 00:00:00.028033
504,pocoproject/poco,2,pre-C++ pre-cpp,1,0,0,1,2,0 days 00:00:00.242675
505,Saul-Mirone/milkdown,29,@milkdown/plugin-slash@ @milkdown/theme-tokyo@ @milkdown/plugin-history@ @milkdown/ctx@ @milkdown/preset-commonmark@ @milkdown/vue@ @milkdown/plugin-listener@ @milkdown/plugin-collaborative@ @milkdown/plugin-clipboard@ @milkdown/transformer@ @milkdown/utils@ @milkdown/core@ @milkdown/plugin-upload@ @milkdown/react@ @milkdown/exception@ @milkdown/preset-gfm@ @milkdown/plugin-cursor@ @milkdown/plugin-diagram@ @milkdown/plugin-indent@ @milkdown/plugin-tooltip@ @milkdown/plugin-math@ @milkdown/theme-nord@ @milkdown/prose@ @milkdown/plugin-menu@ @milkdown/plugin-table@ @milkdown/plugin-emoji@ @milkdown/plugin-prism@ @milkdown/theme-pack-helper@ @milkdown/design-system@,20,15,0,1406,1426,0 days 00:00:02.165091
506,simonw/datasette,1,,55,31,6,39,94,0 days 00:00:00.138976
507,securego/gosec,2, v,16,2,8,8,24,0 days 00:00:00.171155
508,Graylog2/graylog2-server,1,,25,0,20,124,149,0 days 00:00:01.297999
509,faker-js/faker,1,v,22,8,7,26,48,0 days 00:00:00.340525
510,ArthurHub/Android-Image-Cropper,1,,9,2,6,23,32,0 days 00:00:00.033344
511,garris/BackstopJS,2, v,25,5,5,106,131,0 days 00:00:00.102658
512,fruitcake/laravel-cors,2,V v,16,0,4,33,49,0 days 00:00:00.031918
513,PaddlePaddle/Paddle-Lite,3, release/ v,15,4,7,6,21,0 days 00:00:00.430019
514,chrismaltby/gb-studio,2, v,6,3,2,6,12,0 days 00:00:00.185008
515,apache/jmeter,2,rel/v v,24,0,17,15,39,0 days 00:00:01.164513
516,electerious/Lychee,2, v,11,1,4,31,42,0 days 00:00:00.082058
517,centrifugal/centrifugo,1,v,24,5,8,57,81,0 days 00:00:00.080540
518,marshmallow-code/marshmallow,1,,48,14,9,77,125,0 days 00:00:00.282134
519,dylang/npm-check,2, v,12,1,0,33,45,0 days 00:00:00.025510
520,react-native-svg/react-native-svg,2, v,45,13,6,164,209,0 days 00:00:00.259533
521,belluzj/fantasque-sans,2, v,5,0,2,10,15,0 days 00:00:00.021135
522,sebastianbergmann/object-enumerator,1,,4,0,1,9,13,0 days 00:00:00.019172
523,sourcegraph/sourcegraph,2,customer-replica-v v,50,44,1,145,195,0 days 00:00:02.781576
524,lightningnetwork/lnd,9,kvdb/v cert/v tlv/v queue/v v healthcheck/v clock/v ticker/v tor/v,5,0,2,37,42,0 days 00:00:00.874573
525,QuantConnect/Lean,2, v,1917,18,4,10,1927,0 days 00:00:04.862936
526,pahen/madge,2, v,30,4,5,29,59,0 days 00:00:00.038573
527,sandstorm-io/sandstorm,1,v,293,152,0,0,293,0 days 00:00:00.731270
528,cupy/cupy,1,v,56,47,1,6,62,0 days 00:00:01.432487
529,GoAdminGroup/go-admin,2, v,9,2,0,76,85,0 days 00:00:00.106324
530,uber/cadence,1,v,22,10,6,55,77,0 days 00:00:00.329076
531,qemu/qemu,2,release_ v,48,2,42,86,134,0 days 00:00:05.838296
532,facebookresearch/pytorch3d,1,v,6,0,4,4,10,0 days 00:00:00.050796
533,xonsh/xonsh,1,,12,1,10,100,112,0 days 00:00:00.505606
534,nodejs/http-parser,1,v,14,0,10,12,26,0 days 00:00:00.203342
535,os-js/OS.js,4, alpha- alpha v,85,72,2,28,113,0 days 00:00:00.263046
536,jspreadsheet/ce,2, v,7,0,5,17,24,0 days 00:00:00.039862
537,jenssegers/laravel-mongodb,2, v,19,3,7,91,110,0 days 00:00:00.097453
538,edenhill/librdkafka,7, ar_test_ confluent-debian-v test-monic-incl test-tag-arm v confluent-debian-,18,0,11,35,53,0 days 00:00:00.215276
539,gsoft-inc/craco,1,v,32,6,1,27,59,0 days 00:00:00.040572
540,testcontainers/testcontainers-java,4, testcontainers- tes-containers- test-containers-,19,2,12,63,82,0 days 00:00:00.226768
541,tindy2013/subconverter,1,v,7,3,2,28,35,0 days 00:00:00.045646
542,aws/aws-sam-cli,1,v,96,44,0,36,132,0 days 00:00:00.145374
543,keystonejs/keystone,195,@arch-ui/input@ @arch-ui/color-utils@ @keystone-next/utils@ @voussoir/logger@ @arch-ui/modal-utils@ @keystone-ui/options@ @keystone-alpha/auth-passport@ @keystone-alpha/fields@ @keystone-alpha/auth-password@ @keystonejs/fields-auto-increment@ @keystone-alpha/file-adapters@ @keystone-alpha/fields-wysiwyg-tinymce@ @keystone-next/admin-ui-utils@ @arch-ui/pill@ @voussoir/mongo-join-builder@ @keystonejs/fields-location-google@ @keystonejs/app-static@ @keystone-next/email-legacy@ @keystone-alpha/test-utils@ @keystone-alpha/fields-datetime-utc@ @keystone-alpha/list-plugins@ @voussoir/test-utils@ @keystone-ui/icons@ @keystone-next/testing@ @voussoir/utils@ @keystonejs/apollo-helpers@ @keystone-next/fields-datetime-utc-legacy@ @arch-ui/dialog@ @keystone-next/fields-document@ @arch-ui/options@ @keystone-next/adapter-prisma-legacy@ @keystone-alpha/core@ @keystonejs/keystone@ @keystone-alpha/app-static@ @keystone-next/keystone-legacy@ @keystone-next/fields-wysiwyg-tinymce-legacy@ @arch-ui/dropdown@ @keystone-ui/notice@ @keystone-next/admin-ui@ @voussoir/admin-ui@ @keystone-alpha/app-next@ @arch-ui/drawer@ @keystone-ui/button@ @keystone-next/auth@ @keystone-next/utils-legacy@ @keystone-ui/tooltip@ @voussoir/apollo-helpers@ @keystone-next/session-store-redis@ @keystone-next/keystone@ @keystonejs/app-version@ @keystone-alpha/build-field-types@ @keystone-6/document-renderer@ @keystonejs/auth-password@ @keystonejs/server-side-graphql-client@ @keystone-next/fields-unsplash-legacy@ @keystonejs/list-plugins@ @keystone-ui/fields@ @keystonejs/field-content@ @keystone-next/field-views-loader-legacy@ @keystone-ui/modals@ @keystone-next/fields-cloudinary-image-legacy@ @keystone-next/fields-oembed-legacy@ @keystone-next/app-admin-ui-legacy@ @keystonejs/fields-mongoid@ @arch-ui/button@ @arch-ui/card@ @voussoir/adapter-knex@ @keystonejs/fields-oembed@ create-keystone-app@ @keystone-ui/core@ @keystone-alpha/server@ @keystonejs/session@ @keystone-next/adapter-knex-legacy@ @keystone-next/app-nuxt-legacy@ @keystone-next/session-legacy@ @arch-ui/pagination@ @keystone-next/app-graphql-legacy@ @voussoir/icons@ @keystone-alpha/field-content@ @keystonejs/app-graphql@ @arch-ui/alert@ @arch-ui/tooltip@ @voussoir/adapter-mongoose@ @arch-ui/popout@ @keystone-next/fields-color-legacy@ @keystone-next/fields-mongoid-legacy@ @keystone-alpha/adapter-knex@ @keystone-alpha/oembed-adapters@ @arch-ui/theme@ @arch-ui/controls@ @keystonejs/app-admin-ui@ @arch-ui/day-picker@ @keystonejs/fields-color@ @voussoir/server@ @keystone-alpha/fields-auto-increment@ @keystone-alpha/app-admin-ui@ @keystone-next/cloudinary@ @keystone-ui/toast@ @keystone-next/app-static-legacy@ @keystone-next/document-renderer@ @arch-ui/icons@ @keystone-alpha/app-graphql@ @keystone-ui/loading@ @keystonejs/fields-wysiwyg-tinymce@ @keystone-next/fields@ @keystone-alpha/logger@ @keystone-alpha/email@ @keystonejs/file-adapters@ @arch-ui/loading@ @keystonejs/mongo-join-builder@ @keystone-6/cloudinary@ @arch-ui/layout@ @keystone-next/fields-markdown-legacy@ @keystone-6/auth@ @keystonejs/fields-content@ @keystonejs/email@ @keystone-alpha/fields-mongoid@ @keystone-next/server-side-graphql-client-legacy@ @keystone-6/session-store-redis@ @arch-ui/fields@ @keystone-alpha/keystone@ @keystone-next/app-version-legacy@ @keystone-alpha/apollo-helpers@ @arch-ui/navbar@ @voussoir/ui@ @keystone-6/fields-document@ @keystone-next/apollo-helpers-legacy@ @keystone-alpha/access-control@ @keystone-ui/popover@ @keystone-alpha/admin-ui@ @keystone-alpha/session@ @keystone-next/app-graphql-playground-legacy@ @keystonejs/app-next@ @keystone-next/adapter-mongoose-legacy@ @arch-ui/select@ @keystonejs/fields-unsplash@ @voussoir/field-views-loader@ @keystonejs/fields-datetime-utc@ @arch-ui/confirm@ @keystonejs/auth-passport@ @keystone-next/fields-location-google-legacy@ @keystonejs/app-schema-router@ @keystonejs/app-graphql-playground@ @arch-ui/lozenge@ @keystone-next/fields-content-legacy@ @arch-ui/badge@ @keystonejs/fields@ @keystone-alpha/app-graphql-playground@ @keystonejs/build-field-types@ @keystone-next/fields-legacy@ @keystone-alpha/adapter-mongoose@ @keystone-next/app-schema-router-legacy@ @voussoir/core@ @keystone-next/fields-auto-increment-legacy@ @keystone-alpha/fields-markdown@ @keystone-ui/pill@ @keystone-next/file-adapters-legacy@ @keystone-alpha/utils@ @keystone-next/app-next-legacy@ @keystone-alpha/field-views-loader@ @keystonejs/adapter-knex@ @voussoir/file-adapters@ @arch-ui/filters@ @keystonejs/app-nuxt@ @arch-ui/common@ @voussoir/keystone@ @keystone-next/fields-authed-relationship-legacy@ @voussoir/email@ @voussoir/access-control@ @keystone-next/auth-passport-legacy@ @keystonejs/fields-authed-relationship@ @keystonejs/utils@ @keystonejs/oembed-adapters@ @keystonejs/adapter-mongoose@ @keystone-next/access-control-legacy@ @keystonejs/logger@ @keystonejs/fields-cloudinary-image@ @keystone-next/list-plugins-legacy@ @keystonejs/access-control@ @arch-ui/hooks@ @keystone-alpha/mongo-join-builder@ @keystone-next/auth-password-legacy@ @keystonejs/test-utils@ @keystonejs/fields-markdown@ @keystonejs/adapter-prisma@ @arch-ui/typography@ @voussoir/fields@ @keystone-alpha/passport-auth@ @keystone-ui/segmented-control@ v @keystone-alpha/app-schema-router@ @keystone-6/core@ @keystonejs/field-views-loader@ @keystone-next/test-utils-legacy@ @keystone-next/types@,118,0,3,2534,2652,0 days 00:00:09.233489
544,real-logic/aeron,3, publish-test- v,42,16,8,62,104,0 days 00:00:00.826150
545,chancejs/chancejs,2, v,9,1,4,47,56,0 days 00:00:00.061601
546,mcollina/autocannon,1,v,52,6,5,43,95,0 days 00:00:00.058028
547,crater-invoice/crater,1,,11,4,4,19,30,0 days 00:00:00.069688
548,thedevs-network/kutt,1,v,10,2,1,51,61,0 days 00:00:00.045780
549,zephyrproject-rtos/zephyr,2,zephyr-v v,24,4,18,46,70,0 days 00:00:03.507257
550,filhodanuvem/gitql,2, v,10,0,4,8,18,0 days 00:00:00.022751
551,supertokens/supertokens-core,1,v,22,11,1,17,39,0 days 00:00:00.043103
552,flot/flot,2, v,16,4,6,35,51,0 days 00:00:00.066248
553,SocketCluster/socketcluster,3, v. v,17,3,3,26,43,0 days 00:00:00.067712
554,hashicorp/raft,1,v,5,1,3,15,20,0 days 00:00:00.057806
555,Kenshin/simpread,2, firefox-,2,0,1,14,16,0 days 00:00:00.220167
556,google/error-prone,1,v,15,2,5,34,49,0 days 00:00:00.609167
557,facebookresearch/hydra,1,v,3,0,2,10,13,0 days 00:00:00.244381
558,wojtekmaj/react-pdf,1,v,27,8,6,36,63,0 days 00:00:00.071411
559,IntelRealSense/librealsense,4, AutoExposure_Fix_ ros v,55,27,6,75,130,0 days 00:00:00.796133
560,reactiveui/refit,2, v,13,2,6,39,52,0 days 00:00:00.125121
561,apache/tomcat,1,,4,0,3,272,276,0 days 00:00:03.730849
562,onsi/ginkgo,1,v,19,1,6,21,40,0 days 00:00:00.055087
563,karatelabs/karate,1,v,11,1,6,27,38,0 days 00:00:00.195733
564,ProseMirror/prosemirror,1,,9,8,0,8,17,0 days 00:00:00.077850
565,burnash/gspread,2, v,19,7,7,21,40,0 days 00:00:00.063809
566,plantuml/plantuml,1,v,9,0,1,78,87,0 days 00:00:00.070960
567,owncast/owncast,1,v,0,0,0,11,11,0 days 00:00:00.355155
568,fabiospampinato/cash,1,,16,4,4,36,52,0 days 00:00:00.051504
569,OrchardCMS/OrchardCore,1,v,4,0,1,6,10,0 days 00:00:00.558099
570,jazzband/pip-tools,1,,45,15,10,49,94,0 days 00:00:00.112625
571,conan-io/conan,1,,76,65,0,162,238,0 days 00:00:00.496766
572,sindresorhus/query-string,2, v,34,0,0,38,72,0 days 00:00:00.031946
573,platformio/platformio-core,3, v. v,43,22,13,72,115,0 days 00:00:00.294769
574,npm/cli,27, libnpmdiff@ libnpmteam-v libnpmfund-v libnpmversion@ libnpmorg@ libnpmexec@ libnpmpublish@ @npmcli/arborist@ libnpmsearch@ libnpmaccess-v libnpmhook@ libnpmsearch-v libnpmpack@ libnpmteam@ arborist-v libnpmorg-v @npmcli/arborist-v libnpmaccess@ libnpmdiff-v libnpmhook-v libnpmfund@ libnpmexec-v v libnpmpublish-v libnpmpack-v libnpmversion-v,103,63,13,606,709,0 days 00:00:01.424181
575,OJ/gobuster,1,v,11,0,6,4,15,0 days 00:00:00.029361
576,google/sentencepiece,2, v,1,0,0,19,20,0 days 00:00:00.048787
577,blueedgetechno/win11React,2, win11inreact-v,2,0,1,17,19,0 days 00:00:00.183211
578,bytedeco/javacv,1,,17,0,12,14,31,0 days 00:00:00.035181
579,mozilla-mobile/fenix,2,fennec/nightly/ v,60,36,3,59,119,0 days 00:00:00.697983
580,perkeep/perkeep,1,,11,4,5,0,11,0 days 00:00:00.332645
581,spulec/moto,2, v,14,0,6,152,166,0 days 00:00:00.571364
582,ractivejs/ractive,1,v,10,0,2,88,98,0 days 00:00:00.254833
583,angr/angr,1,v,1,0,0,73,74,0 days 00:00:00.644299
584,trpc/trpc,2, v,57,28,1,48,105,0 days 00:00:00.146356
585,google/j2objc,1,,14,0,11,25,39,0 days 00:00:00.252380
586,heroiclabs/nakama,1,v,38,11,5,29,67,0 days 00:00:00.068397
587,ckeditor/ckeditor5,2, v,48,30,3,6,54,0 days 00:00:02.649805
588,rest-assured/rest-assured,1,rest-assured-,32,6,15,40,72,0 days 00:00:00.107384
589,tensorflow/tensorboard,2, data-server-v,27,8,11,18,45,0 days 00:00:00.313157
590,HypothesisWorks/hypothesis,7, hypothesis-ruby- conjecture-rust- v test-tag conjecture- hypothesis-python-,270,103,3,1002,1272,0 days 00:00:02.367394
591,gruntwork-io/terragrunt,1,v,37,7,5,337,374,0 days 00:00:00.287321
592,ariakit/ariakit,12,reakit-system-palette@ reakit-playground@ reakit-system@ website@ reakit@ reakit-utils@ reakit-system-bootstrap@ reakit-test-utils@ reakit-codemods@ v reakit-warning@ reakit-theme-default@,24,1,0,352,376,0 days 00:00:00.303600
593,ianstormtaylor/superstruct,1,v,14,2,1,55,69,0 days 00:00:00.055707
594,AlaSQL/alasql,2, v,6,0,4,58,64,0 days 00:00:00.095846
595,ACRA/acra,3, acra- Acra-,19,0,12,31,50,0 days 00:00:00.130575
596,alibaba/BizCharts,7, bizcharts-plugin/slider/ publish- slider/ v publish/ bizcharts/,7,1,2,55,62,0 days 00:00:00.100763
597,File-New-Project/EarTrumpet,1,,9,1,5,29,38,0 days 00:00:00.058387
598,theatre-js/theatre,1,,4,0,2,33,37,0 days 00:00:00.262111
599,RobinHerbots/Inputmask,1,,12,0,10,88,100,0 days 00:00:00.218650
600,remoteinterview/zero,1,v,1,0,0,36,37,0 days 00:00:00.055403
601,webslides/WebSlides,1,,7,2,1,7,14,0 days 00:00:00.050639
602,leiurayer/downkyi,1,v,2,0,1,8,10,0 days 00:00:00.040211
603,scikit-learn-contrib/imbalanced-learn,1,,8,0,7,21,29,0 days 00:00:00.273930
604,sparklemotion/nokogiri,2,REL_ v,15,1,10,89,104,0 days 00:00:00.429826
605,b-ryan/powerline-shell,1,v,0,0,0,12,12,0 days 00:00:00.064645
606,DouyinFE/semi-design,1,v,12,10,0,25,37,0 days 00:00:00.198225
607,ethereum-mining/ethminer,1,v,10,1,5,3,13,0 days 00:00:00.850140
608,pyroscope-io/pyroscope,6,@pyroscope/flamegraph@ @pyroscope/panel-plugin@ @pyroscope/models@ @pyroscope/datasource-plugin@ v @pyroscope/webapp@,25,9,0,146,171,0 days 00:00:00.141608
609,moroshko/react-autosuggest,1,v,41,3,3,54,95,0 days 00:00:00.046658
610,Unleash/unleash,2, v,34,15,5,132,166,0 days 00:00:00.212895
611,byt3bl33d3r/CrackMapExec,2, v,7,3,0,14,21,0 days 00:00:00.074689
612,mgcrea/angular-strap,1,v,6,0,4,46,52,0 days 00:00:00.091281
613,kulshekhar/ts-jest,2, v,30,13,6,88,118,0 days 00:00:00.177768
614,LMMS/lmms,1,v,6,0,5,47,53,0 days 00:00:00.543301
615,guardicore/monkey,3, zero-trust-demo- v,11,0,8,6,17,0 days 00:00:00.364637
616,geerlingguy/ansible-for-devops,1,,32,0,6,1,33,0 days 00:00:00.038784
617,angular/flex-layout,0,,0,0,0,0,0,0 days 00:00:00.030068
618,Shougo/deoplete.nvim,1,,14,1,11,0,14,0 days 00:00:00.216183
619,humhub/humhub,2,v. v,17,0,14,67,84,0 days 00:00:00.716767
620,twitchtv/twirp,1,v,18,8,6,10,28,0 days 00:00:00.040645
621,postmanlabs/newman,3, v. v,26,8,6,80,106,0 days 00:00:00.260573
622,neuecc/UniRx,1,,18,8,4,7,25,0 days 00:00:00.057975
623,pentaho/pentaho-kettle,1,,31,3,11,37,68,0 days 00:00:00.786542
624,airbnb/hypernova,1,v,9,0,4,8,17,0 days 00:00:00.017663
625,phpmyadmin/phpmyadmin,2, RELEASE_,37,1,21,300,337,0 days 00:00:06.672493
626,mahmoud/boltons,1,,24,8,8,21,45,0 days 00:00:00.081504
627,yuliskov/SmartTubeNext,1,,73,44,1,0,73,0 days 00:00:00.381477
628,davidjbradshaw/iframe-resizer,2, v,26,9,4,96,122,0 days 00:00:00.101319
629,dataease/dataease,1,v,11,9,0,12,23,0 days 00:00:00.452421
630,Airblader/i3,3, tree-pr AnyEvent-,41,1,19,22,63,0 days 00:00:00.514387
631,diasurgical/devilutionX,4, broken works v,19,6,7,15,34,0 days 00:00:00.422923
632,dragonflyoss/Dragonfly,1,v,5,0,3,13,18,0 days 00:00:00.103428
633,gonum/gonum,1,v,5,0,4,7,12,0 days 00:00:00.299015
634,imbushuo/mac-precision-touchpad,1,univ-b,1,0,0,0,1,0 days 00:00:00.015154
635,vmware-tanzu/octant,1,v,25,15,3,15,40,0 days 00:00:00.203050
636,armosec/kubescape,2,betav v,0,0,0,117,117,0 days 00:00:00.103881
637,mitchellh/mapstructure,1,v,6,2,3,11,17,0 days 00:00:00.026094
638,django-extensions/django-extensions,1,,21,0,18,104,125,0 days 00:00:00.202664
639,valinet/ExplorerPatcher,1,,19,1,0,10,29,0 days 00:00:00.044482
640,weibocom/motan,1,,5,1,2,17,22,0 days 00:00:00.161393
641,mamedev/mame,1,mame,124,88,11,0,124,0 days 00:00:04.488892
642,dotnet/wpf,1,v,0,0,0,47,47,0 days 00:00:00.379686
643,gevent/gevent,2, v,19,4,12,35,54,0 days 00:00:00.292830
644,TypeStrong/typedoc,2, v,22,1,11,127,149,0 days 00:00:00.108712
645,react-native-device-info/react-native-device-info,1,v,57,8,2,114,171,0 days 00:00:00.123697
646,ben-rogerson/twin.macro,1,,22,12,0,32,54,0 days 00:00:00.365063
647,gorse-io/gorse,1,v,3,0,2,15,18,0 days 00:00:00.545594
648,travist/jsencrypt,2, v,7,1,3,3,10,0 days 00:00:00.015136
649,joelittlejohn/jsonschema2pojo,2,jsonschema2pojo- jsonschema2pojo-jdk-annotation-,6,0,4,54,60,0 days 00:00:00.102890
650,Financial-Times/polyfill-service,2, v,87,36,5,87,174,0 days 00:00:00.218499
651,Jrohy/multi-v2ray,1,v,18,5,0,79,97,0 days 00:00:00.128974
652,voidcosmos/npkill,1,v,8,5,2,19,27,0 days 00:00:00.028354
653,deepmipt/DeepPavlov,1,,17,4,3,28,45,0 days 00:00:00.133792
654,betaflight/betaflight,7, CLFL_v flight-ready- INAV- v v. flight-tested-,34,13,12,98,132,0 days 00:00:01.305571
655,HMBSbige/ShadowsocksR-Windows,1,,28,4,10,127,155,0 days 00:00:00.136659
656,mattn/go-sqlite3,1,v,16,2,6,19,35,0 days 00:00:00.062013
657,vuejs/vue-class-component,1,v,10,1,4,15,25,0 days 00:00:00.023984
658,python-visualization/folium,1,v,11,1,7,10,21,0 days 00:00:00.174609
659,mikefarah/yq,4, releaseTest-manpage draft- v,45,12,4,79,124,0 days 00:00:00.102777
660,plasma-umass/scalene,2, v,3,0,1,22,25,0 days 00:00:00.239597
661,taigaio/taiga-back,1,,24,7,8,74,98,0 days 00:00:00.230002
662,brython-dev/brython,1,,12,1,9,46,58,0 days 00:00:00.498433
663,redux-observable/redux-observable,2, v,23,9,5,8,31,0 days 00:00:00.050698
664,gcc-mirror/gcc,12,releases/libgcj- releases/gcc- prereleases/gcc- releases/g77- misc/first-auto-changelog- misc/gccgo-go prereleases/libgcj- releases/libf2c- releases/egcs- misc/cutover-egcs- basepoints/gcc- prereleases/libstdc++-,63,0,51,90,153,0 days 00:00:15.212447
665,assimp/assimp,2, v,8,0,6,15,23,0 days 00:00:00.592498
666,kelseyhightower/confd,1,v,15,3,8,7,22,0 days 00:00:00.046456
667,jsx-eslint/eslint-plugin-react,1,v,81,38,6,88,169,0 days 00:00:00.492264
668,vercel/serve,2, v,49,4,1,96,145,0 days 00:00:00.071611
669,spesmilo/electrum,3, password_v seed_v,34,11,16,105,139,0 days 00:00:00.805067
670,shirou/gopsutil,2, v,3,0,1,67,70,0 days 00:00:00.123966
671,edgedb/edgedb,1,v,5,4,0,0,5,0 days 00:00:00.358372
672,carla-simulator/carla,1,,9,4,3,38,47,0 days 00:00:00.260256
673,gcanti/fp-ts,1,,38,19,7,115,153,0 days 00:00:00.191735
674,hoffstadt/DearPyGui,1,v,8,4,1,10,18,0 days 00:00:00.237476
675,oguzhaninan/Stacer,1,v,2,0,1,9,11,0 days 00:00:00.033141
676,UKPLab/sentence-transformers,1,v,10,3,5,20,30,0 days 00:00:00.064992
677,zeromq/libzmq,1,v,2,0,1,9,11,0 days 00:00:00.451071
678,mozilla/nunjucks,3, v. v,14,1,7,37,51,0 days 00:00:00.164248
679,hybridgroup/gobot,3, v. v,29,10,11,16,45,0 days 00:00:00.134892
680,adnanh/webhook,1,,9,1,2,21,30,0 days 00:00:00.034162
681,Yelp/elastalert,1,v,2,0,1,123,125,0 days 00:00:00.122779
682,react-icons/react-icons,3, example v,17,3,6,12,29,0 days 00:00:00.037547
683,typestack/class-validator,2, v,6,0,4,13,19,0 days 00:00:00.042200
684,SFML/SFML,1,,6,0,5,5,11,0 days 00:00:00.096416
685,cortexlabs/cortex,1,v,42,36,1,20,62,0 days 00:00:00.153589
686,metalsmith/metalsmith,2, v,24,4,2,60,84,0 days 00:00:00.042954
687,remix-run/history,1,v,38,10,4,40,78,0 days 00:00:00.072759
688,miguelgrinberg/flasky,0,,0,0,0,0,0,0 days 00:00:00.013466
689,ffmpegwasm/ffmpeg.wasm,1,v,10,2,1,18,28,0 days 00:00:00.022253
690,BeyondDimension/SteamTools,1,,10,5,3,28,38,0 days 00:00:00.132429
691,sindresorhus/type-fest,1,v,40,0,0,34,74,0 days 00:00:00.036207
692,alibaba/formily,1,v,9,1,3,85,94,0 days 00:00:00.172083
693,vercel/turborepo,1,v,3,0,0,54,57,0 days 00:00:00.092016
694,colinhacks/zod,2, v,20,10,2,23,43,0 days 00:00:00.082339
695,rebassjs/rebass,1,v,11,2,4,42,53,0 days 00:00:00.125502
696,beautify-web/js-beautify,1,v,13,3,7,74,87,0 days 00:00:00.265578
697,probot/probot,2, v,71,17,0,124,195,0 days 00:00:00.164144
698,top-think/think,2, v,3,0,2,65,68,0 days 00:00:00.116112
699,prompt-toolkit/python-prompt-toolkit,1,,5,0,1,51,56,0 days 00:00:00.275352
700,mvt-project/mvt,1,v,4,2,0,36,40,0 days 00:00:00.054185
701,uber/baseweb,1,v,210,75,0,161,371,0 days 00:00:00.324167
702,antvis/F2,8, @antv/f2-site@ @antv/f2-graphic@ @antv/f2-react@ @antv/f2-wx@ @antv/f2@ @antv/f2-my@ @antv/f2-vue@,7,0,5,167,174,0 days 00:00:00.152829
703,mrdoob/stats.js,1,r,16,3,1,0,16,0 days 00:00:00.013270
704,yjs/yjs,1,v,19,2,4,151,170,0 days 00:00:00.189367
705,jonobr1/two.js,1,v,7,0,6,20,27,0 days 00:00:00.136845
706,qgis/QGIS,6,final- version_ version Release- ltr- archive/master_,34,0,27,168,202,0 days 00:00:05.507568
707,nodegui/nodegui,1,v,48,17,0,45,93,0 days 00:00:00.086451
708,tailscale/tailscale,1,v,19,6,2,54,73,0 days 00:00:01.110396
709,Maximus5/ConEmu,7,common- i Issue v dbg-test clink old-i,15,3,2,320,335,0 days 00:00:00.657719
710,OwlCarousel2/OwlCarousel2,1,,2,0,1,11,13,0 days 00:00:00.035733
711,sindresorhus/ora,1,v,24,0,2,13,37,0 days 00:00:00.020482
712,zhukov/webogram,1,v,3,0,0,11,14,0 days 00:00:00.425634
713,dotnet/BenchmarkDotNet,1,v,7,0,5,40,47,0 days 00:00:00.105552
714,paramiko/paramiko,3, release- v,23,3,13,152,175,0 days 00:00:00.234904
715,chromedp/chromedp,1,v,8,1,2,33,41,0 days 00:00:00.044876
716,node-fetch/node-fetch,3, fix-chunked-transfer-premature-close- v,15,1,5,25,40,0 days 00:00:00.043651
717,theonedev/onedev,2, v,26,13,2,131,157,0 days 00:00:00.212149
718,freebsd/freebsd-src,1,release/,62,3,58,16,78,0 days 00:00:19.804225
719,go-swagger/go-swagger,2, v,29,8,11,26,55,0 days 00:00:00.143749
720,symfony/http-kernel,1,v,26,4,21,489,515,0 days 00:00:00.598963
721,yiminghe/async-validator,2, v,18,0,5,59,77,0 days 00:00:00.031602
722,signalapp/Signal-Server,1,v,215,20,2,18,233,0 days 00:00:00.304585
723,kubernetes/kompose,1,v,34,17,5,3,37,0 days 00:00:00.086827
724,Tencent/xLua,1,v,0,0,0,12,12,0 days 00:00:00.053444
725,swagger-api/swagger-editor,3, v/ v,27,2,8,364,391,0 days 00:00:00.349027
726,sindresorhus/ky,1,v,29,3,0,18,47,0 days 00:00:00.026228
727,bottlepy/bottle,1,,3,0,2,72,75,0 days 00:00:00.535526
728,wix/react-native-calendars,2, v,1248,25,1,59,1307,0 days 00:00:02.065767
729,owncloud/core,1,v,23,0,21,147,170,0 days 00:00:03.462422
730,99designs/gqlgen,2, v,16,7,6,35,51,0 days 00:00:00.132007
731,developit/htm,3, babel-plugin-transform-jsx-to-htm-v v,8,2,3,14,22,0 days 00:00:00.031906
732,developit/mitt,2, v,6,1,2,5,11,0 days 00:00:00.016746
733,react-native-image-picker/react-native-image-picker,2, v,37,2,3,86,123,0 days 00:00:00.069457
734,secdev/scapy,1,v,80,8,8,432,512,0 days 00:00:00.550136
735,react-grid-layout/react-draggable,1,v,24,1,7,57,81,0 days 00:00:00.051177
736,microsoft/wslg,1,v,1,0,0,30,31,0 days 00:00:00.033821
737,metersphere/metersphere,1,v,20,17,0,61,81,0 days 00:00:00.791703
738,konvajs/konva,1,,41,11,7,131,172,0 days 00:00:00.208559
739,hilongjw/vue-lazyload,2, v,2,0,1,14,16,0 days 00:00:00.022373
740,chaijs/chai,2, v,30,8,9,48,78,0 days 00:00:00.098918
741,akveo/nebular,1,v,23,6,4,23,46,0 days 00:00:00.105948
742,laravel/lumen,1,v,14,0,8,10,24,0 days 00:00:00.028294
743,codenotary/immudb,2,cnlc- v,9,1,5,12,21,0 days 00:00:00.153763
744,dropwizard/metrics,1,v,10,1,8,77,87,0 days 00:00:00.309010
745,trustedsec/social-engineer-toolkit,1,,17,3,8,87,104,0 days 00:00:00.753850
746,retejs/rete,2, v,12,3,2,35,47,0 days 00:00:00.037048
747,apache/shardingsphere-elasticjob,1,,4,0,3,20,24,0 days 00:00:00.120841
748,nteract/nteract,72,@nteract/editor@ @nteract/notebook-app-component@ @nteract/transforms-full@ @nteract/kernel-relay@ @nteract/logos@ @nteract/styles@ @nteract/nbextension@ @nteract/commutable@ @nteract/transform-geojson@ @nteract/transform-vega@ @nteract/data-explorer@ @nteract/mathjax@ @nteract/connected-components@ @nteract/directory-listing@ @nteract/notebook-preview-demo@ @nteract/webpack-configurator@ nteract-on-jupyter@ @nteract/records@ @nteract/reducers@ @nteract/fs-kernels@ @mybinder/host-cache@ @nteract/monaco-editor@ @nteract/types@ @nteract/notebook-render@ @nteract/transform-vdom@ @nteract/mockument@ @nteract/commutable-v fs-observable@ @nteract/dev-scripts@ @nteract/epics@ enchannel@ @nteract/notebook-preview@ @nteract/markdown@ @nteract/commuter@ @nteract/commuter-frontend@ @nteract/dropdown-menu@ @nteract/notebook-on-next@ @nteract/selectors@ ansi-to-react@ @nteract/actions@ @nteract/core@ @nteract/mythic-configuration@ rx-binder@ @nteract/presentational-components@ @nteract/display-area@ @nteract/messaging@ @nteract/myths@ @nteract/styled-blueprintjsx@ @nteract/iron-icons@ @nteract/outputs@ @nteract/timeago@ @nteract/transform-model-debug@ @nteract/mythic-windowing@ @nteract/mythic-multiselect@ @nteract/transform-plotly@ @nteract/fixtures@ @nteract/mythic-notifications@ @nteract/stateful-components@ rx-jupyter@ @nteract/transforms@ @nteract/vega-embed2@ enchannel-zmq-backend@ @nteract/showcase@ @nteract/web@ @nteract/jupyter-widgets@ nteract@ @nteract/gatsby-transformer-ipynb@ v @nteract/transform-dataresource@ @nteract/octicons@ @nteract/play@ @nteract/styleguide-components@,121,7,3,2353,2474,0 days 00:00:08.150084
749,go-vgo/robotgo,2, v,21,3,7,24,45,0 days 00:00:00.070220
750,NginxProxyManager/nginx-proxy-manager,2, v,10,3,2,48,58,0 days 00:00:00.062330
751,streamlink/streamlink,1,,30,9,7,17,47,0 days 00:00:00.222814
752,HangfireIO/Hangfire,2,v. v,13,4,4,92,105,0 days 00:00:00.172163
753,isaacs/node-glob,2, v,18,0,1,102,120,0 days 00:00:00.170219
754,audacity/audacity,2,Audacity- split-,7,0,6,28,35,0 days 00:00:00.599345
755,google/tsunami-security-scanner,2, v,0,0,0,11,11,0 days 00:00:00.014786
756,tldraw/tldraw,3,@tldraw/tldraw@ @tldraw/core@ v,8,3,0,172,180,0 days 00:00:00.131186
757,aws/aws-sdk-go,4, vrelease-v v. v,48,5,2,1288,1336,0 days 00:00:02.190316
758,opencv/opencv_contrib,1,,11,0,10,26,37,0 days 00:00:00.198810
759,visionmedia/page.js,2, v,10,1,2,29,39,0 days 00:00:00.042656
760,xupefei/Locale-Emulator,2, v,13,0,3,14,27,0 days 00:00:00.027552
761,twigphp/Twig,1,v,66,29,20,139,205,0 days 00:00:00.511826
762,wappalyzer/wappalyzer,4, firefox- Firefox- v,13,1,7,100,113,0 days 00:00:00.460643
763,webdriverio/webdriverio,1,v,91,45,11,415,506,0 days 00:00:01.174292
764,facebook/proxygen,1,v,14,8,0,270,284,0 days 00:00:00.821308
765,prometheus/node_exporter,2, v,17,0,12,11,28,0 days 00:00:00.098376
766,numba/numba,2, v,54,9,8,51,105,0 days 00:00:01.276042
767,vesoft-inc/nebula,1,v,7,0,4,6,13,0 days 00:00:00.198957
768,vuejs/pinia,5, pinia@ @pinia/testing@ @pinia/nuxt@ v,6,3,2,62,68,0 days 00:00:00.096869
769,GoogleCloudPlatform/terraformer,1,,2,0,1,29,31,0 days 00:00:00.095967
770,DaveGamble/cJSON,1,v,9,5,1,36,45,0 days 00:00:00.062780
771,guzzle/psr7,1,,12,1,9,17,29,0 days 00:00:00.043370
772,ionic-team/capacitor,2, v,18,6,1,138,156,0 days 00:00:00.271167
773,metricsgraphics/metrics-graphics,3,V v. v,25,12,4,10,35,0 days 00:00:00.081948
774,doctrine/cache,2, v,17,2,7,27,44,0 days 00:00:00.056562
775,FormidableLabs/radium,1,v,17,3,1,46,63,0 days 00:00:00.072658
776,symfony/polyfill-mbstring,1,v,25,0,0,9,34,0 days 00:00:00.017756
777,react-cosmos/react-cosmos,2, v,33,6,6,41,74,0 days 00:00:00.264028
778,InsertKoinIO/koin,1,,13,5,6,33,46,0 days 00:00:00.307260
779,pyro-ppl/pyro,2, pytorch-,14,3,7,15,29,0 days 00:00:00.131870
780,altair-viz/altair,2, v,13,3,7,8,21,0 days 00:00:00.159227
781,modin-project/modin,3, Modin-v v,14,1,8,33,47,0 days 00:00:00.116893
782,duplicati/duplicati,1,,0,0,0,3,3,0 days 00:00:00.085405
783,api-platform/api-platform,2, v,8,0,6,54,62,0 days 00:00:00.061997
784,gogf/gf,1,v,14,2,4,106,120,0 days 00:00:00.457802
785,Z3Prover/z3,2,Z3- z3-,4,0,3,21,25,0 days 00:00:00.887398
786,openspug/spug,2,V v,8,2,3,34,42,0 days 00:00:00.075347
787,cryptomator/cryptomator,1,,18,7,6,73,91,0 days 00:00:00.214441
788,TykTechnologies/tyk,3, certs/v v,23,3,9,90,113,0 days 00:00:00.310473
789,oclif/oclif,1,v,59,5,1,261,320,0 days 00:00:00.197274
790,webpack/webpack-dev-server,1,v,42,14,9,70,112,0 days 00:00:00.140354
791,kelektiv/node-cron,2, v,12,1,6,23,35,0 days 00:00:00.032158
792,bigbluebutton/bigbluebutton,1,v,10,0,9,62,72,0 days 00:00:01.770505
793,mopidy/mopidy,1,v,29,6,16,38,67,0 days 00:00:00.518014
794,gotify/server,1,v,5,1,2,41,46,0 days 00:00:00.036648
795,PointCloudLibrary/pcl,1,pcl-,13,2,8,12,25,0 days 00:00:00.809374
796,krallin/tini,1,v,19,1,3,14,33,0 days 00:00:00.023218
797,facebook/litho,1,v,41,22,2,157,198,0 days 00:00:00.924646
798,Sonarr/Sonarr,1,v,44,12,4,8,52,0 days 00:00:00.499758
799,golang/mock,2, v,7,0,5,8,15,0 days 00:00:00.029207
800,lanpa/tensorboardX,1,v,15,1,8,1,16,0 days 00:00:00.027883
801,facebook/jscodeshift,2, v,11,0,5,45,56,0 days 00:00:00.040225
802,lib/pq,1,v,11,0,5,10,21,0 days 00:00:00.042399
803,Supervisor/supervisor,1,,8,1,6,22,30,0 days 00:00:00.144046
804,statsmodels/statsmodels,1,v,10,0,9,12,22,0 days 00:00:00.789594
805,LeetCode-OpenSource/vscode-leetcode,1,v,17,3,0,26,43,0 days 00:00:00.026163
806,drogonframework/drogon,1,v,8,5,0,7,15,0 days 00:00:00.077666
807,playcanvas/engine,4, b v. v,258,151,3,521,779,0 days 00:00:01.619047
808,sosedoff/pgweb,1,v,11,6,3,31,42,0 days 00:00:00.096652
809,dc-js/dc.js,4, temporary_filter_fix_v mks_patch_v v,26,11,7,63,89,0 days 00:00:00.318532
810,tinacms/tinacms,66,@tinacms/react-core@ @tinacms/react-forms@ @tinacms/styles@ @tinacms/react-tinacms@ @tinacms/react-tinacms-remark@ tina-tailwind-sidebar-demo@ demo-cra@ @tinacms/react-modals@ react-tinacms-inline@ gatsby-tinacms-json@ react-tinacms-strapi@ @tinacms/toolkit@ demo-next@ @tinacms/sharedctx@ @tinacms/gatsby-tinacms-git@ cms-scripts@ react-tinacms@ react-dismissible@ gatsby-tinacms-teams@ @tinacms/scripts@ gatsby-tinacms-remark@ nextjs-blog-starter@ react-tinacms-github@ @tinacms/gatsby-tinacms-json@ @tinacms/icons@ @tinacms/react-screens@ @tinacms/react-toolbar@ @tinacms/teams@ @tinacms/auth@ @tinacms/metrics@ @tinacms/git-client@ @tinacms/form-builder@ react-tinacms-blocks@ @tinacms/tinacms@ @tinacms/alerts@ @tinacms/core@ @tinacms/media@ demo-gatsby@ @tinacms/api-git@ @tinacms/fields@ gatsby-tinacms-git@ @tinacms/webpack-helpers@ next-tinacms-github@ react-tinacms-editor@ create-tina-app@ @tinacms/forms@ next-tinacms-json@ next-tinacms-cloudinary@ gatsby-plugin-tinacms@ gatsby-tinacms-mdx@ @tinacms/next-tinacms-git@ @tinacms/datalayer@ tinacms@ @tinacms/schema-tools@ @tinacms/next-tinacms-markdown@ next-tinacms-markdown@ @tinacms/starter@ tina-cloud-starter@ @tinacms/react-sidebar@ @tinacms/cli@ v @tinacms/browser-storage-client@ @tinacms/gatsby-plugin-tinacms@ react-tinacms-date@ @tinacms/react-alerts@ @tinacms/graphql@,72,21,1,1089,1161,0 days 00:00:01.953398
811,amplication/amplication,1,v,12,6,0,43,55,0 days 00:00:00.497183
812,JeffreySu/WeiXinMPSDK,2, v,4,1,2,40,44,0 days 00:00:00.617889
813,primer/octicons,6,octicons@  jekyll-octicons@ v octicons_gem@ octicons_helper@,59,18,6,47,106,0 days 00:00:00.121178
814,symfony/debug,1,v,16,2,13,354,370,0 days 00:00:00.353825
815,cerebroapp/cerebro,2, v,5,1,3,16,21,0 days 00:00:00.042245
816,sandboxie-plus/Sandboxie,2, v,11,2,4,58,69,0 days 00:00:01.400595
817,snowie2000/mactype,1,v,0,0,0,6,6,0 days 00:00:00.029946
818,TrinityCore/TrinityCore,1,TDB,74,41,22,6,80,0 days 00:00:02.882764
819,apache/cassandra,1,cassandra-,23,7,13,183,206,0 days 00:00:01.425780
820,google/agera,1,v,4,0,3,0,4,0 days 00:00:00.033886
821,winsw/winsw,1,v,21,4,10,10,31,0 days 00:00:00.049525
822,i18next/react-i18next,2, v,84,15,2,164,248,0 days 00:00:00.121165
823,fideloper/TrustedProxy,1,,13,0,6,11,24,0 days 00:00:00.046158
824,davemorrissey/subsampling-scale-image-view,1,v,13,3,4,8,21,0 days 00:00:00.040919
825,aristocratos/btop,1,v,3,0,0,35,38,0 days 00:00:00.038413
826,styled-system/styled-system,2,styled-system@ v,14,5,2,90,104,0 days 00:00:00.217436
827,hrydgard/ppsspp,1,v,20,3,14,46,66,0 days 00:00:01.629179
828,FluentValidation/FluentValidation,1,,49,11,18,60,109,0 days 00:00:00.127200
829,mysql/mysql-server,2,mysql-cluster- mysql-,6,1,4,559,565,0 days 00:00:10.656566
830,be5invis/Sarasa-Gothic,1,v,25,1,1,93,118,0 days 00:00:00.050847
831,AlessandroZ/LaZagne,2, v,14,1,3,6,20,0 days 00:00:00.259048
832,zserge/lorca,1,v,1,0,0,10,11,0 days 00:00:00.042639
833,TeamVanced/VancedManager,2, v,11,7,0,8,19,0 days 00:00:00.315276
834,hashicorp/terraform-provider-aws,1,v,226,220,1,33,259,0 days 00:00:03.139642
835,facebook/hermes,1,v,10,0,5,13,23,0 days 00:00:00.248992
836,AppImage/AppImageKit,1,,13,2,8,0,13,0 days 00:00:00.098344
837,boto/boto3,1,,24,1,4,1045,1069,0 days 00:00:01.425230
838,rocksdanister/lively,1,v,18,6,2,29,47,0 days 00:00:00.032621
839,ArduPilot/ardupilot,26,V test-release ArduSub- yuma-may CanberraUAV-OBC- phoenix-good-thermal- ArduPlane- yuma-may-flight ArduCopter-beta-apm Rover- Plane- test-tag AntennaTracker- ArduCopter- ArduCopter-stable-apm solo- AC_ AION-Orca-Alpha cellular-modem- APMrover2- ft - Copter- v AP_Periph- kraus/LastFlights_,59,21,23,254,313,0 days 00:00:03.547288
840,kedro-org/kedro,1,,5,0,4,26,31,0 days 00:00:00.135635
841,xo/usql,1,v,10,4,3,22,32,0 days 00:00:00.043254
842,terkelg/prompts,1,v,9,0,2,24,33,0 days 00:00:00.025922
843,sebastianbergmann/php-timer,1,,7,0,1,19,26,0 days 00:00:00.027371
844,gedoor/MyBookshelf,1,,0,0,0,172,172,0 days 00:00:00.415816
845,beefproject/beef,2,beef- v,1,0,0,32,33,0 days 00:00:00.173665
846,pennersr/django-allauth,1,,42,11,18,13,55,0 days 00:00:00.125453
847,evilsocket/opensnitch,1,v,4,1,2,7,11,0 days 00:00:00.066336
848,MichalLytek/type-graphql,1,v,19,11,1,18,37,0 days 00:00:00.042788
849,cjbassi/gotop,1,,9,4,0,24,33,0 days 00:00:00.029576
850,smartystreets/goconvey,2, v,7,3,3,20,27,0 days 00:00:00.065246
851,styled-components/polished,2,v. v,22,0,2,56,78,0 days 00:00:00.056540
852,ngrx/platform,2, v,35,16,5,25,60,0 days 00:00:00.086864
853,rui314/mold,1,v,5,0,1,13,18,0 days 00:00:00.154685
854,sveltejs/sapper,1,v,29,16,4,149,178,0 days 00:00:00.128242
855,fancyapps/fancybox,3, V v,5,0,0,30,35,0 days 00:00:00.026563
856,nopSolutions/nopCommerce,1,release-,29,4,20,6,35,0 days 00:00:00.642253
857,graphql-python/graphene,2,v. v,16,7,5,29,45,0 days 00:00:00.079358
858,pytube/pytube,2, v,31,10,7,78,109,0 days 00:00:00.282851
859,inorganik/countUp.js,2, v,13,1,5,26,39,0 days 00:00:00.038048
860,angular/angularfire,2, v,11,0,2,28,39,0 days 00:00:00.069712
861,chrisvfritz/prerender-spa-plugin,2, v,10,1,2,1,11,0 days 00:00:00.015233
862,barteksc/AndroidPdfViewer,1,,14,1,1,8,22,0 days 00:00:00.018622
863,Jackett/Jackett,1,v,5,3,0,1800,1805,0 days 00:00:06.464313
864,offensive-security/exploitdb,0,,0,0,0,0,0,0 days 00:00:00.140047
865,flannel-io/flannel,1,v,18,0,11,18,36,0 days 00:00:00.880503
866,alibaba/otter,2,otter- v,0,0,0,10,10,0 days 00:00:00.015557
867,OWASP/Amass,2, v,37,14,5,123,160,0 days 00:00:00.151165
868,FormidableLabs/urql,20,urql@ @urql/exchange-request-policy@ @urql/exchange-auth@ @urql/core@ @urql/exchange-refocus@ @urql/exchange-multipart-fetch@ @urql/storybook-addon@ @urql/storage-rn@ @urql/exchange-suspense@ @urql/introspection@ @urql/vue@ @urql/preact@ @urql/exchange-retry@ @urql/exchange-persisted-fetch@ @urql/exchange-execute@ @urql/exchange-populate@ @urql/exchange-graphcache@ next-urql@ v @urql/svelte@,39,4,2,352,391,0 days 00:00:00.505987
869,jpillora/chisel,2, v,8,0,3,21,29,0 days 00:00:00.021506
870,lz4/lz4,2,r v,18,10,2,11,29,0 days 00:00:00.117645
871,OpenVPN/openvpn,1,v,5,0,4,43,48,0 days 00:00:00.221344
872,mps-youtube/mps-youtube,1,v,1,0,0,26,27,0 days 00:00:00.084381
873,i3/i3,3, tree-pr AnyEvent-,40,1,19,22,62,0 days 00:00:01.146941
874,symfony/routing,1,v,26,2,21,441,467,0 days 00:00:00.724988
875,tektoncd/pipeline,2, v,35,31,0,55,90,0 days 00:00:00.281095
876,java-native-access/jna,2, v,26,3,18,32,58,0 days 00:00:00.366033
877,leeoniya/uPlot,1,,7,3,1,44,51,0 days 00:00:00.073823
878,lbryio/lbry-sdk,5,test-appveyor-deployment- test-release- test-daemon-release- v v.,102,70,7,152,254,0 days 00:00:00.902281
879,fail2ban/fail2ban,5, upstream/ debian/PREPATCH_TO_UPSTREAM_ debian/python sdist/,10,0,5,110,120,0 days 00:00:00.429774
880,marionettejs/backbone.marionette,1,v,32,12,9,93,125,0 days 00:00:00.196940
881,es-shims/es5-shim,1,v,19,5,4,77,96,0 days 00:00:00.071858
882,predis/predis,1,v,6,0,5,31,37,0 days 00:00:00.126339
883,ImageMagick/ImageMagick,1,,0,0,0,1,1,0 days 00:00:00.649810
884,kekingcn/kkFileView,2, v,5,1,2,5,10,0 days 00:00:00.025708
885,Zettlr/Zettlr,3, v. v,28,12,6,49,77,0 days 00:00:00.264656
886,webmozarts/assert,1,,11,0,7,3,14,0 days 00:00:00.019173
887,vaexio/vaex,16, server-v jupyter-v viz-v meta-v astro-v arrow-v distributed-v vaexpaper_v v ml-v core-v contrib-v hdf5-v ui-v graphql-v,41,7,7,177,218,0 days 00:00:00.339572
888,sebastianbergmann/diff,1,,7,0,4,11,18,0 days 00:00:00.024458
889,pillarjs/path-to-regexp,2, v,24,1,4,28,52,0 days 00:00:00.030153
890,minetest/minetest,2, sapier-,10,1,7,28,38,0 days 00:00:00.667223
891,earthly/earthly,2,vscode-syntax-highlighting-v v,6,1,3,79,85,0 days 00:00:00.106105
892,tenacityteam/tenacity,1,Audacity-,6,0,5,13,19,0 days 00:00:00.967290
893,metafizzy/flickity,1,v,10,2,5,24,34,0 days 00:00:00.040531
894,surmon-china/vue-quill-editor,1,v,6,0,1,21,27,0 days 00:00:00.018782
895,nodemcu/nodemcu-firmware,3, dev_json_ dev,4,2,0,1,5,0 days 00:00:00.039844
896,AmruthPillai/Reactive-Resume,1,v,7,4,2,24,31,0 days 00:00:00.150948
897,dexidp/dex,2,api/v v,38,15,8,25,63,0 days 00:00:00.155515
898,checkstyle/checkstyle,2,checkstyle- release,108,74,19,29,137,0 days 00:00:00.643381
899,vercel/styled-jsx,2, v,15,0,3,78,93,0 days 00:00:00.059231
900,yhirose/cpp-httplib,1,v,9,1,2,75,84,0 days 00:00:00.066539
901,ljharb/qs,1,v,25,3,7,49,74,0 days 00:00:00.054017
902,RT-Thread/rt-thread,1,v,7,0,6,21,28,0 days 00:00:00.730916
903,laravel/tinker,1,v,9,1,2,17,26,0 days 00:00:00.021140
904,google/android-classyshark,1,,15,7,2,0,15,0 days 00:00:00.031349
905,readthedocs/readthedocs.org,1,,76,52,5,152,228,0 days 00:00:01.213480
906,musescore/MuseScore,1,v,11,1,9,24,35,0 days 00:00:01.374901
907,jazzband/django-debug-toolbar,2, v,25,3,15,24,49,0 days 00:00:00.115975
908,terser/terser,3, harmony-v v,49,10,7,318,367,0 days 00:00:00.439605
909,mindsdb/mindsdb,3, v. v,48,35,0,71,119,0 days 00:00:00.414793
910,gitkraken/vscode-gitlens,2, v,45,28,4,91,136,0 days 00:00:00.201935
911,jemalloc/jemalloc,1,,22,2,13,24,46,0 days 00:00:00.147540
912,symfony/css-selector,1,v,26,3,10,434,460,0 days 00:00:00.390507
913,raineorshine/npm-check-updates,2, v,56,6,4,194,250,0 days 00:00:00.187237
914,prometheus-operator/prometheus-operator,3,pkg/apis/monitoring/v pkg/client/v v,56,35,0,97,153,0 days 00:00:00.298348
915,smallnest/rpcx,1,v,3,0,1,22,25,0 days 00:00:00.054977
916,sebastianbergmann/php-file-iterator,1,,7,1,3,27,34,0 days 00:00:00.026879
917,symfony/process,1,v,26,4,19,450,476,0 days 00:00:00.364210
918,encode/starlette,1,,19,2,4,94,113,0 days 00:00:00.071762
919,mqttjs/MQTT.js,2, v,42,8,6,109,151,0 days 00:00:00.116660
920,phar-io/version,1,,5,0,3,8,13,0 days 00:00:00.015126
921,ThreeMammals/Ocelot,1,,31,5,3,110,141,0 days 00:00:00.089264
922,tensorlayer/TensorLayer,2, v,13,0,6,52,65,0 days 00:00:00.167319
923,cython/cython,1,,19,0,16,71,90,0 days 00:00:00.836193
924,OlafenwaMoses/ImageAI,5, essentials-v models-v essential-v v,8,0,1,6,14,0 days 00:00:00.021035
925,cloudflare/cfssl,2, v,7,0,6,6,13,0 days 00:00:00.076445
926,wallabag/wallabag,1,,20,5,10,40,60,0 days 00:00:00.534403
927,developit/microbundle,2, v,15,5,5,24,39,0 days 00:00:00.192207
928,swagger-api/swagger-core,2,swagger-project- v,7,0,5,58,65,0 days 00:00:00.288678
929,kivy/python-for-android,2, v,2,0,1,10,12,0 days 00:00:00.347572
930,deepstreamIO/deepstream.io,2, v,25,5,5,98,123,0 days 00:00:00.151456
931,Turfjs/turf,2, v,23,10,3,65,88,0 days 00:00:00.159148
932,fission/fission,5, alpha nightly v buildmgr-preview-,32,8,7,30,62,0 days 00:00:00.091137
933,xmrig/xmrig,1,v,46,34,7,73,119,0 days 00:00:00.201020
934,Qihoo360/RePlugin,1,v,3,0,1,14,17,0 days 00:00:00.032340
935,sebastianbergmann/php-text-template,1,,4,0,1,9,13,0 days 00:00:00.015446
936,DevinVinson/WordPress-Plugin-Boilerplate,1,,9,4,2,5,14,0 days 00:00:00.024629
937,json-path/JsonPath,3, json-path- json-path-parent-,14,3,10,9,23,0 days 00:00:00.049234
938,monero-project/monero,1,v,19,7,7,34,53,0 days 00:00:00.803384
939,fullstorydev/grpcurl,1,v,9,0,1,11,20,0 days 00:00:00.016853
940,FullHuman/purgecss,2, v,23,8,7,20,43,0 days 00:00:00.061918
941,dotansimha/graphql-yoga,10,@graphql-yoga/node@  @graphql-yoga/core@ graphql-yoga@ @graphql-yoga/subscription@ @graphql-yoga/handler@ @graphql-yoga/common@ v @graphql-yoga/graphiql@ @graphql-yoga/render-graphiql@,39,8,1,136,175,0 days 00:00:00.110375
942,robotframework/robotframework,2, v,13,0,12,49,62,0 days 00:00:00.668665
943,Jigsaw-Code/outline-client,9,ios-v android- linux-v windows-v ios-test-xcode android-v windows- daily-travisintegrationtest macos-v,10,0,2,126,136,0 days 00:00:00.230784
944,final-form/react-final-form,2,v. v,23,7,2,47,70,0 days 00:00:00.040253
945,reach/router,1,v,5,0,2,13,18,0 days 00:00:00.021550
946,jsplumb/jsplumb,1,,28,3,14,188,216,0 days 00:00:00.527632
947,symfony/var-dumper,1,v,20,4,15,355,375,0 days 00:00:00.246397
948,google/trax,1,v,3,0,2,15,18,0 days 00:00:00.085700
949,projectstorm/react-diagrams,2, v,16,4,5,23,39,0 days 00:00:00.049047
950,fsnotify/fsnotify,1,v,7,0,3,31,38,0 days 00:00:00.033824
951,matthew-andrews/isomorphic-fetch,1,v,12,0,1,14,26,0 days 00:00:00.014664
952,uber/RIBs,2, v,5,0,2,9,14,0 days 00:00:00.031794
953,reactjs/react-modal,1,v,19,1,3,91,110,0 days 00:00:00.051980
954,PyMySQL/PyMySQL,3,pymysql-  v,9,0,8,32,41,0 days 00:00:00.061569
955,gophish/gophish,2, v,11,0,10,4,15,0 days 00:00:00.041829
956,orbitdb/orbit-db,3, dc v,7,0,3,12,19,0 days 00:00:00.066901
957,jsfiddle/togetherjs,2, v,1,0,0,12,13,0 days 00:00:00.111370
958,google/re2,0,,0,0,0,0,0,0 days 00:00:00.016497
959,spyder-ide/spyder,1,v,16,0,15,79,95,0 days 00:00:01.463323
960,reactiveui/ReactiveUI,2, v,41,16,7,181,222,0 days 00:00:00.740245
961,ffuf/ffuf,1,v,18,2,4,6,24,0 days 00:00:00.025843
962,lowlighter/metrics,1,v,44,29,0,0,44,0 days 00:00:00.127758
963,aws/aws-sdk-js,1,v,1089,18,4,301,1390,0 days 00:00:02.534538
964,daybrush/moveable,11, vue3-moveable@ svelte-moveable@ moveable-storybook@ ngx-moveable@ lit-moveable@ ngx-moveable-app@ react-moveable@ moveable@ preact-moveable@ react-compat-moveable@,23,10,4,117,140,0 days 00:00:00.107984
965,visualfc/liteide,2,x X,64,30,15,2,66,0 days 00:00:00.126635
966,rr-debugger/rr,1,,28,9,14,6,34,0 days 00:00:00.335585
967,abel533/Mapper,1,,18,6,4,33,51,0 days 00:00:00.046612
968,airbytehq/airbyte,1,v,2,0,0,2,4,0 days 00:00:00.335461
969,faisalman/ua-parser-js,2, v,6,0,1,44,50,0 days 00:00:00.168136
970,sundowndev/phoneinfoga,1,v,4,0,3,29,33,0 days 00:00:00.092392
971,trentm/node-bunyan,1,,33,4,4,81,114,0 days 00:00:00.065787
972,fluxcd/flux,4, helm- chart- v,42,13,7,124,166,0 days 00:00:00.290847
973,cosmtrek/air,1,v,5,0,0,18,23,0 days 00:00:00.022370
974,kennethreitz/records,1,v,5,3,1,6,11,0 days 00:00:00.021119
975,cockpit-project/cockpit,2, v,314,275,6,1,315,0 days 00:00:01.044705
976,taskflow/taskflow,1,v,13,3,8,1,14,0 days 00:00:00.080444
977,verlok/vanilla-lazyload,2, v,81,29,5,77,158,0 days 00:00:00.214067
978,laramies/theHarvester,3, V v,5,0,4,11,16,0 days 00:00:00.123519
979,transmission/transmission,1,,99,55,12,1,100,0 days 00:00:00.806590
980,Humanizr/Humanizer,3, V v,16,8,4,49,65,0 days 00:00:00.118905
981,brunch/brunch,1,,24,10,7,107,131,0 days 00:00:00.150255
982,spring-projects/spring-security,1,,6,0,5,35,41,0 days 00:00:00.623816
983,bigskysoftware/htmx,2, v,12,5,1,18,30,0 days 00:00:00.095601
984,gperftools/gperftools,3,google-perftools- gperftools- perftools-,38,0,4,27,65,0 days 00:00:00.062128
985,olivere/elastic,1,v,8,0,5,317,325,0 days 00:00:00.226761
986,microsoft/botframework-sdk,6, botbuilder@ NuGet Nuget v NugGet,32,9,4,67,99,0 days 00:00:00.184029
987,monkeytypegame/monkeytype,1,v,16,5,1,111,127,0 days 00:00:00.484031
988,guess-js/guess,2, v,4,1,0,42,46,0 days 00:00:00.045401
989,microsoft/DeepSpeed,1,v,6,1,3,36,42,0 days 00:00:00.073093
990,microsoft/azuredatastudio,2, v,40,25,2,89,129,0 days 00:00:00.589801
991,barry-ran/QtScrcpy,1,v,9,3,2,15,24,0 days 00:00:00.033370
992,juice-shop/juice-shop,2, v,91,56,8,101,192,0 days 00:00:00.960553
993,isl-org/Open3D,1,v,15,0,7,5,20,0 days 00:00:00.206062
994,Nuitka/Nuitka,1,,13,1,4,238,251,0 days 00:00:00.660608
995,debezium/debezium,1,v,7,0,3,21,28,0 days 00:00:00.098340
996,Sylius/Sylius,1,v,30,4,17,151,181,0 days 00:00:01.726599
997,gobuffalo/buffalo,2, v,15,2,7,107,122,0 days 00:00:00.202344
998,IvanGoncharov/graphql-voyager,0,,0,0,0,0,0,0 days 00:00:00.010574
999,filamentgroup/loadCSS,2, v,9,1,5,14,23,0 days 00:00:00.026399
1000,DylanVann/react-native-fast-image,1,v,20,1,2,90,110,0 days 00:00:00.060818
1001,microsoft/onnxruntime,2,orttraining_rc v,17,1,6,17,34,0 days 00:00:00.501265
1002,ds300/patch-package,1,v,17,1,2,40,57,0 days 00:00:00.037054
1003,ajenti/ajenti,2, v,5,2,1,123,128,0 days 00:00:00.339408
1004,AaronFeng753/Waifu2x-Extension-GUI,1,v,6,3,0,70,76,0 days 00:00:00.145622
1005,vercel/ncc,1,,31,3,1,46,77,0 days 00:00:00.041442
1006,SonarSource/sonarqube,2, latest-silver-master-#,63,13,10,74,137,0 days 00:00:01.938434
1007,BloodHoundAD/BloodHound,2, v,12,0,10,20,32,0 days 00:00:00.064119
1008,ssssssss-team/spider-flow,1,v,5,3,1,6,11,0 days 00:00:00.025026
1009,shoelace-style/shoelace,0,,0,0,0,0,0,0 days 00:00:00.015918
1010,distribution/distribution,1,v,9,0,6,11,20,0 days 00:00:00.156192
1011,Jermolene/TiddlyWiki5,1,v,2,0,1,26,28,0 days 00:00:00.654759
1012,bup/bup,2, bup-,32,14,8,6,38,0 days 00:00:00.239409
1013,kkroening/ffmpeg-python,2, v,1,0,0,12,13,0 days 00:00:00.031847
1014,rsuite/rsuite,3, github-actions. v,38,11,3,114,152,0 days 00:00:00.157167
1015,cssinjs/jss,2, v,60,20,8,86,146,0 days 00:00:00.134403
1016,needim/noty,1,v,10,1,2,37,47,0 days 00:00:00.033592
1017,whyour/qinglong,1,v,5,0,1,14,19,0 days 00:00:00.051878
1018,fontello/fontello,1,,11,0,8,7,18,0 days 00:00:00.202232
1019,microsoft/fast,65, @microsoft/fast-browser-extensions@ @microsoft/fast-color-explorer@ @microsoft/fast-viewer-react@ @microsoft/fast-web-utilities@ @microsoft/fast-markdown-msft-react@ @microsoft/fast-components-styles-msft@ @microsoft/fast-sketch-library@ @microsoft/fast-jss-manager@ @microsoft/eslint-config-fast-dna_v @microsoft/fast-navigation-generator-react@ @microsoft/fast-react-wrapper_v @microsoft/fast-css-editor-react@ @microsoft/eslint-config-fast-dna@ @microsoft/site-utilities@ @microsoft/fast-application-utilities@ @microsoft/fast-components-msft@ @microsoft/fast-components-class-name-contracts-msft@ @microsoft/fast-tooling-react_v @microsoft/fast-component-explorer@ @microsoft/fast-figma-plugin-msft@ @microsoft/fast-animation_v fast-site@ @microsoft/fast-tslint-rules@ @microsoft/fast-jss-manager-react@ fast-tagged-templates_v @microsoft/fast-layouts-react@ @microsoft/fast-web-utilities_v fast-website@ @microsoft/fast-data-utilities-react@ @microsoft/fast-form-generator-react@ @microsoft/fast-jest-snapshots-react@ @microsoft/fast-components-react-base@ @microsoft/fast-react-utilities@ @microsoft/fast-tooling-examples@ @microsoft/fast-storybook-design-system-addon@ @microsoft/fast-tooling_v @microsoft/fast-storybook-presets@ @microsoft/fast-foundation@ @microsoft/fast-components-class-name-contracts-base@ @microsoft/fast-permutator@ @microsoft/fast-website@ @microsoft/fast-tooling-wasm@ @fluentui/web-components@ @microsoft/fast-animation@ @microsoft/fast-development-site-react@ @microsoft/fast-components-react-msft@ @microsoft/fast-foundation_v @microsoft/fast-tooling-react@ @microsoft/fast-tooling@ @microsoft/fast-jss-utilities@ @microsoft/fast-colors_v @microsoft/fast-components-foundation-react@ @microsoft/fast-glyphs-msft@ @microsoft/fast-components_v @microsoft/fast-creator@ @microsoft/fast-element_v @microsoft/fast-router@ @microsoft/fast-components@ @microsoft/fast-router_v v @microsoft/fast-element@ @microsoft/fast-colors@ @microsoft/fast-breakpoint-tracker-react@ @microsoft/fast-jss-manager-angular@,172,10,1,2307,2479,0 days 00:00:08.055981
1020,mongodb/mongo-go-driver,2, v,13,3,7,60,73,0 days 00:00:00.118098
1021,twpayne/chezmoi,1,v,27,15,4,106,133,0 days 00:00:00.284917
1022,tgalal/yowsup,1,v,8,3,4,20,28,0 days 00:00:00.072459
1023,jupyterhub/jupyterhub,1,,19,2,11,20,39,0 days 00:00:00.279350
1024,microsoft/mimalloc,3,win-m M v,11,5,2,28,39,0 days 00:00:00.089443
1025,alibaba/MNN,1,,13,1,3,36,49,0 days 00:00:00.069241
1026,SigNoz/signoz,2, v,7,1,2,28,35,0 days 00:00:00.068276
1027,noisetorch/NoiseTorch,1,,3,0,1,10,13,0 days 00:00:00.015503
1028,lucas-clemente/quic-go,2,v. v,24,5,10,33,57,0 days 00:00:00.283033
1029,kazupon/vue-i18n,1,v,64,18,3,83,147,0 days 00:00:00.123621
1030,infracost/infracost,2, v,10,5,3,62,72,0 days 00:00:00.112119
1031,NLPchina/elasticsearch-sql,1,,46,4,4,144,190,0 days 00:00:00.204927
1032,SirVer/ultisnips,1,,11,2,7,0,11,0 days 00:00:00.074599
1033,skypjack/entt,2,cpp v,22,5,9,17,39,0 days 00:00:00.150093
1034,k9mail/k-9,2, build_,430,200,6,1,431,0 days 00:00:00.870270
1035,Vincit/objection.js,1,,19,1,9,101,120,0 days 00:00:00.123972
1036,eclipse/che,1,,100,85,2,126,226,0 days 00:00:00.591839
1037,serverless-stack/serverless-stack,10,@serverless-stack/node@ @serverless-stack/console@ @serverless-stack/docs@ create-sst@ @serverless-stack/static-site-env@ @serverless-stack/web@ @serverless-stack/resources@ @serverless-stack/core@ @serverless-stack/cli@ v,72,31,1,309,381,0 days 00:00:00.420371
1038,ActivityWatch/activitywatch,1,v,8,2,3,11,19,0 days 00:00:00.039960
1039,wildfirechat/im-server,1,,72,28,0,1,73,0 days 00:00:00.113574
1040,open-policy-agent/opa,1,v,40,22,6,80,120,0 days 00:00:00.411875
1041,kanboard/kanboard,1,v,3,1,1,71,74,0 days 00:00:00.217573
1042,Laravel-Lang/lang,1,,20,9,4,174,194,0 days 00:00:00.321196
1043,great-expectations/great_expectations,3, O. v,16,2,7,139,155,0 days 00:00:00.602268
1044,aheckmann/gm,2, v,31,5,7,35,66,0 days 00:00:00.148367
1045,PCSX2/pcsx2,1,v,4,0,3,831,835,0 days 00:00:02.311383
1046,lcobucci/jwt,1,,11,2,4,34,45,0 days 00:00:00.071380
1047,sindresorhus/fkill-cli,2, v,23,0,0,3,26,0 days 00:00:00.015643
1048,libvips/libvips,1,v,11,0,9,41,52,0 days 00:00:00.456725
1049,ElemeFE/v-charts,1,v,14,1,1,72,86,0 days 00:00:00.043867
1050,BoyceLig/Clash_Chinese_Patch,1,,7,0,0,57,64,0 days 00:00:00.023174
1051,sindresorhus/np,1,v,42,1,3,34,76,0 days 00:00:00.036238
1052,schollz/howmanypeoplearearound,1,v,4,1,1,11,15,0 days 00:00:00.014698
1053,hugapi/hug,1,,18,10,5,44,62,0 days 00:00:00.121652
1054,grpc/grpc-web,1,,7,4,2,9,16,0 days 00:00:00.047471
1055,kornia/kornia,2, v,6,0,3,27,33,0 days 00:00:00.119898
1056,Rob--W/cors-anywhere,2, v,3,1,0,18,21,0 days 00:00:00.016072
1057,sebastianbergmann/comparator,1,,7,0,3,21,28,0 days 00:00:00.024237
1058,xojs/xo,1,v,43,3,7,43,86,0 days 00:00:00.051217
1059,gregberge/loadable-components,1,v,30,5,3,35,65,0 days 00:00:00.046230
1060,OctoPrint/OctoPrint,1,,9,0,7,42,51,0 days 00:00:00.516093
1061,yanzhenjie/AndPermission,1,,2,0,1,13,15,0 days 00:00:00.020342
1062,nextui-org/nextui,0,,0,0,0,0,0,0 days 00:00:00.014429
1063,Tencent/Hippy,2, qb-androidx-,14,4,1,66,80,0 days 00:00:00.081510
1064,visgl/react-map-gl,2, v,22,3,8,143,165,0 days 00:00:00.115908
1065,pymc-devs/pymc,1,v,11,0,9,9,20,0 days 00:00:00.435780
1066,Hacker0x01/react-datepicker,2, v,107,43,1,73,180,0 days 00:00:00.216601
1067,ipfs/js-ipfs,59, ipfs-v example-running-multiple-nodes@ ipfs-grpc-client@ example-browser-mfs@ example-browser-parceljs@ example-browser-webpack@ example-traverse-ipld-graphs@ ipfs-client-v ipfs-core-types@ ipfs@ example-js-ipfs-in-electron@ ipfs-daemon-v example-browser-readablestream@ ipfs-http-response@ ipfs-cli-v ipfs-message-port-client-v ipfs-message-port-client@ ipfs-grpc-server@ interface-ipfs-core-v example-exchange-files-in-browser@ example-ipfs-101@ ipfs-core-utils-v example-browser-add-readable-stream@ ipfs-core-config-v ipfs-message-port-protocol-v interface-ipfs-core@ example-browser-script-tag@ example-custom-ipfs-repo@ ipfs-http-server-v ipfs-core-v ipfs-grpc-client-v ipfs-grpc-protocol@ ipfs-http-server@ ipfs-core-types-v ipfs-message-port-server@ ipfs-http-client@ example-browser-video-streaming@ ipfs-daemon@ ipfs-cli@ ipfs-core-config@ ipfs-core-utils@ ipfs-client@ ipfs-message-port-server-v example-browser-vue@ example-explore-ethereum-blockchain@ ipfs-message-port-protocol@ example-browser-browserify@ ipfs-http-client-v test-ipfs-example@ example-browser-create-react-app@ ipfs-grpc-server-v example-custom-libp2p@ ipfs-http-gateway-v example-circuit-relaying@ ipfs-http-response-v v ipfs-http-gateway@ ipfs-core@,256,33,7,1038,1294,0 days 00:00:02.334032
1068,JetBrains/ideavim,2, EAP-,43,12,12,4,47,0 days 00:00:00.358355
1069,electron/fiddle,2, v,29,12,3,22,51,0 days 00:00:00.101116
1070,shidenggui/easytrader,1,,2,0,0,11,13,0 days 00:00:00.031028
1071,enquirer/enquirer,1,,6,1,1,27,33,0 days 00:00:00.035227
1072,flyway/flyway,1,flyway-,40,7,13,101,141,0 days 00:00:00.193813
1073,janeczku/calibre-web,1,,1,0,0,17,18,0 days 00:00:00.263188
1074,migueldeicaza/gui.cs,1,v,13,2,3,9,22,0 days 00:00:00.140362
1075,QUANTAXIS/QUANTAXIS,2, V,15,3,4,44,59,0 days 00:00:00.459910
1076,php-fig/http-message,1,,12,0,0,5,17,0 days 00:00:00.013960
1077,wailsapp/wails,1,v,19,6,1,44,63,0 days 00:00:00.143677
1078,yargs/yargs,3, yargs-v v,88,26,8,95,183,0 days 00:00:00.178027
1079,google/auto,5,auto-common- auto-value- auto-service- auto-parent- auto-factory-,26,2,14,28,54,0 days 00:00:00.194940
1080,jaredpalmer/tsdx,1,v,13,4,3,40,53,0 days 00:00:00.035982
1081,grpc/grpc-java,1,v,52,22,4,58,110,0 days 00:00:00.355532
1082,catboost/catboost,3, v. v,25,7,3,57,82,0 days 00:00:00.984416
1083,iterative/dvc,1,,92,63,3,258,350,0 days 00:00:00.634255
1084,Netflix/pollyjs,14,@pollyjs/persister@ @pollyjs/ember@ @pollyjs/persister-rest@ @pollyjs/persister-fs@ @pollyjs/persister-local-storage@ @pollyjs/adapter-puppeteer@ @pollyjs/node-server@ @pollyjs/utils@ @pollyjs/adapter-xhr@ @pollyjs/adapter-fetch@ @pollyjs/cli@ v @pollyjs/adapter@ @pollyjs/core@,26,3,0,127,153,0 days 00:00:00.067811
1085,raysan5/raylib,1,,13,0,11,4,17,0 days 00:00:00.237197
1086,unoplatform/uno,3, hr-pre v,23,10,3,27,50,0 days 00:00:01.117860
1087,matthieua/WOW,1,,3,0,1,26,29,0 days 00:00:00.040095
1088,dmlc/dgl,2, v,7,0,6,15,22,0 days 00:00:00.265283
1089,stylelint/stylelint,2, v,97,72,4,88,185,0 days 00:00:00.323701
1090,botpress/botpress,2, v,88,53,4,234,322,0 days 00:00:00.638088
1091,wasabeef/glide-transformations,1,,9,1,2,10,19,0 days 00:00:00.013815
1092,dbader/schedule,1,,7,0,4,17,24,0 days 00:00:00.032408
1093,barbajs/barba,5, @barba/css@ @barba/prefetch@ @barba/router@ @barba/core@,10,0,1,74,84,0 days 00:00:00.076431
1094,josdejong/jsoneditor,1,v,71,21,5,125,196,0 days 00:00:00.148129
1095,JakeWharton/timber,2, timber-parent-,21,4,6,16,37,0 days 00:00:00.030688
1096,svgdotjs/svg.js,1,,50,5,5,48,98,0 days 00:00:00.070102
1097,haiwen/seafile,10, datadupe- lianyou- pafile- server- mac-v client- Horizonbase- HorizonBase- v,19,1,8,113,132,0 days 00:00:00.270150
1098,square/javapoet,2,javapoet- javawriter-,20,3,8,16,36,0 days 00:00:00.060303
1099,languagetool-org/languagetool,2,languagetool-parent- v,35,0,34,11,46,0 days 00:00:02.677658
1100,libretro/RetroArch,2, v,15,3,7,77,92,0 days 00:00:03.344523
1101,react-native-camera/react-native-camera,1,v,84,7,3,96,180,0 days 00:00:00.140261
1102,FormidableLabs/victory,1,v,65,24,5,156,221,0 days 00:00:00.574070
1103,snapappointments/bootstrap-select,2, v,13,2,5,52,65,0 days 00:00:00.100480
1104,lvgl/lvgl,2, v,26,10,7,20,46,0 days 00:00:00.523096
1105,acidanthera/OpenCorePkg,1,,4,0,3,31,35,0 days 00:00:00.304085
1106,zealdocs/zeal,1,v,6,0,4,4,10,0 days 00:00:00.069583
1107,apache/arrow,5,apache-arrow- go/arrow/v apache-arrow-js- go/v go/parquet/v,25,3,16,20,45,0 days 00:00:00.669675
1108,scipy/scipy,1,v,27,0,26,45,72,0 days 00:00:01.587336
1109,zaproxy/zaproxy,3, svn_ v,16,0,12,18,34,0 days 00:00:00.699836
1110,TranslucentTB/TranslucentTB,1,,14,1,4,0,14,0 days 00:00:00.087480
1111,mdbootstrap/material-design-for-bootstrap,1,,18,0,0,46,64,0 days 00:00:00.028972
1112,wix/Detox,5, detox-server@ detox@ v detox-cli@,117,47,4,275,392,0 days 00:00:00.513052
1113,jhy/jsoup,2, jsoup-,1,0,0,39,40,0 days 00:00:00.109874
1114,addyosmani/critical,2, v,17,1,4,44,61,0 days 00:00:00.046654
1115,clojure/clojure,2, clojure-,12,0,11,6,18,0 days 00:00:00.161773
1116,pockethub/PocketHub,2, v,11,5,3,9,20,0 days 00:00:00.154214
1117,mwaskom/seaborn,1,v,11,0,8,9,20,0 days 00:00:00.138273
1118,sindresorhus/pageres,2, v,24,2,3,23,47,0 days 00:00:00.033058
1119,senchalabs/connect,1,,52,17,10,174,226,0 days 00:00:00.432533
1120,meliorence/react-native-snap-carousel,2,V v,22,10,2,29,51,0 days 00:00:00.030273
1121,vuestorefront/vue-storefront,14,@vue-storefront/extension-droppoint-shipping@ cms@ @vue-storefront/theme-starter@ @vue-storefront/i18n@ @vue-storefront/extension-template@ @vue-storefront/theme-default@ @vue-storefront/extension-payment-backend-methods@ @vue-storefront/store@ @vue-storefront/extension-mailchimp-subscribe@ v @vue-storefront/core@ @vue-storefront/extension-google-analytics@ @vue-storefront/extension-payment-cash-on-delivery@ @vue-storefront/extension-magento2-cms@,15,8,5,62,77,0 days 00:00:00.732061
1122,BookStackApp/BookStack,3, v. v,36,10,9,113,149,0 days 00:00:00.250985
1123,TarsCloud/Tars,2, v,15,2,4,32,47,0 days 00:00:00.057562
1124,matrix-org/synapse,9, 2017-06- dinsic_2019-06- hhs- shhs-v v dinsic_2019-04- 2017-05- dinsic_2018-07-,115,80,11,136,251,0 days 00:00:01.389620
1125,mongodb/node-mongodb-native,3,V v. v,25,4,18,387,412,0 days 00:00:01.153189
1126,argoproj/argo-cd,1,v,25,9,4,115,140,0 days 00:00:00.375304
1127,cookiecutter/cookiecutter-django,1,,1,0,0,129,130,0 days 00:00:00.317583
1128,adobe/react-spectrum,148, @react-types/actiongroup@ @react-spectrum/form@ @react-types/meter@ @react-types/button@ @react-stately/combobox@ @internationalized/message@ react-stately@ @react-stately/list@ @react-spectrum/numberfield@ @react-aria/dialog@ @react-aria/searchfield@ @react-aria/progress@ @react-aria/breadcrumbs@ @react-types/contextualhelp@ @react-stately/tabs@ @react-stately/tooltip@ @react-stately/utils@ @react-aria/utils@ @react-spectrum/buttongroup@ @react-spectrum/label@ @react-aria/focus@ @react-aria/spinbutton@ @react-types/progress@ @react-stately/virtualizer@ @react-spectrum/overlays@ @react-types/view@ @react-stately/select@ @react-spectrum/textfield@ @react-types/combobox@ @react-spectrum/dialog@ @react-stately/menu@ @react-types/listbox@ @react-types/buttongroup@ @react-spectrum/breadcrumbs@ @react-types/dialog@ @react-spectrum/searchfield@ @react-aria/numberfield@ @react-aria/table@ @react-spectrum/tabs@ @react-types/slider@ @react-types/tabs@ @react-types/grid@ @react-types/checkbox@ @react-types/shared@ @react-types/overlays@ @react-spectrum/menu@ @react-spectrum/icon@ @react-spectrum/text@ @adobe/react-spectrum@ @react-stately/toggle@ @react-types/statuslight@ @react-spectrum/theme-default@ @react-spectrum/layout@ @react-stately/searchfield@ @react-types/searchfield@ @spectrum-icons/illustrations@ @react-types/menu@ @react-types/text@ @react-spectrum/theme-light@ @react-aria/separator@ @react-stately/grid@ @react-stately/table@ @react-types/switch@ @react-stately/numberfield@ @react-types/numberfield@ @react-spectrum/illustratedmessage@ @react-spectrum/link@ @react-spectrum/image@ @react-spectrum/utils@ @react-stately/radio@ @react-types/select@ @react-types/image@ @spectrum-icons/workflow@ @react-stately/slider@ @react-aria/switch@ @react-spectrum/statuslight@ @react-spectrum/meter@ @react-aria/interactions@ @react-aria/button@ @react-aria/grid@ @react-spectrum/listbox@ @react-stately/collections@ @react-types/illustratedmessage@ @react-types/tooltip@ @react-spectrum/contextualhelp@ @react-aria/live-announcer@ @spectrum-icons/color@ react-aria@ @react-aria/listbox@ @react-aria/radio@ @react-aria/aria-modal-polyfill@ @react-aria/actiongroup@ @react-aria/virtualizer@ @react-spectrum/combobox@ @react-types/link@ @react-stately/selection@ @react-stately/overlays@ @react-types/radio@ @react-stately/layout@ @react-spectrum/picker@ @react-stately/data@ @react/react-spectrum@ @spectrum-icons/ui@ @react-aria/select@ @react-spectrum/tooltip@ @react-types/label@ @react-aria/tabs@ @react-stately/tree@ @react-aria/ssr@ @react-spectrum/radio@ @react-types/provider@ @react-spectrum/provider@ @react-aria/toggle@ @react-aria/textfield@ @react-aria/visually-hidden@ @react-types/table@ @react-aria/tooltip@ @react-aria/meter@ @react-aria/checkbox@ @react-types/well@ @react-aria/combobox@ @internationalized/number@ @react-types/textfield@ @react-spectrum/checkbox@ @react-aria/overlays@ @react-spectrum/slider@ @react-spectrum/theme-dark@ @react-spectrum/divider@ @react-spectrum/table@ @react-spectrum/well@ @react-aria/selection@ @react-aria/menu@ @react-spectrum/button@ @react-stately/checkbox@ @react-spectrum/progress@ @react-spectrum/view@ @react-aria/slider@ @react-types/form@ @react-types/layout@ @react-aria/link@ @react-spectrum/switch@ @react-types/breadcrumbs@ @react-types/divider@ @react-aria/label@ v @react-spectrum/actiongroup@ @react-aria/i18n@,50,25,2,1829,1879,0 days 00:00:04.137121
1129,mswjs/msw,2, v,38,13,1,90,128,0 days 00:00:00.093416
1130,darknessomi/musicbox,1,,1,0,0,11,12,0 days 00:00:00.032791
1131,mamoe/mirai,10, wrapper- conosle- test-doc- console- mirai- japt- special- v core-,53,40,4,102,155,0 days 00:00:00.537938
1132,phpredis/phpredis,1,,14,0,13,44,58,0 days 00:00:00.153721
1133,jhen0409/react-native-debugger,1,v,12,3,4,74,86,0 days 00:00:00.206503
1134,apidoc/apidoc,1,,27,5,6,19,46,0 days 00:00:00.052407
1135,squizlabs/PHP_CodeSniffer,1,,19,5,12,51,70,0 days 00:00:00.532551
1136,pion/webrtc,1,v,8,0,6,145,153,0 days 00:00:00.253175
1137,Automattic/kue,2, v,10,2,6,47,57,0 days 00:00:00.063931
1138,gabrielbull/react-desktop,2, v,2,0,0,27,29,0 days 00:00:00.033518
1139,charmbracelet/glow,1,v,7,4,1,10,17,0 days 00:00:00.038000
1140,vnotex/vnote,2, v,47,28,3,13,60,0 days 00:00:00.091708
1141,pinojs/pino,2, v,90,20,2,150,240,0 days 00:00:00.171258
1142,DevExpress/testcafe,17,spawn-browser- element-screenshot-rc role-defs- code-steps- experimental-razor- debug-convergence- build-gh- status_bar-redisign- gh- sync-selector- debug-T edge-error- no-reload-demo- dq- v element-screenshot-alpha disable-page-cache-alpha-,42,14,8,85,127,0 days 00:00:00.301224
1143,upx/upx,1,v,31,4,18,0,31,0 days 00:00:00.153130
1144,deepmind/sonnet,1,v,35,9,1,0,35,0 days 00:00:00.052630
1145,JamesNK/Newtonsoft.Json,1,,0,0,0,63,63,0 days 00:00:00.096434
1146,MyCATApache/Mycat-Server,1,,1,0,0,0,1,0 days 00:00:00.021721
1147,r-spacex/SpaceX-API,2, v,15,9,3,8,23,0 days 00:00:00.105947
1148,Atmosphere-NX/Atmosphere,1,,18,7,6,48,66,0 days 00:00:00.184309
1149,bulletphysics/bullet3,1,,18,3,9,6,24,0 days 00:00:00.537339
1150,bobthecow/psysh,1,v,11,0,9,72,83,0 days 00:00:00.112238
1151,dingo/api,2, v,16,5,5,41,57,0 days 00:00:00.092126
1152,future-architect/vuls,1,v,19,1,4,64,83,0 days 00:00:00.173982
1153,exceljs/exceljs,2, v,41,22,4,180,221,0 days 00:00:00.160544
1154,Zulko/moviepy,1,v,1,0,0,11,12,0 days 00:00:00.047693
1155,FormidableLabs/spectacle,2, v,35,3,8,77,112,0 days 00:00:00.088804
1156,uncss/uncss,1,,9,2,5,9,18,0 days 00:00:00.035204
1157,deployphp/deployer,1,v,20,5,8,47,67,0 days 00:00:00.105169
1158,reactjs/react-transition-group,1,v,19,5,6,19,38,0 days 00:00:00.029585
1159,systemd/systemd,3, v239- v,242,129,22,43,285,0 days 00:00:03.506708
1160,adamwdraper/Numeral-js,1,,3,0,2,12,15,0 days 00:00:00.034814
1161,opencontainers/runc,1,v,3,0,2,16,19,0 days 00:00:00.333540
1162,oblador/react-native-animatable,1,v,10,1,2,13,23,0 days 00:00:00.016042
1163,coredns/coredns,1,v,20,6,7,42,62,0 days 00:00:00.180119
1164,acaudwell/Gource,1,gource-,20,0,8,0,20,0 days 00:00:00.048994
1165,c3js/c3,2, v,6,0,3,108,114,0 days 00:00:00.122238
1166,davatorium/rofi,1,,8,0,5,26,34,0 days 00:00:00.294868
1167,cheat/cheat,1,,18,1,4,67,85,0 days 00:00:00.097004
1168,crimx/ext-saladict,3, V v,59,34,5,139,198,0 days 00:00:00.325092
1169,arasatasaygin/is.js,1,v,8,3,1,13,21,0 days 00:00:00.032320
1170,doctrine/orm,2, v,13,0,12,77,90,0 days 00:00:00.876685
1171,callstack/react-native-paper,2, v,53,23,4,61,114,0 days 00:00:00.113094
1172,openedx/edx-platform,1182, release-2018-09-21- release-2021-03-18- release-2019-07-17- release-2019-05-21- release-2022-03-07- release-2021-11-12- release-2020-07-17- release-2017-06-15- release-2018-10-12- release-2018-04-27- release-2020-02-03- release-2020-05-14- release-2017-12-05- release-2020-12-18- release-2017-07-18- release-2022-02-08- release-2021-07-19- release-2018-09-19- release-2021-01-05- release-2020-01-14- release-2018-06-22- release-2017-04-20- release-2017-03-28- release-2019-04-25- release-2017-10-10- release-2018-05-21- release-2019-05-08- release-2017-04-07- release-2017-12-07- release-2021-09-09- release-2021-01-26- release-2021-02-05- release-2020-07-01- release-2020-09-16- release-2022-05-27- release-2021-06-07- release-2017-12-12- release-2020-09-23- release-2021-07-21- release-2020-11-12- release-2020-06-17- release-2022-02-17- release-2017-03-08- release-2019-01-25- release-2018-11-02- release-2020-10-29- release-2021-09-02- release-2018-08-30- release-2017-03-09- release-2020-04-02- release-2018-08-31- release-2020-10-05- release-2022-02-15- release-2021-06-14- release-2020-03-11- release-2019-12-10- release-2019-12-04- release-2021-07-22- release-2022-02-09- release-2018-12-03- release-2020-02-20- release-2020-04-23- release-2020-08-26- release-2020-08-24- release-2020-07-27- release-2021-08-09- release-2022-01-31- release-2019-07-24- release-2019-06-28- release-2017-01-24- release-2021-02-24- release-2021-06-17- release-2017-01-31- release-2022-04-13- release-2019-01-02- release-2020-02-25- release-2022-02-07- release-2020-03-27- release-2019-04-01- release-2020-06-29- archived-branch/arjun/pre_push_ release-2020-03-06- release-2017-04-25- release-2019-05-10- release-2022-03-25- release-2019-02-07- release-2018-10-30- release-2017-02-10- release-2022-03-31- release-2020-06-10- release-2021-06-03- release-2017-09-12- release-2019-03-05- release-2021-05-10- release-2017-05-04- release-2021-01-25- release-2020-02-18- release-2019-03-19- release-2020-09-01- release-2020-01-06- release-2019-02-12- release-2017-11-02- open-release/ginkgo. release-2020-03-25- release-2017-09-14- release-2021-11-22- release-2018-10-26- release-2018-01-17- release-2021-01-15- release-2019-11-04- release-2018-07-10- release-2020-08-06- release-2018-04-05- release-2019-09-18- release-2019-03-15- release-2021-10-28- release-2018-11-19- release-2017-09-05- release-2018-09-06- release-2020-01-30- release-2020-10-20- named-release/dogwood. release-2021-07-28- release-2017-10-20- release-2019-10-02- release-2019-12-18- release-2018-01-08- release-2017-02-06- release-2019-11-19- release-2019-04-22- release-2020-05-07- release-2017-02-07- release-2017-03-20- release-2021-04-12- release-2017-03-10- release-2017-11-28- release-2018-02-26- release-2021-08-13- release-2019-08-23- release-2018-02-27- release-2020-11-09- release-2020-05-26- release-2020-08-04- release-2018-08-20- release-2022-03-02- release-2019-09-30- release-2017-04-13- release-2022-01-11- release-2018-01-24- release-2021-07-07- release-2021-06-15- release-2021-03-19- release-2022-01-26- release-2020-09-11- release-2020-12-16- release-2018-11-27- release-2020-05-15- release-2021-01-29- release-2020-07-13- release-2019-11-25- release-2020-09-15- release-2021-05-09- release-2017-03-03- release-2020-11-24- release-2018-11-06- release-2017-01-30- release-2022-01-19- release-2018-10-19- release-2020-08-14- release-2019-02-13- release-2021-07-15- release-2019-09-09- release-2019-10-25- release-2017-05-18- release-2021-01-13- release-2021-12-08- release-2020-02-06- release-2022-03-16- release-2017-09-19- release-2019-01-30- release-2018-01-29- release-2017-05-12- release-2020-09-30- release-2017-02-28- release-2019-10-11- release-2019-08-07- release-2019-03-13- release-2020-01-22- release-2019-02-21- release-2020-11-06- release-2020-03-20- release-2019-10-15- release-2019-03-18- release-2021-02-11- release-2021-09-01- release-2019-01-14- release-2020-05-31- release-2021-04-15- release-2021-07-16- release-2020-10-19- release-2021-02-09- release-2022-03-15- release-2021-11-19- release-2019-04-04- release-2018-07-20- release-2017-03-27- release-2017-12-22- release-2020-08-25- release-2020-07-09- release-2020-12-04- release-2021-05-25- release-2021-04-05- release-2019-04-17- release-2017-08-23- release-2022-04-08- release-2018-05-17- release-2019-01-22- release-2018-04-11- release-2019-11-15- named-release/cypress.rc release-2018-08-13- release-2022-01-06- release-2022-03-21- release-2018-04-06- release-2017-09-07- release-2022-05-06- release-2018-05-16- release-2020-06-11- release-2020-03-26- release-2021-07-01- release-2021-06-09- release-2021-01-07- release-2018-06-15- release-2018-01-19- release-2019-07-26- release-2019-01-16- release-2019-04-10- release-2018-11-26- release-2019-03-01- release-2020-09-10- release-2021-07-26- release-2018-05-25- release-2018-09-14- release-2020-04-24- release-2021-04-14- release-2018-02-07- release-2021-01-28- release-2019-04-29- release-2018-05-11- release-2019-03-11- release-2022-05-16- release-2021-10-26- release-2020-02-17- release-2021-12-22- release-2018-05-15- release-2021-11-28- release-2020-02-04- release-2018-08-15- release-2018-09-07- release-2021-03-05- release-2018-06-14- release-2018-02-01- release-2021-04-06- release-2017-12-20- release-2017-05-24- release-2018-05-08- release-2019-05-24- release-2020-09-08- release-2019-01-07- release-2021-03-26- open-release/ficus. release-2021-05-04- release-2017-08-28- release-2019-06-25- release-2022-03-22- release-2021-11-29- release-2022-02-16- release-2018-03-16- release-2021-10-04- release-2019-01-04- release-2019-06-18- sprint- release-2021-03-15- release-2019-06-24- release-2020-03-18- release-2020-08-21- release-2020-01-08- release-2017-06-30- release-2018-05-22- hotfix- release-2022-01-07- release-2018-09-11- release-2022-03-28- release-2021-06-21- release-2017-10-25- release-2020-04-10- release-2020-11-11- release-2022-01-28- release-2021-07-02- release-2021-01-12- release-2021-03-25- release-2019-10-10- release-2017-09-29- release-2017-09-06- release-2017-02-02- release-2019-06-27- release-2021-09-14- release-2021-06-24- release-2021-02-03- release-2020-08-23- release-2017-07-25- release-2019-04-18- release-2020-03-31- release-2021-05-14- release-2022-03-24- release-2017-09-01- release-2020-04-16- release-2017-08-21- release-2020-05-12- release-2018-05-02- release-2018-12-20- release-2017-09-08- release-2020-08-17- release-2017-06-27- release-2020-03-16- release-2018-06-06- release-2020-06-16- release-2019-07-10- release-2018-05-31- release-2017-08-04- release-2017-10-30- release-2021-05-28- release-2022-02-01- release-2018-05-29- release-2017-04-27- release-2021-03-31- release-2021-09-29- release-2021-01-06- release-2020-04-03- release-2019-11-06- release-2017-02-08- release-2019-04-09- release-2018-06-27- release-2020-04-14- release-2021-02-19- release-2019-10-30- release-2018-10-31- release-2019-11-11- release-2022-05-18- release-2018-11-20- release-2020-04-01- release-2018-10-03- release-2019-10-18- release-2021-01-21- release-2018-12-16- release-2019-07-29- release-2020-09-02- release-2021-06-25- release-2022-05-12- release-2020-06-21- release-2021-09-08- release-2020-08-27- ned/test-ficus. release-2017-08-09- release-2018-03-15- release-2019-01-03- release-2021-09-24- release-2017-06-22- release-2018-03-26- release-2021-02-26- release-2018-08-03- release-2021-12-21- release-2017-10-16- open-release/eucalyptus. release-2017-07-28- release-2019-02-19- release-2021-03-16- release-2020-12-10- release-2022-05-20- release-2019-10-03- nedbat/test-ficus.1rc open-release/koa. release-2022-04-15- release-2020-03-19- release-2021-02-16- release-2018-03-27- release-2021-08-18- release-2020-12-17- release-2022-04-04- release-2021-03-10- edx-west-release- release-2021-08-20- release-2017-08-22- nedbat/test/h. release-2018-08-16- release-2022-01-05- release-2019-08-26- release-2022-03-04- release-2021-12-15- release-2021-06-22- release-2018-11-30- release-2020-01-24- release-2019-07-15- release-2019-06-21- release-2021-10-22- release-2017-02-03- aspen. release-2017-08-11- release-2018-10-09- release-2017-01-26- release-2022-03-23- release-2019-03-20- release-2021-12-06- release-2021-04-01- release-2020-10-16- release-2018-04-02- release-2019-11-18- release-2019-02-15- release-2018-10-02- release-2021-07-06- release-2022-05-03- release-2017-03-29- release-2020-05-06- release-2021-03-11- release-2017-07-20- release-2018-09-10- release-2018-12-12- release-2021-08-23- release-2020-05-04- release-2020-10-28- release-2020-01-27- release-2017-05-31- release-2019-10-01- release-2021-02-25- release-2021-02-08- release-2017-11-09- release-2021-05-26- release-2018-04-12- release-2019-11-21- release-2021-07-23- release-2020-12-22- release-2019-07-18- release-2018-07-24- release-2021-08-12- release-2018-06-28- release-2021-10-08- release-2019-07-02- release-2020-02-24- release-2020-03-24- release-2019-02-20- release-2020-11-04- release-2018-06-01- release-2021-06-11- release-2020-01-02- release-2022-02-23- named-release/birch. release-2017-10-02- release-2017-09-13- release-2021-01-14- release-2019-11-14- release-2017-10-26- release-2017-09-18- release-2020-01-09- release-2021-11-18- release-2020-10-07- release-2021-08-10- release-2017-09-26- release-2018-08-17- release-2022-04-14- release-2022-02-02- release-2017-02-15- release-2018-04-23- release-2017-06-01- release-2020-02-26- release-2019-08-22- release-2017-11-16- release-2021-09-10- release-2020-05-16- release-2021-06-01- release-2020-10-22- release-2019-07-03- release-2021-10-01- aspen- release-2019-05-29- release-2017-06-09- release-2022-04-29- release-2021-08-06- release-2019-08-13- release-2018-10-01- release-2020-10-15- release-2020-06-19- release-2020-07-24- release-2018-02-15- release-2020-05-22- release-2019-10-21- release-2018-11-28- release-2021-07-30- release-2018-09-05- release-2019-05-03- release-2018-02-28- release-2018-03-06- release-2020-08-03- release-2018-03-20- release-2017-06-06- release-2020-06-05- release-2017-03-07- release-2019-07-01- release-2019-03-21- release-2020-02-28- release-2020-11-20- open-release/hawthorn. release-2018-09-27- release-2022-04-27- release-2019-03-14- release-2020-06-26- release-2020-09-25- release-2020-05-11- release-2017-03-13- release-2019-03-22- release-2017-03-06- release-2019-08-12- release-2021-05-20- release-2022-05-04- release-2017-08-18- mitx-release-fa release-2021-09-16- release-2021-08-27- release-2021-09-03- release-2020-02-07- release-2017-11-14- release-2020-06-08- release-2021-04-29- release-2017-05-05- release-2019-08-19- release-2018-12-05- release-2021-02-02- release-2021-11-15- release-2022-02-04- release-2021-08-16- release-2020-02-10- release-2020-05-10- release-2018-12-10- release-2018-08-09- release-2019-02-26- release-2020-02-12- release-2020-07-31- release-2022-03-30- release-2017-06-13- release-2021-11-05- release-2017-04-12- release-2021-11-02- v release-2022-03-29- release-2020-03-02- release-2021-08-11- release-2022-05-02- release-2019-03-04- release-2018-08-07- release-2021-06-10- release-2019-05-30- release-2019-05-09- release-2021-12-09- release-2020-09-29- release-2018-08-08- release-2020-11-13- release-2020-07-10- release-2020-09-09- release-2018-06-25- release-2020-07-07- edx-west/release- proctor-hotfix- release-2019-08-09- release-2021-01-11- release-2018-04-13- release-2018-08-21- release-2017-06-19- release-2020-05-29- release-2022-01-12- release-2021-04-02- release-2020-06-24- release-2021-05-12- release-2020-08-11- release-2017-05-08- release-2020-11-25- release-2020-08-22- release-2020-12-14- release-2021-01-27- release-2021-12-13- release-2019-06-05- release-2017-02-27- release-2019-09-19- release-2018-01-31- release-2021-08-30- release-2020-07-28- release-2021-06-23- release-2022-01-13- release-2019-01-08- release-2020-03-09- release-2018-11-08- release-2020-11-16- release-2019-04-03- release-2017-10-18- release-2020-05-05- release-2022-05-10- release-2021-12-23- release-2018-06-19- release-2018-02-22- release-2021-12-01- release-2017-11-22- release-2019-12-16- release-2018-01-10- release-2021-09-22- release-2022-02-03- release-2021-11-30- nedbat/test/ficus.2rc release-2018-04-26- release-2021-11-11- release-2021-08-02- release-2017-04-04- release-2019-01-31- release-2018-07-18- release-2018-08-29- release-2018-09-25- release-2020-04-30- release-2020-07-30- release-2021-10-25- release-2020-03-03- release-2018-07-05- release-2022-05-23- release-2019-06-20- release-2020-03-13- release-2021-03-01- release-2020-10-25- release-2020-09-04- release-2021-05-27- release-2017-06-28- release-2021-09-21- release-2021-07-29- release-2020-10-13- release-2020-09-28- release-2017-07-21- release-2021-03-08- release-2017-05-03- release-2022-04-18- release-2021-03-24- release-2017-12-21- release-2017-07-12- release-2021-12-19- release-2017-11-03- release-2019-11-07- release-2021-12-07- release-2018-07-17- release-2022-01-10- release-2017-05-19- release-2020-12-09- release-2020-06-28- release-2022-02-14- nedbat/test/ficus. release-2021-06-30- release-2017-11-07- release-2021-05-11- release-2019-02-27- release-2021-11-09- release-2019-11-08- release-2021-11-08- release-2018-07-31- release-2021-02-22- release-2020-05-08- release-2018-12-07- release-2019-06-10- release-2017-08-02- release-2021-05-21- release-2021-06-02- release-2020-08-07- release-2022-02-11- release-2021-10-07- release-2019-03-25- release-2017-11-08- release-2018-07-27- release-2022-03-14- release-2021-02-10- release-2017-02-21- release-2017-08-31- release-2018-05-10- release-2018-03-07- release-2021-08-25- release-2019-09-11- release-2021-09-30- release-2021-04-08- release-2019-06-17- release-2020-04-15- release-2021-08-26- release-2020-02-21- release-2017-06-07- release-2019-03-27- release-2019-05-02- release-2018-04-17- release-2022-05-24- release-2020-06-02- release-2021-10-19- release-2019-10-29- release-2018-10-18- release-2018-02-02- release-2022-02-21- release-2017-07-24- release-2017-08-17- release-2021-07-08- release-2022-03-17- release-2021-09-17- release-2021-03-17- release-2017-06-26- release-2018-05-03- release-2020-08-12- release-2018-02-12- release-2019-01-18- release-2021-12-14- release-2022-05-09- release-2017-09-25- release-2018-03-29- release-2018-09-18- release-2020-05-27- release-2017-04-28- release-2019-10-07- named-release/dogwood.rc release-2017-04-26- release-2022-04-05- release-2018-06-11- release-2020-11-03- release-2020-08-13- release-2020-02-13- release-2018-07-02- release-2017-10-13- release-2020-04-25- release-2017-07-14- release-2018-08-23- release-2019-04-11- release-2021-02-06- release-2018-07-26- release-2020-02-14- release-2020-02-11- release-2019-05-15- release-2022-05-25- release-2021-11-23- release-2018-04-03- release-2021-05-17- release-2018-05-14- release-2018-08-22- release-2022-01-24- release-2018-01-30- release-2022-01-27- release-2020-10-14- release-2017-12-14- release-2019-10-23- release-2018-02-14- release-2021-12-31- release-2022-03-08- release-2022-02-24- release-2020-03-12- release-2018-05-30- release-2020-11-02- release-2021-05-18- release-2017-07-06- release-2021-03-29- release-2020-07-08- release-2018-03-08- release-2021-03-04- release-2020-08-09- release-2019-07-12- release-2017-08-10- release-2022-01-21- release-2017-04-11- release-2019-08-06- release-2019-02-22- release-2017-05-09- release-2022-03-01- release-2018-11-21- release-2021-05-06- release-2021-07-12- release-2017-07-31- release-2021-04-07- release-2022-05-05- release-2019-07-25- release-2021-09-23- nedbat/test/ficus.1rc release-2017-06-29- release-2017-11-30- release-2020-06-01- release-2022-02-18- release-2018-07-19- release-2020-11-05- release-2021-12-29- release-2022-04-19- release-2020-12-01- release-2020-01-10- release-2019-01-24- release-2018-10-04- release-2019-08-15- release-2018-03-09- release-2022-01-18- release-2020-09-27- release-2017-04-14- release-2018-09-20- release-2021-09-28- release-2018-05-23- release-2017-04-18- release-2020-07-26- release-2020-02-27- release-2020-01-03- release-2019-08-30- release-2020-09-24- release-2020-06-04- release-2019-06-13- release-2017-05-25- release-2020-12-02- release-2021-10-05- release-2020-09-14- release-2020-02-08- release-2022-04-20- release-2021-12-17- release-2020-12-23- release-2019-12-13- release-2021-10-29- release-2020-07-16- release-2018-09-17- release-2019-09-17- release-2020-01-29- release-2018-08-28- release-2017-12-11- release-2019-01-15- release-2019-04-23- release-2021-10-13- release-2020-08-10- release-2020-07-15- release-2020-04-17- release-2017-08-01- release-2020-02-19- release-2021-01-20- release-2018-06-05- release-2019-12-05- release-2020-05-13- release-2018-06-08- release-2020-04-13- release-2017-02-23- release-2018-04-24- release-2018-04-19- release-2018-04-09- release-2019-11-05- release-2018-06-21- release-2018-07-30- release-2018-01-03- release-2020-12-15- open-release/lilac. release-2018-08-10- release-2022-01-04- release-2018-08-27- release-2017-12-04- release-2020-10-26- release-2018-05-01- release-2020-11-10- release-2019-04-19- dogwood-first- release-2021-11-01- release-2018-06-20- release-2018-03-02- release-2022-03-03- release-2020-08-31- release-2019-05-16- release-2021-03-23- release-2021-11-24- release-2021-07-27- release-2022-03-09- release-2017-07-10- release-2019-09-26- release-2017-05-10- release-2021-06-29- release-2017-06-16- release-2021-09-20- release-2018-06-12- release-2019-10-08- release-2021-10-06- release-2019-12-19- release-2019-08-21- release-2020-11-23- release-2021-03-09- release-2021-02-01- release-2021-05-05- release-2021-08-29- release-2019-06-14- release-2021-08-04- release-2017-09-20- jan- release-2020-05-21- release-2021-02-04- release-2018-04-04- release-2022-04-21- release-2021-03-02- release-2018-06-26- release-2018-10-22- release-2017-11-15- release-2022-04-01- release-2019-09-06- release-2017-05-16- release-2018-07-06- release-2018-12-14- release-2019-10-09- release-2022-05-17- release-2020-11-22- release-2018-03-01- named-release/birch.rc release-2020-08-28- release-2022-04-26- open-release/juniper. release-2019-12-06- release-2017-12-13- release-2021-04-26- release-2018-12-18- release-2021-12-02- release-2017-07-13- release-2018-09-26- release-2019-10-17- release-2021-02-18- release-2021-10-20- release-2020-01-31- release-2022-05-13- release-2019-08-02- release-2020-04-29- release-2020-07-14- release-2021-11-17- release-2021-12-03- release-2017-06-14- release-2019-02-04- release-2021-04-16- release-2017-06-05- release-2017-05-30- release-2021-10-18- release-2017-03-24- release-2019-11-01- release-2021-11-04- release-2019-03-08- release-2019-01-23- release-2017-08-24- release-2018-07-12- release-2019-09-12- release-2020-08-20- release-2017-03-23- release-2021-06-16- release-2017-11-13- release-2022-02-25- open-release/maple. release-2020-06-03- release-2021-03-30- release-2020-09-22- release-2021-10-14- release-2021-12-26- release-2020-05-19- release-2020-06-12- release-2021-10-15- release-2021-01-08- release-2018-08-14- release-2020-07-19- release-2020-03-17- release-2019-12-09- release-2017-03-17- release-2022-05-11- release-2018-02-20- release-2017-07-19- release-2017-05-02- release-2021-02-17- release-2020-04-21- release-2018-04-10- release-2021-08-05- release-2018-03-14- release-2017-10-04- release-2021-07-13- release-2018-07-13- release-2017-07-05- release-2017-09-15- release-2020-06-15- release-2018-02-08- release-2020-04-06- release-2021-09-07- release-2022-03-11- release-2020-07-02- release-2019-09-16- release-2018-05-09- release-2021-11-26- open-release/ironwood. release-2019-09-20- appsembler/intersystems/release/dogwood.rc-SSO- release-2019-07-30- release-2021-11-03- release-2021-08-24- release-2019-01-20- release-2020-01-23- release-2021-06-04- release-2018-01-26- release-2018-10-17- release-2019-08-29- release-2017-05-23- release-2020-01-07- release-2019-08-05- release-2021-07-09- release-2019-08-20- release-2022-04-07- release-2021-08-03- release-2021-04-28- release-2020-03-04- release-2018-07-25- release-2017-03-02- release-2020-06-18- release-2022-04-28- release-2019-11-22- release-2018-01-25- release-2019-02-06- release-2018-05-24- release-2019-04-16- release-2017-08-07- release-2022-03-18- release-2021-07-14- release-2017-04-06- release-2022-05-19- release-2017-07-11- release-2018-08-24- release-2017-04-19- release-2017-05-01- release-2018-10-05- release-2019-07-23- release-2021-10-21- release-2020-04-22- release-2019-10-16- release-2021-02-12- release-2019-07-31- release-2018-07-03- release-2017-01-27- release-2021-12-10- release-2021-01-19- release-2018-12-13- release-2021-05-03- release-2022-04-12- release-2018-01-11- release-2021-04-13- release-2019-03-06- release-2019-05-31- release-2020-09-03- release-2021-12-16- release-2017-06-23- release-2018-10-23- release-2020-06-09- release-2021-09-15- release-2022-01-20- release-2019-09-23- release-2017-05-17- release-2020-12-07- release-2020-04-07- release-2020-10-06- release-2020-09-17- release-2019-03-28- release-2017-03-31- release-2018-03-28- release-2021-08-17- release- release-2018-11-07- release-2021-09-27- release-2022-04-06- release-2020-08-19- release-2020-06-25- release-2019-12-20- release-2020-07-20- release-2020-01-28- release-2020-06-22- release-2017-08-03- release-2020-07-22- release-2020-03-10- release-2022-04-11- release-2018-07-23- release-2020-04-09- release-2019-02-14- release-2022-01-25- edx-west/releas- release-2018-10-29- release-2018-11-14- release-2019-01-10- release-2022-02-10- release-2019-06-06- release-2019-05-07- release-2019-04-02- release-2022-04-22- release-2020-01-21- release-2020-09-21- release-2018-11-16- release-2019-08-08- release-2019-03-26- release-2022-02-28- release-2020-07-29- release-2020-05-01- release-2021-08-31- release-2022-05-26- release-2020-10-21- release-2020-10-30- release-2019-02-05- release-2019-08-01- release-2020-11-19- release-2019-06-19- release-2019-02-25- release-2017-03-30- release-2019-04-26- release-2017-02-24- release-2018-03-21- release-2021-03-22- release-2018-02-05- release-2020-11-17- release-2019-12-17- release-2021-08-19- release-2019-12-12- proctor-release- release-2020-03-30- release-2022-02-22- release-2021-03-03- release-2019-09-05- release-2020-05-28- release-2022-04-25- release-2021-05-19- release-2020-10-01- release-2021-12-28- release-2020-02-05- release-2021-07-20- release-2017-03-16- release-2021-06-08- release-2021-04-09- release-2020-09-18- release-2020-12-11- release-2020-04-27- release-2018-02-13- release-2019-08-28- release-2017-10-03- release-2018-11-29- release-2021-11-16- release-2017-02-16- release-2018-12-21- release-2021-04-30- release-2018-12-04- release-2019-05-28- release-2019-09-27- release-2021-05-07- release-2021-05-13- release-2020-06-30- release-2021-12-20- release-2020-08-18- release-2022-03-10- release-2020-06-23- release-2018-02-16- release-2019-04-08- release-2020-10-23- release-2017-07-27- release-2021-11-10- release-2017-10-05- release-2020-01-13- release-2021-03-12- release-2017-06-21- release-2017-10-12- release-2018-01-18- release-2018-10-11- release-2019-09-10- release-2018-04-18- release-2021-04-27- release-2017-06-20- release-2021-10-27- release-2020-08-05- release-2017-08-30- release-2019-01-17- release-2019-06-12- release-2017-08-25- release-2019-01-09- release-2020-12-03- release-2018-05-04- release-2020-10-02- release-2017-11-06- release-2019-05-20- release-2016-07- amc- release-2018-11-01-,2040,77,148,2491,4531,0 days 00:00:34.476909
1173,hackware1993/MagicIndicator,1,,8,3,0,5,13,0 days 00:00:00.015770
1174,docmirror/dev-sidecar,2, v,7,3,2,16,23,0 days 00:00:00.032887
1175,pyinstaller/pyinstaller,2, v,28,5,19,6,34,0 days 00:00:00.570326
1176,coleifer/peewee,1,,35,8,13,139,174,0 days 00:00:00.248862
1177,boardgameio/boardgame.io,1,v,39,20,2,111,150,0 days 00:00:00.134045
1178,apereo/cas,1,v,20,0,19,159,179,0 days 00:00:03.337770
1179,Unity-Technologies/UnityCsReference,0,,0,0,0,0,0,0 days 00:00:00.055351
1180,gomodule/redigo,1,v,3,0,0,10,13,0 days 00:00:00.022016
1181,aksakalli/gtop,1,v,3,0,1,9,12,0 days 00:00:00.012456
1182,chimurai/http-proxy-middleware,1,v,26,0,2,30,56,0 days 00:00:00.034217
1183,streamaserver/streama,1,v,6,0,5,47,53,0 days 00:00:00.096004
1184,javascript-obfuscator/javascript-obfuscator,1,,63,27,2,122,185,0 days 00:00:00.222723
1185,apache/thrift,3, thrift- v,15,0,11,16,31,0 days 00:00:00.418276
1186,symfony/console,1,v,26,4,21,466,492,0 days 00:00:00.475343
1187,PrefectHQ/prefect,1,,17,5,6,102,119,0 days 00:00:00.889639
1188,akveo/react-native-ui-kitten,1,v,8,0,2,16,24,0 days 00:00:00.048246
1189,koral--/android-gif-drawable,1,v,3,0,2,53,56,0 days 00:00:00.074528
1190,direnv/direnv,2, v,33,2,15,42,75,0 days 00:00:00.175861
1191,alibaba/hooks,7,ahooks@ @umijs/hooks@ ahooks-v2@ @ahooksjs/use-url-state@ @umijs/use-request@ v @ahooksjs/use-request@,29,14,1,156,185,0 days 00:00:00.556034
1192,phpDocumentor/ReflectionDocBlock,1,,14,1,7,24,38,0 days 00:00:00.051555
1193,hacksalot/HackMyResume,1,v,20,10,0,19,39,0 days 00:00:00.041297
1194,TooTallNate/Java-WebSocket,2,Java-WebSocket- v,13,1,6,14,27,0 days 00:00:00.062253
1195,sonic-pi-net/sonic-pi,1,v,16,5,7,9,25,0 days 00:00:00.495664
1196,logaretm/vee-validate,5, vee-validate@ @vee-validate/i18n@ v @vee-validate/rules@,14,3,5,151,165,0 days 00:00:00.341698
1197,Gallopsled/pwntools,1,,26,5,8,35,61,0 days 00:00:00.214657
1198,glfw/glfw,1,,4,0,3,14,18,0 days 00:00:00.210498
1199,rough-stuff/wired-elements,1,v,9,1,4,26,35,0 days 00:00:00.038966
1200,typecho/typecho,1,v,1,0,0,0,1,0 days 00:00:00.074810
1201,ydataai/pandas-profiling,2,v. v,20,7,7,14,34,0 days 00:00:00.078937
1202,alexfoxy/lax.js,2, v,3,1,0,14,17,0 days 00:00:00.024789
1203,aksonov/react-native-router-flux,2, v,13,1,5,34,47,0 days 00:00:00.093115
1204,timarney/react-app-rewired,10, react-app-rewire-mobx@ react-app-rewire-polyfills@ react-app-rewire-eslint@ react-app-rewired@ v react-app-rewire-relay@ react-app-rewire-preact@ react-app-rewire-sass@ react-app-rewire-less@,10,0,2,41,51,0 days 00:00:00.042384
1205,cure53/DOMPurify,2, v,12,1,6,68,80,0 days 00:00:00.138357
1206,sinonjs/sinon,2, v,57,18,16,121,178,0 days 00:00:00.434862
1207,didi/cube-ui,2, v,13,9,1,69,82,0 days 00:00:00.148196
1208,react-dropzone/react-dropzone,2, v,55,5,3,120,175,0 days 00:00:00.114014
1209,sympy/sympy,1,sympy-,14,0,12,34,48,0 days 00:00:02.696028
1210,OWASP/owasp-mstg,2, v,5,1,3,7,12,0 days 00:00:00.732121
1211,paulmillr/chokidar,1,,28,8,10,70,98,0 days 00:00:00.120593
1212,thumbor/thumbor,1,,61,12,9,178,239,0 days 00:00:00.254482
1213,ginuerzh/gost,2, v,21,4,6,11,32,0 days 00:00:00.048663
1214,SoftEtherVPN/SoftEtherVPN,1,,1,0,0,18,19,0 days 00:00:00.094281
1215,helmetjs/helmet,1,v,51,2,6,34,85,0 days 00:00:00.079211
1216,capnproto/capnproto,1,v,9,1,6,12,21,0 days 00:00:00.385892
1217,inversify/InversifyJS,2, v,25,4,6,22,47,0 days 00:00:00.092014
1218,symless/synergy-core,2, release-,6,0,3,38,44,0 days 00:00:00.207726
1219,openlayers/openlayers,4,release- docs- backport- v,63,25,19,53,116,0 days 00:00:01.855107
1220,Studio3T/robomongo,1,v,5,0,3,24,29,0 days 00:00:00.306804
1221,callstack/linaria,1,v,14,2,2,24,38,0 days 00:00:00.052557
1222,HabitRPG/habitica,2, v,351,105,2,612,963,0 days 00:00:02.071489
1223,SecureAuthCorp/impacket,1,impacket_,1,0,0,17,18,0 days 00:00:00.171743
1224,zuiidea/antd-admin,1,,8,0,5,11,19,0 days 00:00:00.039243
1225,TuSimple/naive-ui,2, v,26,21,1,70,96,0 days 00:00:00.587993
1226,nukeop/nuclear,3,eac e v,5,0,4,21,26,0 days 00:00:00.160931
1227,mayswind/AriaNg,1,,9,0,6,14,23,0 days 00:00:00.032637
1228,dromara/Sa-Token,1,v,23,16,2,1,24,0 days 00:00:00.045555
1229,aws/chalice,1,,38,15,7,43,81,0 days 00:00:00.138780
1230,didi/chameleon,2, v,4,1,1,19,23,0 days 00:00:00.062279
1231,labring/sealos,2,kubeadm v,6,1,2,17,23,0 days 00:00:00.056440
1232,marmelab/gremlins.js,2, v,5,0,3,2,7,0 days 00:00:00.189368
1233,gka/chroma.js,2, v,9,0,3,26,35,0 days 00:00:00.036069
1234,nasa/fprime,2,NASA-v v,10,1,7,5,15,0 days 00:00:00.219651
1235,antvis/G6,1,,9,2,2,64,73,0 days 00:00:00.355171
1236,phpDocumentor/TypeResolver,1,,14,0,7,18,32,0 days 00:00:00.030949
1237,cert-manager/cert-manager,1,v,25,3,3,49,74,0 days 00:00:00.512294
1238,crawlab-team/crawlab,1,v,6,1,3,21,27,0 days 00:00:00.111395
1239,fkhadra/react-toastify,1,v,33,10,7,60,93,0 days 00:00:00.174264
1240,react-page/react-page,2, v,58,9,4,214,272,0 days 00:00:00.154179
1241,webtorrent/webtorrent-desktop,1,v,25,17,5,13,38,0 days 00:00:00.112951
1242,heartexlabs/label-studio,2,v. v,14,1,2,24,38,0 days 00:00:00.092658
1243,facebookresearch/ParlAI,2, v,10,5,2,10,20,0 days 00:00:00.210046
1244,dompdf/dompdf,1,v,6,0,4,14,20,0 days 00:00:00.078295
1245,libevent/libevent,1,release-,1,0,0,1,2,0 days 00:00:00.021126
1246,CleverRaven/Cataclysm-DDA,4, cdda-jenkins-b experimental- v,2705,745,1,2,2707,0 days 00:00:15.192111
1247,JetBrains/compose-jb,2, v,4,0,3,5,9,0 days 00:00:00.165138
1248,OpenRefine/OpenRefine,2, v,13,1,10,9,22,0 days 00:00:00.323091
1249,tinode/chat,1,v,6,1,4,45,51,0 days 00:00:00.152624
1250,tweepy/tweepy,2, v,40,16,15,4,44,0 days 00:00:00.164565
1251,openframeworks/openFrameworks,1,,10,1,6,16,26,0 days 00:00:00.909242
1252,carlospolop/PEASS-ng,1,,40,0,0,0,40,0 days 00:00:00.073878
1253,facebook/chisel,1,,10,1,6,3,13,0 days 00:00:00.037280
1254,amueller/word_cloud,1,,5,0,4,6,11,0 days 00:00:00.033892
1255,angular/protractor,3, fv v,47,31,5,44,91,0 days 00:00:00.105255
1256,zerotier/ZeroTierOne,1,,15,3,5,68,83,0 days 00:00:00.400778
1257,encode/httpx,1,,23,7,3,47,70,0 days 00:00:00.074416
1258,DNSCrypt/dnscrypt-proxy,1,,2,0,1,45,47,0 days 00:00:00.245845
1259,falconry/falcon,1,,11,0,9,11,22,0 days 00:00:00.104989
1260,remarkjs/react-markdown,2, v,22,2,6,46,68,0 days 00:00:00.198941
1261,phpDocumentor/ReflectionCommon,1,,7,0,1,1,8,0 days 00:00:00.014196
1262,quay/clair,2,config/v v,10,1,5,52,62,0 days 00:00:00.103827
1263,golang-migrate/migrate,1,v,24,6,7,25,49,0 days 00:00:00.094931
1264,mapeditor/tiled,1,v,27,3,19,56,83,0 days 00:00:00.314553
1265,Aircoookie/WLED,1,v,8,1,5,15,23,0 days 00:00:00.098260
1266,GoogleChromeLabs/comlink,1,v,15,6,4,23,38,0 days 00:00:00.084041
1267,AutoMapper/AutoMapper,2, v,24,0,20,26,50,0 days 00:00:00.185334
1268,easy-mock/easy-mock,1,v,4,0,1,8,12,0 days 00:00:00.013610
1269,mementum/backtrader,1,,7,2,1,132,139,0 days 00:00:00.192617
1270,cefsharp/CefSharp,1,v,27,4,10,70,97,0 days 00:00:00.346473
1271,pytest-dev/pytest,1,,42,10,17,122,164,0 days 00:00:00.947347
1272,jshint/jshint,3, relicensing- r,27,8,9,47,74,0 days 00:00:00.368682
1273,coursera-dl/coursera-dl,1,,8,1,5,12,20,0 days 00:00:00.067215
1274,aws/aws-cdk,1,v,217,193,0,46,263,0 days 00:00:00.750449
1275,novnc/noVNC,1,v,10,0,8,3,13,0 days 00:00:00.116888
1276,ultralytics/yolov3,1,v,12,6,3,0,12,0 days 00:00:00.108365
1277,gregberge/svgr,1,v,36,6,4,19,55,0 days 00:00:00.051539
1278,desandro/imagesloaded,1,v,11,0,3,27,38,0 days 00:00:00.031425
1279,videolan/vlc,1,,9,0,3,50,59,0 days 00:00:04.302679
1280,espressif/arduino-esp32,1,,2,0,1,9,11,0 days 00:00:00.098356
1281,IdentityServer/IdentityServer4,3, RC beta,17,8,7,44,61,0 days 00:00:00.170481
1282,django-cms/django-cms,1,,16,0,15,69,85,0 days 00:00:01.401129
1283,YiiGuxing/TranslationPlugin,2,clion# v,19,2,7,42,61,0 days 00:00:00.109397
1284,doctrine/dbal,2, v,18,2,14,79,97,0 days 00:00:00.723380
1285,s0md3v/Photon,1,v,2,0,0,17,19,0 days 00:00:00.026264
1286,microsoft/Windows-universal-samples,2, v,438,0,0,171,609,0 days 00:00:00.435471
1287,vercel/vercel,44, @now/node-bridge@ @now/wordpress@ @now/mdx-deck@ @now/cgi@ @now/layer-npm@ @now/go@ @now/html-minifier@ @now/md@ @vercel/static-config@ @vercel/next@ @now/php-bridge@ @now/node@ @now/python@ @now/layer-yarn@ @now/lambda@ @now/build-utils@ @vercel/node@ @now/node-server@ gatsby-plugin-now@ now@ @now/frameworks@ @now/next@ @vercel/frameworks@ @vercel/cgi@ @vercel/python@ @vercel/ruby@ @now/ruby@ @now/routing-utils@ now-client@ @now/optipng@ @vercel/build-utils@ @vercel/redwood@ @vercel/static-build@ @now/php@ @now/layer-node@ @vercel/node-bridge@ @now/rust@ @now/bash@ @vercel/client@ @vercel/go@ @now/static-build@ @vercel/routing-utils@ vercel@,164,43,1,1019,1183,0 days 00:00:02.276639
1288,pyodide/pyodide,2, v,20,9,6,25,45,0 days 00:00:00.114530
1289,caprover/caprover,2,V v,12,6,5,17,29,0 days 00:00:00.080767
1290,piskelapp/piskel,1,v,14,2,9,16,30,0 days 00:00:00.092032
1291,SignalR/SignalR,2, v,10,0,9,23,33,0 days 00:00:00.360725
1292,keplergl/kepler.gl,3,keplergl== keplergl-jupyter@ v,10,3,5,53,63,0 days 00:00:00.075363
1293,cs01/gdbgui,4,pyPI-  pypi- v,16,0,2,52,68,0 days 00:00:00.066621
1294,chakra-core/ChakraCore,1,v,9,1,3,52,61,0 days 00:00:00.673364
1295,mailpile/Mailpile,1,,5,1,2,6,11,0 days 00:00:00.228625
1296,questdb/questdb,2, v,12,1,8,39,51,0 days 00:00:00.168319
1297,captbaritone/webamp,1,,6,0,3,11,17,0 days 00:00:00.161772
1298,gedoor/legado,1,,0,0,0,231,231,0 days 00:00:00.727872
1299,Nickersoft/push.js,2, v,1,0,0,23,24,0 days 00:00:00.023744
1300,cyrus-and/gdb-dashboard,1,v,15,2,1,15,30,0 days 00:00:00.024116
1301,tweenjs/tween.js,3, r v,30,4,10,23,53,0 days 00:00:00.052189
1302,mapbox/mapbox-gl-js,2,v style-spec@,108,51,5,100,208,0 days 00:00:00.853105
1303,spotDL/spotify-downloader,1,v,14,2,4,38,52,0 days 00:00:00.079236
1304,CesiumGS/cesium,2, b,120,116,0,12,132,0 days 00:00:01.996165
1305,EpistasisLab/tpot,2, v,9,1,5,15,24,0 days 00:00:00.119814
1306,Automattic/node-canvas,2, v,30,6,10,88,118,0 days 00:00:00.116599
1307,aws/serverless-application-model,2, v,42,10,5,9,51,0 days 00:00:00.067203
1308,microsoft/qlib,1,v,4,0,2,11,15,0 days 00:00:00.094876
1309,google/go-github,1,v,59,10,6,35,94,0 days 00:00:00.104146
1310,OnsenUI/OnsenUI,1,,20,6,8,68,88,0 days 00:00:00.538209
1311,claudiodangelis/qrcp,1,,6,1,0,17,23,0 days 00:00:00.019155
1312,ExistentialAudio/BlackHole,1,v,1,0,0,9,10,0 days 00:00:00.026800
1313,trufflesecurity/trufflehog,2, v,7,4,0,20,27,0 days 00:00:00.088994
1314,XTLS/Xray-core,1,v,6,1,1,21,27,0 days 00:00:00.026404
1315,gotwarlost/istanbul,2, v,3,0,2,52,55,0 days 00:00:00.039823
1316,graphql-go/graphql,1,v,4,0,2,10,14,0 days 00:00:00.059531
1317,Shopify/sarama,1,v,34,10,15,18,52,0 days 00:00:00.273686
1318,aristocratos/bpytop,1,v,1,0,0,68,69,0 days 00:00:00.042805
1319,Justson/AgentWeb,2, v,4,1,1,13,17,0 days 00:00:00.041624
1320,Activiti/Activiti,2, activiti-,29,10,14,6,35,0 days 00:00:00.691168
1321,muesli/duf,1,v,8,5,1,4,12,0 days 00:00:00.016905
1322,gildas-lormeau/SingleFile,1,v,1,0,0,66,67,0 days 00:00:00.313429
1323,keras-team/autokeras,1,,4,0,3,47,51,0 days 00:00:00.087868
1324,pallets/jinja,1,,14,0,11,29,43,0 days 00:00:00.348243
1325,sveltejs/kit,1,kit.svelte.dev@,0,0,0,1,1,0 days 00:00:00.222123
1326,dotnet/orleans,4, v. rebond/tmp/feature/directory-rework/ v,18,0,14,72,90,0 days 00:00:00.377278
1327,dotnet/runtime,1,v,2,0,1,22,24,0 days 00:00:07.021017
1328,pmndrs/jotai,1,v,24,7,0,88,112,0 days 00:00:00.078078
1329,jprichardson/node-fs-extra,2, v,43,7,7,42,85,0 days 00:00:00.073638
1330,scrapinghub/portia,3,slybot- slybot_ portia-,4,1,1,16,20,0 days 00:00:00.136552
1331,golang/protobuf,1,v,6,0,4,10,16,0 days 00:00:00.048131
1332,shipshapecode/tether,1,v,13,2,3,60,73,0 days 00:00:00.071353
1333,nextapps-de/flexsearch,1,,4,1,1,13,17,0 days 00:00:00.021268
1334,welldone-software/why-did-you-render,2,v. v,19,1,1,67,86,0 days 00:00:00.046248
1335,wkentaro/labelme,1,v,50,15,7,125,175,0 days 00:00:00.136149
1336,listen1/listen1_chrome_extension,1,v,32,7,1,36,68,0 days 00:00:00.041676
1337,phpspec/prophecy,2, v,16,0,11,24,40,0 days 00:00:00.047074
1338,James-Yu/LaTeX-Workshop,1,v,89,53,1,126,215,0 days 00:00:00.284252
1339,MarshallOfSound/Google-Play-Music-Desktop-Player-UNOFFICIAL-,2, v,26,15,3,32,58,0 days 00:00:00.086423
1340,linkerd/linkerd2,3,edge- stable- v,17,1,0,222,239,0 days 00:00:00.471625
1341,restsharp/RestSharp,2, v,30,10,7,29,59,0 days 00:00:00.109268
1342,MonoGame/MonoGame,2, v,12,1,9,4,16,0 days 00:00:00.672597
1343,blevesearch/bleve,1,v,14,1,4,27,41,0 days 00:00:00.140661
1344,cats-oss/android-gpuimage,1,v,3,0,2,9,12,0 days 00:00:00.029182
1345,kubernetes-sigs/kustomize,10,cmd/config/v cmd/kubectl/v v pluginator/v pseudo/k8s/v kustomize/v kstatus/v cmd/resource/v kyaml/v api/v,33,8,5,249,282,0 days 00:00:00.432960
1346,dotansimha/graphql-code-generator,60, @graphql-codegen/add@ @graphql-codegen/typescript-jit-sdk@ @graphql-codegen/typescript-stencil-apollo@ @graphql-codegen/typescript-vue-apollo@ @graphql-codegen/hasura-allow-list@ @graphql-codegen/flow-operations@ @graphql-codegen/typescript-compatibility@ @graphql-codegen/fragment-matcher@ @graphql-codegen/typescript-msw@ @graphql-codegen/import-types-preset@ @graphql-codegen/typescript-react-apollo@ @graphql-codegen/typescript-vue-urql@ @graphql-codegen/gql-tag-operations@ @graphql-codegen/visitor-plugin-common@ @graphql-codegen/introspection@ @graphql-codegen/typescript-graphql-request@ @graphql-codegen/graphql-modules-preset@ @graphql-codegen/typescript-enum-array@ @graphql-codegen/typescript-graphql-files-modules@ @graphql-codegen/typescript-graphql-apollo@ @graphql-codegen/typescript-react-offix@ @graphql-codegen/java-resolvers@ @graphql-codegen/typescript-urql-graphcache@ @graphql-codegen/flow-resolvers@ @graphql-codegen/typescript-apollo-angular@ @graphql-codegen/typescript-mongodb@ @graphql-codegen/typescript-operations@ @graphql-cli/codegen@ @graphql-codegen/schema-ast@ @graphql-codegen/plugin-helpers@ @graphql-codegen/cli@ @graphql-codegen/java@ @graphql-codegen/near-operation-file-preset@ @graphql-codegen/java-common@ @graphql-codegen/typescript-apollo-client-helpers@ @graphql-codegen/kotlin@ @graphql-codegen/core@ @graphql-codegen/urql-svelte-operations-store@ @graphql-codegen/typescript-rtk-query@ @graphql-codegen/time@ @graphql-codegen/typed-document-node@ @graphql-codegen/typescript-type-graphql@ @graphql-codegen/c-sharp@ @graphql-codegen/typescript-generic-sdk@ @graphql-codegen/java-apollo-android@ @graphql-codegen/typescript@ @graphql-codegen/named-operations-object@ @graphql-codegen/gql-tag-operations-preset@ @graphql-codegen/typescript-oclif@ @graphql-codegen/typescript-vue-apollo-smart-ops@ @graphql-codegen/typescript-react-query@ @graphql-codegen/typescript-document-nodes@ @graphql-codegen/typescript-urql@ @graphql-codegen/typescript-resolvers@ @graphql-codegen/urql-introspection@ v @graphql-codegen/c-sharp-operations@ @graphql-codegen/jsdoc@ @graphql-codegen/flow@,60,24,2,1553,1613,0 days 00:00:04.574702
1347,google/go-cloud,9,pubsub/natspubsub/v secrets/hashivault/v  pubsub/kafkapubsub/v secrets/vault/v pubsub/rabbitpubsub/v v docstore/mongodocstore/v runtimevar/etcdvar/v,25,12,6,63,88,0 days 00:00:00.120221
1348,gskinner/regexr,1,,5,1,1,6,11,0 days 00:00:00.020642
1349,tsayen/dom-to-image,1,,13,1,2,23,36,0 days 00:00:00.027928
1350,giampaolo/psutil,1,release-,32,8,17,52,84,0 days 00:00:00.384450
1351,libgit2/libgit2,1,v,29,7,16,48,77,0 days 00:00:00.920097
1352,stanfordnlp/CoreNLP,1,v,11,1,8,12,23,0 days 00:00:00.770107
1353,nilaoda/N_m3u8DL-CLI,1,,18,1,2,65,83,0 days 00:00:00.038121
1354,evolus/pencil,1,v,2,0,1,4,6,0 days 00:00:00.075486
1355,GeekyAnts/vue-native-core,2, v,3,0,2,6,9,0 days 00:00:00.024894
1356,cesanta/mongoose,1,,43,11,21,1,44,0 days 00:00:00.183177
1357,nodejs/node-gyp,2, v,37,2,15,98,135,0 days 00:00:00.104737
1358,cytoscape/cytoscape.js,1,v,29,10,12,198,227,0 days 00:00:00.599138
1359,node-schedule/node-schedule,2, v,10,0,2,36,46,0 days 00:00:00.044090
1360,acornjs/acorn,3, walk- v,53,9,11,66,119,0 days 00:00:00.100212
1361,microsoft/reactxp,1,,1,0,0,1,2,0 days 00:00:00.484371
1362,espressif/esp-idf,1,v,13,0,11,41,54,0 days 00:00:01.950865
1363,jwtk/jjwt,1,,11,3,6,15,26,0 days 00:00:00.036231
1364,projectdiscovery/nuclei,2,v. v,10,2,6,43,53,0 days 00:00:00.216140
1365,reactphp/reactphp,1,v,7,0,4,14,21,0 days 00:00:00.069513
1366,KurtBestor/Hitomi-Downloader,1,v,17,0,1,0,17,0 days 00:00:00.019760
1367,rq/rq,2, v,24,2,15,44,68,0 days 00:00:00.093281
1368,felixse/FluentTerminal,1,,5,0,3,26,31,0 days 00:00:00.054856
1369,vector-im/element-web,1,v,27,9,9,172,199,0 days 00:00:00.764209
1370,ludwig-ai/ludwig,1,v,5,0,4,17,22,0 days 00:00:00.278563
1371,Nozbe/WatermelonDB,1,v,19,5,6,17,36,0 days 00:00:00.180231
1372,borgbackup/borg,1,,22,12,5,36,58,0 days 00:00:00.540736
1373,junit-team/junit4,1,r,8,1,6,5,13,0 days 00:00:00.123484
1374,Perfare/AssetStudio,1,v,10,0,8,13,23,0 days 00:00:00.035348
1375,chocolatey/choco,1,,5,1,2,38,43,0 days 00:00:00.175083
1376,sebastianbergmann/php-code-coverage,1,,23,2,13,138,161,0 days 00:00:00.149355
1377,cakephp/cakephp,1,,28,0,27,330,358,0 days 00:00:02.688565
1378,panjf2000/ants,1,v,9,2,2,15,24,0 days 00:00:00.037621
1379,uber/react-vis,2, v,22,10,1,77,99,0 days 00:00:00.069747
1380,myclabs/DeepCopy,1,,12,0,3,18,30,0 days 00:00:00.020800
1381,ag-grid/ag-grid,2, v,87,57,5,103,190,0 days 00:00:01.495928
1382,MahApps/MahApps.Metro,1,,21,5,11,33,54,0 days 00:00:00.282114
1383,sshuttle/sshuttle,2,v sshuttle-,29,7,6,11,40,0 days 00:00:00.059848
1384,dat-ecosystem-archive/dat,1,v,43,9,5,64,107,0 days 00:00:00.124591
1385,benoitc/gunicorn,1,,31,12,14,51,82,0 days 00:00:00.307855
1386,square/moshi,1,moshi-parent-,15,1,12,4,19,0 days 00:00:00.054788
1387,protobufjs/protobuf.js,2, v,23,7,5,55,78,0 days 00:00:00.079493
1388,agenda/agenda,2, v,20,2,8,65,85,0 days 00:00:00.177736
1389,zinclabs/zinc,1,v,2,0,1,10,12,0 days 00:00:00.018024
1390,jopohl/urh,1,v,17,6,6,74,91,0 days 00:00:00.146803
1391,ReFirmLabs/binwalk,2,python v,5,0,4,5,10,0 days 00:00:00.063490
1392,gridsome/gridsome,22,@gridsome/source-airtable@ @gridsome/source-wordpress@ @gridsome/source-graphql@ @gridsome/source-faker@ @gridsome/source-strapi@ @gridsome/source-contentful@ @gridsome/source-ghost@ @gridsome/remark-prismjs@ gridsome@ @gridsome/plugin-critical@ @gridsome/plugin-google-analytics@ @gridsome/transformer-remark@ @gridsome/source-datocms@ @gridsome/vue-remark@ @gridsome/transformer-csv@ @gridsome/transformer-yaml@ @gridsome/source-drupal@ @gridsome/source-filesystem@ v @gridsome/transformer-json@ @gridsome/plugin-sitemap@ @gridsome/cli@,7,0,0,239,246,0 days 00:00:00.150862
1393,sumatrapdfreader/sumatrapdf,1,,1,0,0,0,1,0 days 00:00:00.797669
1394,coil-kt/coil,1,,15,5,6,12,27,0 days 00:00:00.057441
1395,pre-commit/pre-commit,1,v,60,25,8,111,171,0 days 00:00:00.160691
1396,google/or-tools,1,v,32,7,8,3,35,0 days 00:00:00.581668
1397,devhubapp/devhub,2, v,55,25,3,61,116,0 days 00:00:00.180322
1398,YOURLS/YOURLS,1,,8,0,5,14,22,0 days 00:00:00.097119
1399,sogou/workflow,1,v,1,0,0,12,13,0 days 00:00:00.077271
1400,symfony/http-foundation,1,v,26,4,20,464,490,0 days 00:00:00.496180
1401,NG-ZORRO/ng-zorro-antd,1,,41,28,5,65,106,0 days 00:00:00.248803
1402,text-mask/text-mask,11, react-v ember-v vanilla-v addons-v angular1-v text-mask-v angular2-v v core-v vue-v,55,0,0,245,300,0 days 00:00:00.144071
1403,dropwizard/dropwizard,1,v,15,1,11,119,134,0 days 00:00:00.687943
1404,apache/tvm,1,v,7,0,6,1,8,0 days 00:00:00.374353
1405,facebook/buck,1,v,0,0,0,61,61,0 days 00:00:01.369961
1406,lima-vm/lima,1,v,11,6,1,16,27,0 days 00:00:00.069940
1407,sass/node-sass,4, RELEASE- napi_ v,45,7,15,114,159,0 days 00:00:00.476781
1408,tidwall/tile38,1,,27,6,7,59,86,0 days 00:00:00.174661
1409,rawgraphs/rawgraphs-app,3, v. v,3,0,2,5,8,0 days 00:00:00.032320
1410,Shopify/toxiproxy,1,v,8,0,3,11,19,0 days 00:00:00.037324
1411,gitpod-io/gitpod,4, poolkeeper-v production_ v,10,4,2,5,15,0 days 00:00:00.197609
1412,BuilderIO/partytown,1,v,6,4,0,54,60,0 days 00:00:00.176187
1413,bloomrpc/bloomrpc,2, v,6,0,3,9,15,0 days 00:00:00.016008
1414,googleapis/google-api-php-client,2, v,13,0,1,32,45,0 days 00:00:00.096732
1415,goplus/gop,1,v,5,0,3,91,96,0 days 00:00:00.147955
1416,ninja-build/ninja,2,release- v,14,1,10,12,26,0 days 00:00:00.144208
1417,alibaba/atlas,2, v,4,1,0,14,18,0 days 00:00:00.061824
1418,hediet/vscode-drawio,1,v,10,4,2,13,23,0 days 00:00:00.027145
1419,OpenFeign/feign,3, release- v,72,12,8,54,126,0 days 00:00:00.192515
1420,mawww/kakoune,1,v,1,0,0,13,14,0 days 00:00:00.368744
1421,olivernn/lunr.js,1,v,12,1,3,46,58,0 days 00:00:00.037466
1422,foliojs/pdfkit,1,v,8,0,6,12,20,0 days 00:00:00.039802
1423,symfony/event-dispatcher,1,v,26,4,17,436,462,0 days 00:00:00.445522
1424,knadh/listmonk,1,v,4,1,2,0,4,0 days 00:00:00.154972
1425,maurosoria/dirsearch,1,v,2,0,1,12,14,0 days 00:00:00.094418
1426,VulcanJS/Vulcan,2, v,22,10,6,45,67,0 days 00:00:00.356665
1427,microsoft/react-native-code-push,2, v,11,0,3,20,31,0 days 00:00:00.210554
1428,microsoft/pyright,1,,2,0,1,328,330,0 days 00:00:00.363157
1429,resilience4j/resilience4j,3, v. v,22,4,8,15,37,0 days 00:00:00.074644
1430,MetaMask/metamask-extension,5, Version- Version v v.,82,62,4,239,321,0 days 00:00:00.989474
1431,amitshekhariitbhu/Android-Debug-Database,1,v,6,2,0,6,12,0 days 00:00:00.026435
1432,paragonie/random_compat,2, v,7,0,0,54,61,0 days 00:00:00.035356
1433,PaddlePaddle/PaddleHub,2, v,12,2,1,10,22,0 days 00:00:00.090304
1434,Koenkk/zigbee2mqtt,1,,28,16,5,33,61,0 days 00:00:00.207150
1435,openshift/origin,1,v,14,1,10,25,39,0 days 00:00:01.725150
1436,happyfish100/fastdfs,1,V,16,5,4,0,16,0 days 00:00:00.023334
1437,graphql/graphql-playground,9, graphql-playground-middleware-hapi@ graphql-playground-middleware-lambda@ graphql-playground-middleware-express@ graphql-playground-react@ graphql-playground-html@ v graphql-playground-middleware-koa@ graphql-playground-electron@,9,4,0,92,101,0 days 00:00:00.080764
1438,electron/electron-packager,1,v,53,9,6,42,95,0 days 00:00:00.100811
1439,square/okio,3, parent- okio-parent-,36,10,11,13,49,0 days 00:00:00.082265
1440,OpenIMSDK/Open-IM-Server,1,v,3,1,1,15,18,0 days 00:00:00.094463
1441,abpframework/abp,2, v,43,31,3,60,103,0 days 00:00:01.317890
1442,rofl0r/proxychains-ng,1,v,16,0,10,1,17,0 days 00:00:00.023518
1443,pypa/pip,1,,36,2,27,73,109,0 days 00:00:00.680163
1444,shwenzhang/AndResGuard,1,,3,0,0,35,38,0 days 00:00:00.032606
1445,jbogard/MediatR,1,v,12,0,7,6,18,0 days 00:00:00.029044
1446,keybase/client,2, v,29,21,4,65,94,0 days 00:00:02.037272
1447,symfony/finder,1,v,26,4,16,440,466,0 days 00:00:00.441687
1448,sockjs/sockjs-client,1,v,11,0,7,20,31,0 days 00:00:00.054526
1449,dotnet/machinelearning,1,v,18,12,4,5,23,0 days 00:00:00.235727
1450,Stuk/jszip,1,v,19,5,7,14,33,0 days 00:00:00.052342
1451,VowpalWabbit/vowpal_wabbit,3, r_l.snapshot. v,33,2,22,10,43,0 days 00:00:00.531760
1452,gwuhaolin/livego,1,,0,0,0,13,13,0 days 00:00:00.016448
1453,sahat/satellizer,1,,14,7,4,41,55,0 days 00:00:00.104264
1454,apache/dolphinscheduler,1,,5,0,4,19,24,0 days 00:00:00.679406
1455,szimek/signature_pad,1,v,11,0,2,19,30,0 days 00:00:00.026889
1456,rematch/rematch,8, @rematch/select@ @rematch/updated@ @rematch/persist@ @rematch/loading@ @rematch/typed-state@ @rematch/core@ @rematch/immer@,16,3,6,46,62,0 days 00:00:00.114423
1457,smicallef/spiderfoot,1,v,8,1,6,1,9,0 days 00:00:00.155975
1458,ng-bootstrap/ng-bootstrap,1,,27,12,6,49,76,0 days 00:00:00.210415
1459,airbnb/epoxy,1,,41,4,4,22,63,0 days 00:00:00.041793
1460,ChrisRM/material-theme-jetbrains,2, v,83,42,1,163,246,0 days 00:00:00.218258
1461,firefly-iii/firefly-iii,1,,41,18,8,201,242,0 days 00:00:01.123079
1462,dexie/Dexie.js,1,v,9,0,8,24,33,0 days 00:00:00.278524
1463,arrow-py/arrow,1,,17,1,11,37,54,0 days 00:00:00.081304
1464,doitsujin/dxvk,1,v,40,30,5,32,72,0 days 00:00:00.223238
1465,PostHog/posthog,1,,37,32,0,25,62,0 days 00:00:00.536665
1466,adrai/flowchart.js,1,v,17,0,1,31,48,0 days 00:00:00.023743
1467,grommet/grommet,2, v,41,18,7,76,117,0 days 00:00:00.538678
1468,Jguer/yay,1,v,49,19,9,26,75,0 days 00:00:00.121446
1469,Pikaday/Pikaday,1,,9,1,6,6,15,0 days 00:00:00.029797
1470,JustArchiNET/ArchiSteamFarm,1,,167,83,9,431,598,0 days 00:00:00.935740
1471,hs-web/hsweb-framework,3, V v,3,0,2,12,15,0 days 00:00:00.111203
1472,coturn/coturn,2,upstream/ ,13,0,5,43,56,0 days 00:00:00.066221
1473,qutebrowser/qutebrowser,1,v,32,4,16,49,81,0 days 00:00:01.253768
1474,mediaelement/mediaelement,1,,32,8,11,117,149,0 days 00:00:00.220285
1475,tiangolo/typer,1,,4,0,1,15,19,0 days 00:00:00.021138
1476,hackmdio/codimd,2, v,10,0,7,16,26,0 days 00:00:00.150824
1477,mjmlio/mjml,3, V v,25,8,10,50,75,0 days 00:00:00.142527
1478,reduxjs/redux-toolkit,3, @rtk-query/graphql-request-base-query@ v,19,4,6,38,57,0 days 00:00:00.214823
1479,huggingface/datasets,1,,26,21,1,26,52,0 days 00:00:00.152538
1480,wtfutil/wtf,2, v,41,25,1,26,67,0 days 00:00:00.145050
1481,scylladb/scylla,1,scylla-,33,11,10,130,163,0 days 00:00:01.932470
1482,d2l-ai/d2l-en,1,v,8,1,4,17,25,0 days 00:00:00.396426
1483,google/cadvisor,2, v,45,19,15,71,116,0 days 00:00:00.177178
1484,ArchiveBox/ArchiveBox,1,v,3,0,2,24,27,0 days 00:00:00.131088
1485,justauth/JustAuth,3, v. v,14,5,1,25,39,0 days 00:00:00.038109
1486,zalmoxisus/redux-devtools-extension,2, v,27,15,2,43,70,0 days 00:00:00.058664
1487,openzfs/zfs,1,zfs-,6,0,5,60,66,0 days 00:00:01.978944
1488,grpc-ecosystem/grpc-gateway,1,v,28,7,7,43,71,0 days 00:00:00.107892
1489,fabric/fabric,1,,26,4,18,97,123,0 days 00:00:00.343854
1490,automerge/automerge,1,v,13,3,6,20,33,0 days 00:00:00.040787
1491,verdaccio/verdaccio,1,v,64,21,8,148,212,0 days 00:00:00.420283
1492,MithrilJS/mithril.js,3,ospec-v ospec_v v,7,2,3,55,62,0 days 00:00:00.184967
1493,simple-icons/simple-icons,2, v,116,86,0,27,143,0 days 00:00:00.476106
1494,Tencent/APIJSON,1,,37,18,7,51,88,0 days 00:00:00.150928
1495,powerline/powerline,1,,13,3,7,10,23,0 days 00:00:00.142014
1496,orhanobut/logger,2, v,13,1,3,1,14,0 days 00:00:00.014993
1497,android-hacker/VirtualXposed,2, v,12,0,2,55,67,0 days 00:00:00.115076
1498,authelia/authelia,1,v,55,33,5,114,169,0 days 00:00:00.208927
1499,getgrav/grav,1,,13,3,8,170,183,0 days 00:00:00.528471
1500,shelljs/shelljs,1,v,6,0,4,33,39,0 days 00:00:00.047978
1501,apache/incubator-brpc,2, v,3,0,2,3,6,0 days 00:00:00.121176
1502,openjdk/jdk,0,,0,0,0,0,0,0 days 00:00:00.167723
1503,woocommerce/woocommerce,3, @woocommerce/e2e-environment@ v,50,28,17,349,399,0 days 00:00:03.462904
1504,microsoft/recommenders,1,,9,0,7,2,11,0 days 00:00:00.484151
1505,Budibase/budibase,1,v,10,5,2,479,489,0 days 00:00:01.376115
1506,RaRe-Technologies/gensim,1,,23,6,11,36,59,0 days 00:00:00.331092
1507,liabru/matter-js,1,,10,1,6,8,18,0 days 00:00:00.039515
1508,microsoft/AirSim,2,v. v,3,1,1,15,18,0 days 00:00:00.079352
1509,python/mypy,1,v,59,22,8,7,66,0 days 00:00:00.809741
1510,timescale/timescaledb,1,,28,7,8,33,61,0 days 00:00:00.240997
1511,MarlinFirmware/Marlin,1,,2,0,1,37,39,0 days 00:00:01.045059
1512,remotion-dev/remotion,1,v,14,8,1,81,95,0 days 00:00:00.536140
1513,aws-amplify/amplify-js,31, @aws-amplify/pubsub@ aws-amplify-vue@ @aws-amplify/analytics@ amazon-cognito-identity-js@ aws-amplify@ @aws-amplify/xr@ aws-amplify-react-native@ @aws-amplify/storage@ aws-amplify-angular@ @aws-amplify/cache@ @aws-amplify/api@ aws-amplify-react-naitve@ @aws-amplify/ui@ @aws-amplify/ui-angular@ @aws-amplify/ui-vue@ @aws-amplify/ui-react@ @aws-amplify/pushnotification@ @aws-amplify/core@ @aws-amplify/api-graphql@ @aws-amplify/ui-components@ @aws-amplify/geo@ aws-amplify-react@ @aws-amplify/predictions@ @aws-amplify/datastore@ @aws-amplify/datastore-storage-adapter@ @aws-amplify/api-rest@ @aws-amplify/interactions@ @aws-amplify/ui-storybook@ v @aws-amplify/auth@,54,0,0,3284,3338,0 days 00:00:15.545703
1514,ahmetb/kubectx,1,v,9,1,1,11,20,0 days 00:00:00.022596
1515,flipped-aurora/gin-vue-admin,3,V v. v,7,2,2,21,28,0 days 00:00:00.107051
1516,mdx-js/mdx,2, v,26,8,2,140,166,0 days 00:00:00.174226
1517,txthinking/brook,1,v,43,9,4,0,43,0 days 00:00:00.050671
1518,keepassxreboot/keepassxc,1,,8,0,7,29,37,0 days 00:00:00.211915
1519,Konloch/bytecode-viewer,5, v b b. B,17,1,1,41,58,0 days 00:00:00.078901
1520,pavlobu/deskreen,1,v,1,0,0,12,13,0 days 00:00:00.018380
1521,the1812/Bilibili-Evolved,1,v,7,0,6,74,81,0 days 00:00:00.499480
1522,brix/crypto-js,2, release-,4,0,1,10,14,0 days 00:00:00.018251
1523,eclipse-vertx/vert.x,4, v Eclipse_Initial_Contribution_ _old/v,18,0,15,57,75,0 days 00:00:00.453037
1524,microsoft/WSL,1,,2,0,0,9,11,0 days 00:00:00.015260
1525,modood/Administrative-divisions-of-China,1,,9,0,2,7,16,0 days 00:00:00.015832
1526,mockito/mockito,1,v,58,16,6,409,467,0 days 00:00:00.534798
1527,xtermjs/xterm.js,1,,76,29,6,35,111,0 days 00:00:00.477956
1528,Unity-Technologies/ml-agents,5, release_ python-packages_ com.unity.ml-agents_ v,57,15,6,33,90,0 days 00:00:00.222038
1529,termux/termux-app,1,v,89,20,7,0,89,0 days 00:00:00.080531
1530,redwoodjs/redwood,2, v,57,51,1,71,128,0 days 00:00:00.476496
1531,xtaci/kcptun,2, v,106,19,0,0,106,0 days 00:00:00.065544
1532,jsdoc/jsdoc,11, @jsdoc/eslint-config@ @jsdoc/parse@ @jsdoc/prettier-config@ @jsdoc/cli@ @jsdoc/task-runner@ @jsdoc/util@ @jsdoc/test-matchers@ v @jsdoc/tag@ @jsdoc/core@,12,0,6,99,111,0 days 00:00:00.144769
1533,arduino/Arduino,1,,26,3,12,46,72,0 days 00:00:00.440053
1534,bcicen/ctop,2, v,5,2,2,11,16,0 days 00:00:00.035737
1535,selectize/selectize.js,1,v,12,1,2,64,76,0 days 00:00:00.061677
1536,WerWolv/ImHex,1,v,19,14,2,12,31,0 days 00:00:00.070408
1537,GoogleContainerTools/skaffold,1,v,80,76,0,29,109,0 days 00:00:00.555597
1538,gionkunz/chartist-js,1,v,11,5,4,47,58,0 days 00:00:00.053941
1539,wechaty/wechaty,1,v,15,4,7,8,23,0 days 00:00:00.373346
1540,ether/etherpad-lite,1,,8,0,7,50,58,0 days 00:00:00.461033
1541,http-party/node-http-proxy,2, v,27,4,8,70,97,0 days 00:00:00.082700
1542,filp/whoops,1,,18,1,5,50,68,0 days 00:00:00.072397
1543,kubernetes/ingress-nginx,6, controller- controller-v helm-chart- nginx- ingress-nginx-,100,43,4,75,175,0 days 00:00:00.389974
1544,Semantic-Org/Semantic-UI-React,1,v,93,32,5,211,304,0 days 00:00:00.285664
1545,reduxjs/redux-devtools,48,d3-state-visualizer-tree-example@ slider-todomvc@ @redux-devtools/inspector-monitor-trace-tab@ react-dock@ @redux-devtools/cli@ @redux-devtools/rtk-query-monitor@ @redux-devtools/inspector-monitor-test-tab@ @redux-devtools/remote@ redux-devtools-inspector@ @redux-devtools/log-monitor@ inspector-demo@ redux-devtools-chart-monitor@ react-json-tree@ @redux-devtools/app@ test-demo@ @redux-devtools/slider-monitor@ @redux-devtools/inspector-monitor@ @redux-devtools/utils@ redux-devtools-test-generator@ remotedev-serialize@ @redux-devtools/dock-monitor@ react-base16-styling@ rtk-query-demo@ d3tooltip@ react-json-tree-example@ @redux-devtools/chart-monitor@ counter-redux@ react-json-tree-testing@ redux-devtools@ redux-devtools-testing@ redux-devtools-extension@ todomvc@ @redux-devtools/ui@ redux-devtools-dock-monitor@ map2tree@ remotedev-redux-devtools-extension@ extension@ redux-devtools-trace-monitor@ redux-devtools-instrument@ @redux-devtools/serialize@ @redux-devtools/extension@ d3-state-visualizer@ redux-devtools-serialize@ @redux-devtools/core@ react-dock-demo@ @redux-devtools/instrument@ v redux-devtools-log-monitor@,41,3,3,260,301,0 days 00:00:00.296960
1546,nrwl/nx,1,,75,59,0,218,293,0 days 00:00:00.541123
1547,google/gvisor,1,release-,99,89,1,0,99,0 days 00:00:00.353350
1548,DIYgod/DPlayer,2, v,21,2,4,21,42,0 days 00:00:00.064959
1549,Foundry376/Mailspring,1,,11,1,6,43,54,0 days 00:00:00.474819
1550,you-dont-need/You-Dont-Need-Momentjs,1,v,6,0,2,5,11,0 days 00:00:00.018529
1551,CachetHQ/Cachet,1,v,7,1,2,30,37,0 days 00:00:00.325503
1552,formatjs/formatjs,37,@formatjs/vue-intl@ vue-intl@ @formatjs/ts-transformer@ @formatjs/intl-getcanonicallocales@ @formatjs/intl@ babel-plugin-formatjs@ @formatjs/icu-messageformat-parser@ @formatjs/intl-utils@ @formatjs/ecma376@ formatjs-extract-cldr-data@ @formatjs/macro@ eslint-plugin-formatjs@ @formatjs/ecma402-abstract@ @formatjs/intl-relativetimeformat@ @formatjs/intl-listformat@ formatjs-website@ website@ @formatjs/editor@ @formatjs/intl-localematcher@ @formatjs/intl-datetimeformat@ @formatjs/intl-pluralrules@ @formatjs/fast-memoize@ @formatjs/cli@ @formatjs/icu-skeleton-parser@ intl-messageformat-parser@ @formatjs/intl-numberformat@ babel-plugin-react-intl@ @formatjs/intl-unified-numberformat@ @formatjs/intl-displaynames@ intl-format-cache@ intl-locales-supported@ intl-messageformat@ react-intl@ @formatjs/intl-locale@ v @formatjs/ecma-376@ @formatjs/swc-plugin@,130,5,6,2030,2160,0 days 00:00:05.720762
1553,flarum/flarum,1,v,3,0,0,0,3,0 days 00:00:00.027406
1554,dutchcoders/transfer.sh,1,v,5,0,4,13,18,0 days 00:00:00.040769
1555,rwaldron/johnny-five,2, v,14,1,4,73,87,0 days 00:00:00.175828
1556,umijs/qiankun,1,v,14,0,2,92,106,0 days 00:00:00.066910
1557,NodeBB/NodeBB,1,v,30,2,17,93,123,0 days 00:00:01.189167
1558,faressoft/terminalizer,1,v,6,1,0,25,31,0 days 00:00:00.018496
1559,Intervention/image,1,,15,0,3,93,108,0 days 00:00:00.179080
1560,redux-form/redux-form,1,v,46,11,7,141,187,0 days 00:00:00.140583
1561,revel/revel,1,v,18,4,10,7,25,0 days 00:00:00.074752
1562,BrainJS/brain.js,1,,4,0,1,16,20,0 days 00:00:00.033728
1563,ory/hydra,3, sdk/go/hydra/v v,20,5,6,126,146,0 days 00:00:00.173530
1564,pulumi/pulumi,3,pkg/v sdk/v v,90,81,2,393,483,0 days 00:00:00.716615
1565,aleju/imgaug,1,,3,0,2,9,12,0 days 00:00:00.116394
1566,adonisjs/core,3,@adonisjs/framework@v @adonisjs/framework@ v,24,3,6,139,163,0 days 00:00:00.224774
1567,onnx/onnx,1,v,13,1,10,9,22,0 days 00:00:00.101820
1568,google/yapf,2,yapf-v v,31,10,8,34,65,0 days 00:00:00.063923
1569,apache/hadoop,3,release- rel/submarine- rel/release-,39,1,14,92,131,0 days 00:00:03.138413
1570,charmbracelet/bubbletea,1,v,20,4,3,27,47,0 days 00:00:00.040635
1571,uxsolutions/bootstrap-datepicker,2, v,10,0,8,13,23,0 days 00:00:00.076758
1572,facebook/stetho,1,v,7,0,5,6,13,0 days 00:00:00.034527
1573,moment/luxon,1,,37,2,4,69,106,0 days 00:00:00.071147
1574,showdownjs/showdown,2, v,14,3,5,42,56,0 days 00:00:00.046833
1575,pqina/filepond,1,,52,7,0,143,195,0 days 00:00:00.091901
1576,thephpleague/flysystem,1,,13,2,4,175,188,0 days 00:00:00.164142
1577,eclipse/deeplearning4j,2,_old/deeplearning4j- _old/deeplearning4j-parent-,9,1,3,16,25,0 days 00:00:00.953844
1578,CodisLabs/codis,1,,3,0,2,33,36,0 days 00:00:00.253694
1579,psf/requests-html,1,v,8,3,1,22,30,0 days 00:00:00.027564
1580,horovod/horovod,1,v,16,1,8,53,69,0 days 00:00:00.073835
1581,myliang/x-spreadsheet,1,v,1,0,0,26,27,0 days 00:00:00.030776
1582,signalapp/Signal-Desktop,2,c v,124,93,3,169,293,0 days 00:00:00.603225
1583,apollographql/apollo-server,36,apollo-server@ apollo-federation-integration-testsuite@ apollo-reporting-protobuf@ apollo-server-micro@ apollo-server-caching@ publish/ apollo-server-lambda@ apollo-server-koa@ @apollo/federation@ apollo-server-hapi@ apollo-graphql@ apollo-server-env@ graphql-extensions@ apollo-server-types@ apollo-cache-control@ apollo-server-fastify@ apollo-server-testing@ apollo-server-cache-memcached@ apollo-datasource-rest@ apollo-server-cache-redis@ apollo-server-cloud-functions@ @apollo/gateway@ apollo-engine-reporting@ apollo-tracing@ apollo-server-plugin-base@ apollo-server-cloudflare@ apollo-server-plugin-operation-registry@ apollo-server-express@ apollo-server-integration-testsuite@ apollo-server-plugin-response-cache@ apollo-server-errors@ v apollo-datasource@ apollo-server-azure-functions@ apollo-engine-reporting-protobuf@ apollo-server-core@,247,47,1,2316,2563,0 days 00:00:08.943255
1584,aio-libs/aiohttp,4, v. 4v v,38,13,9,124,162,0 days 00:00:00.555131
1585,aws/aws-cli,1,,46,18,9,1642,1688,0 days 00:00:03.689193
1586,saltstack/salt,2,old-branch- v,62,15,19,151,213,0 days 00:00:06.623700
1587,openstf/stf,1,v,12,1,7,16,28,0 days 00:00:00.109468
1588,bvaughn/react-window,1,,4,1,1,16,20,0 days 00:00:00.028608
1589,OptimalBits/bull,2, v,49,7,10,84,133,0 days 00:00:00.298060
1590,keycloak/keycloak,1,,16,2,7,21,37,0 days 00:00:00.761266
1591,google/tink,3,go/v go/integration/hcvault/v v,7,0,6,9,16,0 days 00:00:00.183022
1592,josdejong/mathjs,1,v,109,64,2,118,227,0 days 00:00:00.408471
1593,umijs/umi,37,umi-library@ umi-ui@ umi-server@ umi-plugin-yunfengdie@ umi-utils@ umi-plugin-hd@ umi-plugin-locale@ umi-ui-theme@ umi-build-dev@ umi-core@ umi-plugin-polyfills@ umi-router@ umi-plugin-auto-externals@ eslint-config-umi@ umi-plugin-dva@ umi@ af-webpack@ umi-plugin-react@ umi-plugin-prerender@ umi-plugin-routes@ umi% umi-plugin-datahub@ umi-plugin-modern-mode@ umi-serve@ umi-plugin-es5-imcompatible-versions@ umi-plugin@ umi-plugin-polyfill@ umi-ui-tasks@ umi-types@ umi-test@ umi-plugin-ui@ umi-plugin-dll@ babel-preset-umi@ umi-mock@ @umijs/plugin-prerender@ v umi-buildAndDev@,62,4,4,1402,1464,0 days 00:00:03.020752
1594,pyecharts/pyecharts,1,v,14,3,5,29,43,0 days 00:00:00.134835
1595,barryvdh/laravel-ide-helper,1,v,25,1,11,61,86,0 days 00:00:00.065944
1596,kovidgoyal/calibre,2, v,252,251,0,57,309,0 days 00:00:02.494309
1597,MaterialDesignInXAML/MaterialDesignInXamlToolkit,2, v,21,5,12,12,33,0 days 00:00:00.334370
1598,uuidjs/uuid,1,v,16,4,6,21,37,0 days 00:00:00.036218
1599,surmon-china/vue-awesome-swiper,2, v,14,0,1,36,50,0 days 00:00:00.028433
1600,qmk/qmk_firmware,10, breakpoint_ drop- ergodox_ez- planck- preonic- gh60- LUFA- planck-light- v,29,0,14,1440,1469,0 days 00:00:03.926169
1601,zhihu/Matisse,1,v,0,0,0,3,3,0 days 00:00:00.017391
1602,go-sql-driver/mysql,2,beta v,10,2,6,8,18,0 days 00:00:00.051568
1603,tensorflow/tensor2tensor,3, v. v,15,5,4,61,76,0 days 00:00:00.399957
1604,gunthercox/ChatterBot,1,,10,0,9,65,75,0 days 00:00:00.099416
1605,GoogleCloudPlatform/microservices-demo,1,v,3,0,2,16,19,0 days 00:00:00.046005
1606,danilowoz/react-content-loader,2, v,16,0,3,27,43,0 days 00:00:00.027518
1607,liriliri/eruda,1,v,15,2,5,40,55,0 days 00:00:00.048062
1608,OpenAPITools/openapi-generator,2, v,16,2,11,38,54,0 days 00:00:00.982266
1609,antlr/antlr4,3, antlr4-master- v,11,1,9,15,26,0 days 00:00:00.528496
1610,gaearon/react-hot-loader,2, v,25,7,4,107,132,0 days 00:00:00.241124
1611,pandao/editor.md,1,v,6,0,0,14,20,0 days 00:00:00.012555
1612,linnovate/mean,2, v,4,0,3,9,13,0 days 00:00:00.113206
1613,gruntjs/grunt,1,v,7,0,2,14,21,0 days 00:00:00.102498
1614,pinpoint-apm/pinpoint,2, v,9,0,7,25,34,0 days 00:00:00.775388
1615,wkhtmltopdf/wkhtmltopdf,1,,8,1,1,31,39,0 days 00:00:00.054972
1616,11ty/eleventy,1,v,13,2,6,41,54,0 days 00:00:00.084103
1617,systemjs/systemjs,2, v,40,8,3,187,227,0 days 00:00:00.154884
1618,wagtail/wagtail,3,caltech-upgrade-point- ads- v,40,6,13,99,139,0 days 00:00:00.898453
1619,aquasecurity/trivy,1,v,28,13,2,59,87,0 days 00:00:00.203380
1620,rt2zz/redux-persist,1,v,36,4,4,76,112,0 days 00:00:00.059118
1621,withastro/astro,31,@astrojs/test-static-build-pkg@ @astrojs/markdown-support@ @astrojs/solid-js@ @astrojs/vercel@ create-astro@ @astrojs/preact@ @astrojs/netlify@ @astrojs/markdown-remark@ @astrojs/sitemap@ @astrojs/webapi@ @astrojs/renderer-solid@ @astrojs/react@ @astrojs/svelte@ @astrojs/turbolinks@ @astrojs/renderer-react@ @astrojs/renderer-preact@ @astrojs/deno@ @astrojs/node@ @astrojs/partytown@ @astrojs/renderer-svelte@ astro@ @astrojs/prism@ @astrojs/renderer-lit@ @astrojs/lit@ @astrojs/telemetry@ @astrojs/tailwind@ @astrojs/rss@ @astrojs/renderer-vue@ @astrojs/vue@ v @astrojs/parser@,20,0,0,248,268,0 days 00:00:00.236017
1622,arangodb/arangodb,3, documentation- v,31,3,18,319,350,0 days 00:00:03.752822
1623,electron-userland/electron-builder,5, docker@ electron-updater-v electron-updater@ v,320,17,4,434,754,0 days 00:00:00.677780
1624,mishoo/UglifyJS,2,harmony-v v,25,3,11,306,331,0 days 00:00:00.420223
1625,visionmedia/supertest,2, v,29,2,9,29,58,0 days 00:00:00.036151
1626,lra/mackup,1,,8,4,3,53,61,0 days 00:00:00.099418
1627,cilium/cilium,2, v,17,0,7,287,304,0 days 00:00:01.488589
1628,Automattic/wp-calypso,23,@automattic/social-previews@ @automattic/eslint-plugin-wpcalypso@ @automattic/webpack-rtl-plugin@ desktop-v @automattic/babel-plugin-i18n-calypso@ @automattic/interpolate-components@ calypso- @automattic/effective-module-tree@ eslint-plugin-wpcalypso@ @automattic/calypso-babel-config@ @automattic/tree-select@ i18n-calypso@ @automattic/babel-plugin-transform-wpcalypso-async@ wp-calypso@ @automattic/explat-client-react-helpers@ @automattic/popup-monitor@ @automattic/explat-client@ desktop- @automattic/data-stores@ @automattic/jetpack-blocks@ desktop/ v @automattic/format-currency@,139,32,13,47,186,0 days 00:00:02.961656
1629,mattboldt/typed.js,1,v,3,0,2,19,22,0 days 00:00:00.025085
1630,oliver-moran/jimp,2, v,15,2,2,71,86,0 days 00:00:00.055801
1631,casbin/casbin,1,v,68,10,5,118,186,0 days 00:00:00.254058
1632,tabler/tabler-icons,1,v,69,30,1,15,84,0 days 00:00:00.057433
1633,ish-app/ish,3,builds/iostestflight/ builds/beta/ builds/,318,42,2,0,318,0 days 00:00:00.234618
1634,sivel/speedtest-cli,1,v,5,0,4,24,29,0 days 00:00:00.022387
1635,foambubble/foam,1,v,17,8,2,44,61,0 days 00:00:00.053251
1636,mlflow/mlflow,2, v,35,21,1,20,55,0 days 00:00:00.177491
1637,android/compose-samples,3,github/dev dev v,5,1,1,8,13,0 days 00:00:00.082137
1638,arut/nginx-rtmp-module,1,v,12,2,0,100,112,0 days 00:00:00.063868
1639,Netflix/zuul,2,zuul- v,9,0,6,43,52,0 days 00:00:00.069915
1640,qax-os/excelize,1,v,11,0,10,6,17,0 days 00:00:00.052220
1641,Miserlou/Zappa,2, v,50,30,3,71,121,0 days 00:00:00.143494
1642,calcom/cal.com,3,v. V v,7,4,0,3,10,0 days 00:00:00.266212
1643,Delgan/loguru,1,,6,0,4,12,18,0 days 00:00:00.031355
1644,react-dates/react-dates,1,v,78,43,1,81,159,0 days 00:00:00.115563
1645,trufflesuite/truffle,92, truffle-external-compile@ @truffle/contract-schema@ @truffle/box@ @truffle/preserve-to-filecoin@ truffle-debug-utils@ @truffle/plugins@ truffle-decode-utils@ @truffle/require@ @truffle/events@ truffle-solidity-loader@ truffle-config@ @truffle/codec@ truffle-compile@ truffle-blockchain-utils@ truffle-core@ truffle-provider@ truffle-contract-sources@ truffle-solidity-utils@ @truffle/decode-utils@ @truffle/contract-sources@ truffle-workflow-compile@ truffle-deployer@ truffle-sawtooth-seth-provider@ @truffle/db-kit@ @truffle/preserve-to-buckets@ @truffle/dashboard@ @truffle/core@ truffle-error@ truffle-require@ @truffle/hdwallet-provider@ @truffle/spinners@ @truffle/deployer@ @truffle/encoder@ truffle-hdwallet-provider@ @truffle/compile-vyper@ @truffle/solidity-utils@ truffle-provisioner@ @truffle/fetch-and-compile@ @truffle/compile-solidity@ @truffle/migrate@ @truffle/reporters@ @truffle/expect@ @truffle/debugger@ truffle-resolver@ truffle-interface-adapter@ truffle-reporters@ @truffle/blockchain-utils@ truffle-debugger@ @truffle/code-utils@ @truffle/workflow-compile@ @truffle/compile-common@ truffle-contract@ @truffle/preserve@ @truffle/provisioner@ truffle@ @truffle/external-compile@ @truffle/contract-tests@ truffle-artifactor@ truffle-contract-schema@ truffle-compile-vyper@ @truffle/abi-utils@ @truffle/profiler@ truffle-migrate@ v. @truffle/source-map-utils@ @truffle/dashboard-message-bus@ @truffle/config@ @truffle/decoder@ @truffle/error@ @truffle/resolver@ @truffle/contract@ @truffle/source-fetcher@ @truffle/db-loader@ @truffle/interface-adapter@ @truffle/dashboard-provider@ @truffle/solidity-loader@ @truffle/sawtooth-seth-provider@ @truffle/environment@ truffle-decoder@ truffle-box@ truffle-environment@ @truffle/db@ truffle-legacy-system@ truffle-code-utils@ @truffle/provider@ @truffle/preserve-fs@ @truffle/artifactor@ @truffle/preserve-to-ipfs@ v @truffle/debug-utils@ truffle-expect@,58,0,8,4135,4193,0 days 00:00:26.221666
1646,GoogleContainerTools/jib,1,v,2,0,1,7,9,0 days 00:00:00.040590
1647,carloscuesta/gitmoji,1,v,13,4,2,5,18,0 days 00:00:00.036162
1648,gravitational/teleport,3, teleport-connect-preview- v,35,13,7,277,312,0 days 00:00:00.909571
1649,memcached/memcached,1,,4,0,2,86,90,0 days 00:00:00.348795
1650,roots/sage,2, v,27,7,10,35,62,0 days 00:00:00.114700
1651,webpack-contrib/webpack-bundle-analyzer,1,v,32,6,6,34,66,0 days 00:00:00.041081
1652,http-party/http-server,2, v,15,1,7,30,45,0 days 00:00:00.213988
1653,BrowserSync/browser-sync,3, v2-rc v,45,10,3,184,229,0 days 00:00:00.159045
1654,apache/druid,1,druid-,18,1,13,366,384,0 days 00:00:00.826744
1655,aurelia/framework,1,,23,2,5,32,55,0 days 00:00:00.048307
1656,jaredreich/pell,1,v,6,1,1,6,12,0 days 00:00:00.012591
1657,Tonejs/Tone.js,2, r,12,1,8,4,16,0 days 00:00:00.190670
1658,Tamsiree/RxTool,2, v,15,1,1,177,192,0 days 00:00:00.084014
1659,pytorch/vision,2,ciflow/default/ v,16,2,9,18,34,0 days 00:00:00.315184
1660,karma-runner/karma,2, v,35,8,10,198,233,0 days 00:00:00.296097
1661,FaridSafi/react-native-gifted-chat,2, v,16,1,6,46,62,0 days 00:00:00.063616
1662,rrweb-io/rrweb,5, rrweb-snapshot@ rrweb@ rrdom@ rrweb-player@,6,0,2,92,98,0 days 00:00:00.064908
1663,ramsey/uuid,1,,26,4,12,37,63,0 days 00:00:00.063480
1664,thingsboard/thingsboard,1,v,15,2,7,33,48,0 days 00:00:00.387674
1665,flairNLP/flair,1,v,11,1,6,12,23,0 days 00:00:00.192755
1666,typescript-eslint/typescript-eslint,2, v,122,84,0,50,172,0 days 00:00:00.286990
1667,ben-manes/caffeine,2, v,16,3,6,45,61,0 days 00:00:00.174749
1668,segmentio/evergreen,1,v,51,7,1,84,135,0 days 00:00:00.083631
1669,medusajs/medusa,40,medusa-payment-manual@ medusa-interfaces@ medusa-plugin-economic@ medusa-file-spaces@ @medusajs/medusa-cli@ medusa-plugin-discount-generator@ medusa-file-s3@ medusa-plugin-segment@ medusa-plugin-twilio-sms@ medusa-plugin-contentful@ medusa-plugin-slack-notification@ medusa-plugin-sendgrid@ medusa-telemetry@ medusa-payment-klarna@ medusa-plugin-meilisearch@ medusa-source-shopify@ create-medusa-app@ medusa-plugin-restock-notification@ gatsby-source-medusa@ medusa-payment-adyen@ medusa-file-minio@ medusa-plugin-ip-lookup@ babel-preset-medusa-package@ medusa-payment-paypal@ medusa-plugin-algolia@ medusa-plugin-mailchimp@ medusa-core-utils@ medusa-fulfillment-manual@ medusa-react@ medusa-plugin-add-ons@ medusa-plugin-wishlist@ medusa-plugin-permissions@ @medusajs/medusa@ @medusajs/medusa-js@ medusa-dev-cli@ medusa-payment-stripe@ medusa-test-utils@ medusa-plugin-brightpearl@ v medusa-fulfillment-webshipper@,7,0,1,1308,1315,0 days 00:00:01.709864
1670,AdguardTeam/AdGuardHome,1,v,19,6,4,31,50,0 days 00:00:00.146946
1671,ranger/ranger,1,v,10,0,8,31,41,0 days 00:00:00.300492
1672,lit/lit,20, @lit-labs/task@ @lit-labs/ssr-client@ @lit/localize-tools@ @lit/reactive-element@ @lit-labs/eleventy-plugin-lit@ @lit-labs/scoped-registry-mixin@ @lit-labs/ssr@ @lit-labs/motion@ lit-html@ @lit-labs/analyzer@ @lit-labs/router@ @lit-labs/observers@ @lit/ts-transformers@ lit-element@ @lit-labs/context@ @lit/localize@ lit@ @lit-labs/react@ v,20,3,5,96,116,0 days 00:00:00.102820
1673,influxdata/telegraf,4, igloo-rc plugins-rc v,29,3,19,109,138,0 days 00:00:00.522810
1674,plotly/plotly.py,6, widget-v jupyterlab-plotly-v v chart-studio-v plotly-geo-v,48,16,3,42,90,0 days 00:00:00.259461
1675,emirpasic/gods,1,v,19,7,1,6,25,0 days 00:00:00.027529
1676,mikepenz/MaterialDrawer,1,v,35,9,7,166,201,0 days 00:00:00.163042
1677,LuckSiege/PictureSelector,2,v. v,12,5,5,91,103,0 days 00:00:00.312827
1678,microsoft/nni,1,v,27,9,2,16,43,0 days 00:00:00.287700
1679,NetEase/pomelo,2, v,9,1,4,84,93,0 days 00:00:00.100664
1680,apexcharts/apexcharts.js,2, v,32,9,3,54,86,0 days 00:00:00.103782
1681,PuerkitoBio/goquery,1,v,12,0,5,10,22,0 days 00:00:00.022882
1682,QL-Win/QuickLook,2, v,4,1,1,38,42,0 days 00:00:00.039957
1683,nock/nock,2, v,125,15,5,181,306,0 days 00:00:00.214077
1684,go-chi/chi,1,v,12,1,2,27,39,0 days 00:00:00.037238
1685,rjsf-team/react-jsonschema-form,1,v,71,15,6,52,123,0 days 00:00:00.117317
1686,d2-projects/d2-admin,2, v,25,6,4,62,87,0 days 00:00:00.155462
1687,koekeishiya/yabai,1,v,12,5,1,34,46,0 days 00:00:00.049214
1688,alibaba/tengine,3, tengine- tags/tengine-,7,0,6,22,29,0 days 00:00:00.113925
1689,mifi/lossless-cut,1,v,70,29,8,67,137,0 days 00:00:00.105040
1690,sindresorhus/got,1,v,70,18,8,71,141,0 days 00:00:00.199084
1691,spicetify/spicetify-cli,2,v. v,23,9,4,52,75,0 days 00:00:00.048512
1692,netchx/netch,2, v,6,1,2,47,53,0 days 00:00:00.116119
1693,meolu/walle-web,1,v,13,6,1,6,19,0 days 00:00:00.058145
1694,kyleneideck/BackgroundMusic,1,v,3,0,2,3,6,0 days 00:00:00.036772
1695,rizinorg/cutter,1,v,14,6,5,16,30,0 days 00:00:00.116675
1696,openwrt/openwrt,1,v,4,0,3,29,33,0 days 00:00:02.936837
1697,video-dev/hls.js,1,v,16,2,9,185,201,0 days 00:00:00.629507
1698,twitter/twemproxy,2, v,4,0,3,10,14,0 days 00:00:00.043836
1699,mikecao/umami,1,v,46,38,0,3,49,0 days 00:00:00.090141
1700,chenshuo/muduo,2,pre-cpp v,12,1,6,45,57,0 days 00:00:00.058055
1701,OpenRA/OpenRA,5, pkgtest- devtest- playtest- release-,309,198,16,16,325,0 days 00:00:01.965757
1702,blitz-js/blitz,2,affbcb v,41,35,0,74,115,0 days 00:00:00.356577
1703,FreeCAD/FreeCAD,1,,7,0,6,10,17,0 days 00:00:01.358016
1704,apple/foundationdb,2, snowflake-,8,0,7,120,128,0 days 00:00:01.402647
1705,bettercap/bettercap,1,v,33,21,5,10,43,0 days 00:00:00.111692
1706,hotwired/stimulus,1,v,12,5,4,14,26,0 days 00:00:00.055124
1707,facebook/flipper,2, v,136,123,0,66,202,0 days 00:00:00.727513
1708,EOSIO/eos,3,box-pre- dawn-v v,15,6,4,80,95,0 days 00:00:01.276960
1709,graphile/postgraphile,1,v,35,3,7,60,95,0 days 00:00:00.145014
1710,marko-js/marko,5,@marko/translator-default@ marko@ @marko/babel-utils@ @marko/compiler@ v,78,14,3,525,603,0 days 00:00:00.776033
1711,slimphp/Slim,1,,40,6,21,55,95,0 days 00:00:00.245306
1712,xinntao/Real-ESRGAN,1,v,2,1,0,12,14,0 days 00:00:00.013473
1713,dotnet/efcore,4, rel/ release/ v,9,0,7,102,111,0 days 00:00:00.902757
1714,Netflix/eureka,5, blitz4j- eureka- v v.,25,0,0,203,228,0 days 00:00:00.261842
1715,mengshukeji/Luckysheet,2,doc v,3,0,0,16,19,0 days 00:00:00.050175
1716,dimsemenov/Magnific-Popup,1,,3,0,2,18,21,0 days 00:00:00.029844
1717,realm/realm-java,4,b alpha- DLL-Ver- v,101,44,12,91,192,0 days 00:00:00.576322
1718,wenzhixin/bootstrap-table,1,,18,3,9,39,57,0 days 00:00:00.382711
1719,Textualize/textual,1,v,0,0,0,10,10,0 days 00:00:00.028716
1720,CodeSeven/toastr,2, v,4,0,2,10,14,0 days 00:00:00.032800
1721,mantinedev/mantine,1,,19,14,0,90,109,0 days 00:00:00.447790
1722,tinymce/tinymce,24, @ephox/porkbun@ @ephox/polaris@ @ephox/agar@ @tinymce/oxide@ @ephox/dragster@ @ephox/sugar@ @ephox/snooker@ @ephox/jax@ @ephox/mcagar@ @ephox/robin@ @ephox/sand@ @ephox/katamari@ @ephox/phoenix@ @ephox/boss@ @ephox/acid@ @ephox/echo@ @ephox/alloy@ @ephox/darwin@ @ephox/katamari-assertions@ @tinymce/oxide-icons-default@ @ephox/imagetools@ @ephox/bridge@ @ephox/boulder@,59,0,17,1408,1467,0 days 00:00:03.663213
1723,nexe/nexe,1,v,5,1,1,14,19,0 days 00:00:00.042026
1724,projectlombok/lombok,1,v,7,0,6,47,54,0 days 00:00:00.317822
1725,RPCS3/rpcs3,1,v,5,0,3,21,26,0 days 00:00:00.767080
1726,searx/searx,2, v,14,1,12,3,17,0 days 00:00:00.220131
1727,cloudwu/skynet,1,v,15,7,6,18,33,0 days 00:00:00.112076
1728,getlantern/lantern,6, lantern- android-sdk- _ v natty-beta,21,1,3,164,185,0 days 00:00:00.852137
1729,antvis/G2,2, v,13,1,5,144,157,0 days 00:00:00.359306
1730,Yalantis/uCrop,1,,0,0,0,8,8,0 days 00:00:00.020906
1731,java-decompiler/jd-gui,1,v,7,4,1,11,18,0 days 00:00:00.019258
1732,MobSF/Mobile-Security-Framework-MobSF,2, v,5,0,1,37,42,0 days 00:00:00.099340
1733,conventional-changelog/commitlint,1,v,47,14,5,89,136,0 days 00:00:00.275722
1734,kubernetes/dashboard,1,v,15,1,9,20,35,0 days 00:00:00.238163
1735,ankitects/anki,1,,1,0,0,83,84,0 days 00:00:00.432171
1736,PHPOffice/PhpSpreadsheet,1,,24,6,7,10,34,0 days 00:00:00.313031
1737,tensorflow/tfjs-models,19,qna-v depth-estimation-v pose-detection-v speech-commands-v hand-pose-detection-v handpose-v body-pix-v face-detection-v universal-sentence-encoder-v mobilenet-v posenet-v facemesh-v knn-classifier-v body-segmentation-v blazeface-v face-landmarks-detection-v deeplab-v coco-ssd-v toxicity-v,6,0,0,70,76,0 days 00:00:00.173226
1738,gopherjs/gopherjs,2,v go,2,0,0,3,5,0 days 00:00:00.102853
1739,pagehelper/Mybatis-PageHelper,1,v,18,5,6,42,60,0 days 00:00:00.038045
1740,micro/micro,2, v,62,36,2,37,99,0 days 00:00:00.251713
1741,google/guice,2, snapshot,19,4,10,4,23,0 days 00:00:00.120000
1742,single-spa/single-spa,2, v,29,1,5,85,114,0 days 00:00:00.082883
1743,davisking/dlib,1,v,55,12,13,0,55,0 days 00:00:00.390544
1744,argoproj/argo-workflows,2, v,23,7,9,102,125,0 days 00:00:00.248125
1745,containerd/containerd,2, v,9,1,7,76,85,0 days 00:00:00.869487
1746,frappe/erpnext,2, v,153,125,7,763,916,0 days 00:00:03.361902
1747,nightwatchjs/nightwatch,1,v,16,1,9,207,223,0 days 00:00:00.167992
1748,ccampbell/mousetrap,1,,7,1,5,21,28,0 days 00:00:00.023793
1749,jquery/jquery-ui,1,,8,1,6,38,46,0 days 00:00:00.314413
1750,FriendsOfPHP/PHP-CS-Fixer,1,v,48,26,15,148,196,0 days 00:00:00.619410
1751,google/brotli,1,v,6,1,4,10,16,0 days 00:00:00.062121
1752,hashicorp/nomad,1,v,17,0,15,104,121,0 days 00:00:01.262615
1753,mail-in-a-box/mailinabox,1,v,45,13,11,0,45,0 days 00:00:00.214541
1754,ajv-validator/ajv,2, v,71,26,4,89,160,0 days 00:00:00.149088
1755,pybind/pybind11,2,archive/yclass_v v,19,4,8,16,35,0 days 00:00:00.136984
1756,octalmage/robotjs,1,v,6,0,4,28,34,0 days 00:00:00.040654
1757,SFTtech/openage,1,v,5,2,2,4,9,0 days 00:00:00.266183
1758,allenai/allennlp,2, v,24,4,5,23,47,0 days 00:00:00.156394
1759,the-control-group/voyager,1,v,5,0,3,35,40,0 days 00:00:00.152025
1760,elastic/beats,3, libbeat/v v,45,10,9,136,181,0 days 00:00:01.909754
1761,ansible/awx,1,,36,18,2,20,56,0 days 00:00:01.562929
1762,baidu/amis,1,,9,5,2,37,46,0 days 00:00:00.416707
1763,permissions-dispatcher/PermissionsDispatcher,2, ktx-,22,5,8,35,57,0 days 00:00:00.192494
1764,nats-io/nats-server,1,v,17,2,12,49,66,0 days 00:00:00.265730
1765,keeweb/keeweb,1,v,25,10,9,103,128,0 days 00:00:00.433612
1766,stylus/stylus,1,,53,28,10,115,168,0 days 00:00:00.247804
1767,beetbox/beets,1,v,6,1,4,30,36,0 days 00:00:00.513983
1768,codecentric/spring-boot-admin,1,,12,0,11,62,74,0 days 00:00:00.091517
1769,Chia-Network/chia-blockchain,3, Alpha- alpha-,6,4,0,36,42,0 days 00:00:00.408664
1770,json-iterator/go,3, jsoniter-go- v,2,0,1,29,31,0 days 00:00:00.045091
1771,apache/pulsar,1,v,14,1,10,37,51,0 days 00:00:00.691010
1772,jonas/tig,1,tig-,27,6,19,22,49,0 days 00:00:00.115754
1773,facebook/watchman,2,mlion_ v,38,11,4,110,148,0 days 00:00:00.631159
1774,tomnomnom/gron,2, v,7,1,1,27,34,0 days 00:00:00.019859
1775,dgraph-io/badger,1,v,14,3,6,20,34,0 days 00:00:00.094650
1776,WickyNilliams/headroom.js,1,v,9,0,2,8,17,0 days 00:00:00.021485
1777,postmanlabs/httpbin,3,deployment-test- deployment-prod- v,16,1,3,12,28,0 days 00:00:00.042688
1778,taye/interact.js,1,v,11,0,4,102,113,0 days 00:00:00.277437
1779,ent/ent,1,v,10,2,4,21,31,0 days 00:00:00.096338
1780,containrrr/watchtower,1,v,8,1,5,24,32,0 days 00:00:00.048261
1781,doctrine/inflector,2, v,6,0,4,10,16,0 days 00:00:00.029964
1782,mobile-shell/mosh,1,mosh-,4,2,1,10,14,0 days 00:00:00.064431
1783,SpartnerNL/Laravel-Excel,2, v,11,1,4,143,154,0 days 00:00:00.122562
1784,Kotlin/kotlinx.coroutines,1,,24,11,6,38,62,0 days 00:00:00.130156
1785,reactos/reactos,70,backups/GSoC_Network@ backups/ntoskrnl-audit@ backups/rbuild@ backups/ros-csrss@ backups/pierre-fsd@ backups/avendor@ backups/arty-newcc@ backups/vs_jc@ backups/FreeLoader@ backups/pnpmgr_cleanup@ backups/umode_net_branch@ backups/ELF_support@ backups/new_headers@ backups/aicom-network-fixes@ backups/unmaintained@ backups/cmake-bringup@ backups/header-work@ backups/tcpip_revolution@ backups/hyperion@ backups/powerpc@ backups/wlan-bringup@ backups/danny-web@ backups/ROS@ backups/keyboard_heavy_lifting@ backups/cache_manager_rewrite@ backups/jcatena-branch@ backups/lean-explorer@ backups/c++-bringup@ backups/reactos@ backups/alex-cm-branch@ ReactOS- backups/arty-stable@ backups/reactx@ backups/curicon_rewrite@ backups/sndblst@ backups/nyadav-audio-branch@ backups/DBXSL@ backups/old_reactx@ backups/silverblade-audio@ backups/umode-network-branch@ backups/the-real-msvc@ backups/tcp-rewrite-branch@ backups/iut-netsh@ backups/lean-explorer_tmp@ backups/services--dd--floppy@ backups/baikalnet@ backups/xmlbuildsystem@ backups/expat-rbuild@ backups/GSoC_Themes@ backups/reactos-yarotows@ backups/xen@ backups/KJKHyperion-RtlUnwind@ backups/ros@ backups/rox-u@ backups/winldr@ backups/colins-printing-for-freedom@ backups/usb-bringup@ backups/alex_devel_branch@ backups/mpw@ backups/shell-experiments@ backups/audio-bringup@ backups/usb-bringup-trunk@ v backups/alex-kd-branch@ backups/no-windres-workaround@ backups/aicom-network-stable@ backups/KJKHyperion-ntoskrnl-fixnotifs@ backups/clipboard@ backups/Ash_Shell@ backups/cis@,74,10,43,64,138,0 days 00:00:04.010384
1786,networkx/networkx,1,networkx-,37,7,25,10,47,0 days 00:00:00.432853
1787,octobercms/october,1,v,5,0,2,203,208,0 days 00:00:00.346110
1788,wbkd/react-flow,2, v,56,27,2,118,174,0 days 00:00:00.202873
1789,GoogleChrome/workbox,1,v,24,9,7,38,62,0 days 00:00:00.098128
1790,jaredpalmer/razzle,24, razzle-dev-utils@ razzle-plugin-scss@ razzle-plugin-elm@ razzle-start-server-webpack-plugin@ razzle-plugin-devcert@ razzle-plugin-preact@ razzle-plugin-css@ razzle-plugin-bundle-analyzer@ create-razzle-app@ razzle-plugin-react@ razzle-plugin-mdx@ razzle-plugin-less@ razzle-plugin-vue@ razzle@ babel-preset-razzle@ razzle-plugin-eslint@ razzle-plugin-php@ razzle-plugin-manifest@ razzle-plugin-svelte@ razzle-plugin-graphql@ razzle-plugin-typescript@ razzle-plugin-inferno@ v,16,3,5,129,145,0 days 00:00:00.146485
1791,summernote/summernote,1,v,8,2,2,52,60,0 days 00:00:00.274990
1792,javve/list.js,2, v,11,3,5,10,21,0 days 00:00:00.044584
1793,lokesh/color-thief,2, v,5,0,2,6,11,0 days 00:00:00.017184
1794,nltk/nltk,1,,8,0,7,23,31,0 days 00:00:00.970499
1795,ionic-team/stencil,1,v,53,33,2,189,242,0 days 00:00:00.397632
1796,GoogleChromeLabs/ndb,1,v,2,0,0,57,59,0 days 00:00:00.054515
1797,egulias/EmailValidator,1,,8,0,5,47,55,0 days 00:00:00.057145
1798,Chocobozzz/PeerTube,2,test-tag- v,17,0,6,10,27,0 days 00:00:00.449058
1799,compiler-explorer/compiler-explorer,1,gh-,1309,4,0,0,1309,0 days 00:00:02.374890
1800,diegomura/react-pdf,18, @react-pdf/image@ @react-pdf/renderer@ @react-pdf/types@ @react-pdf/stylesheet@ @react-pdf/textkit@ @react-pdf/svgkit@ @react-pdf/render@ @react-pdf/font@ @react-pdf/png-js@ @react-pdf/fontkit@ @react-pdf/yoga@ @react-pdf/pdfkit@ @react-pdf/zlib@ v @react-pdf/primitives@ @react-pdf/unicode-properties@ @react-pdf/layout@,17,4,1,234,251,0 days 00:00:00.392678
1801,browserslist/browserslist,1,,49,10,5,119,168,0 days 00:00:00.098611
1802,jxnblk/mdx-deck,1,v,21,14,1,91,112,0 days 00:00:00.092681
1803,Rapptz/discord.py,1,v,24,11,6,41,65,0 days 00:00:00.155336
1804,fengyuanchen/cropperjs,1,v,14,6,3,40,54,0 days 00:00:00.038755
1805,casesandberg/react-color,2, v,14,0,4,23,37,0 days 00:00:00.043558
1806,dolthub/dolt,3, go/v v,30,19,2,119,149,0 days 00:00:01.035902
1807,doctrine/instantiator,1,,5,0,4,7,12,0 days 00:00:00.026962
1808,swaywm/sway,1,,22,5,8,7,29,0 days 00:00:00.469381
1809,phalcon/cphalcon,3,Dao-v phalcon-v v,15,2,8,80,95,0 days 00:00:00.895107
1810,highcharts/highcharts,4,v test-v highmaps-v highstock-v,27,0,19,153,180,0 days 00:00:01.329262
1811,downshift-js/downshift,1,v,49,0,0,179,228,0 days 00:00:00.116717
1812,lingochamp/FileDownloader,1,v,11,2,2,56,67,0 days 00:00:00.055671
1813,OpenRCT2/OpenRCT2,1,v,4,0,3,23,27,0 days 00:00:01.172845
1814,tymondesigns/jwt-auth,1,,6,2,2,29,35,0 days 00:00:00.067416
1815,App-vNext/Polly,2, v,7,1,2,4,11,0 days 00:00:00.043170
1816,FiloSottile/age,1,v,1,0,0,0,1,0 days 00:00:00.014057
1817,polybar/polybar,1,,20,5,7,84,104,0 days 00:00:00.276756
1818,apache/zookeeper,2,release- ,10,0,4,40,50,0 days 00:00:00.228487
1819,withspectrum/spectrum,3, desktop-v v,10,7,1,151,161,0 days 00:00:00.774886
1820,chjj/blessed,1,v,1,0,0,79,80,0 days 00:00:00.062448
1821,dotnet/AspNetCore.Docs,1,,40,24,1,0,40,0 days 00:00:00.685438
1822,mholt/PapaParse,1,,19,1,2,55,74,0 days 00:00:00.042188
1823,z-song/laravel-admin,2, v,3,0,2,74,77,0 days 00:00:00.162771
1824,star7th/showdoc,2, v,18,1,5,124,142,0 days 00:00:00.098089
1825,redis/jedis,3, jedis- v,27,7,17,36,63,0 days 00:00:00.277629
1826,go-playground/validator,1,v,94,12,6,59,153,0 days 00:00:00.085229
1827,VSCodeVim/Vim,2, v,38,18,6,187,225,0 days 00:00:00.315968
1828,avwo/whistle,1,v,31,11,10,342,373,0 days 00:00:00.692063
1829,spatie/laravel-permission,1,,87,18,4,71,158,0 days 00:00:00.102027
1830,rqlite/rqlite,1,v,56,35,4,39,95,0 days 00:00:00.259728
1831,openresty/openresty,1,v,1,0,0,161,162,0 days 00:00:00.119222
1832,abseil/abseil-cpp,1,,17,0,1,0,17,0 days 00:00:00.053537
1833,restify/node-restify,2, v,44,11,7,96,140,0 days 00:00:00.107403
1834,GoogleContainerTools/kaniko,1,v,33,14,4,4,37,0 days 00:00:00.090225
1835,PatrickJS/angular-starter,2, v,6,3,1,5,11,0 days 00:00:00.162398
1836,thanos-io/thanos,1,v,26,7,2,17,43,0 days 00:00:00.147240
1837,akiran/react-slick,2, v,13,3,5,27,40,0 days 00:00:00.056539
1838,milvus-io/milvus,1,v,9,3,3,15,24,0 days 00:00:00.950139
1839,dbcli/pgcli,2, v,39,12,9,47,86,0 days 00:00:00.191274
1840,peers/peerjs,2, v,6,1,4,30,36,0 days 00:00:00.054817
1841,asciinema/asciinema,1,v,10,0,8,12,22,0 days 00:00:00.044323
1842,netbox-community/netbox,2, v,24,6,13,173,197,0 days 00:00:00.505969
1843,dbcli/mycli,1,v,26,8,9,20,46,0 days 00:00:00.082669
1844,luin/ioredis,2, v,54,9,4,132,186,0 days 00:00:00.229849
1845,styleguidist/react-styleguidist,2, v,47,16,3,215,262,0 days 00:00:00.170905
1846,golangci/golangci-lint,1,v,47,23,1,63,110,0 days 00:00:00.120541
1847,dangrossman/daterangepicker,2, v,5,1,3,58,63,0 days 00:00:00.048023
1848,jina-ai/clip-as-service,1,v,15,7,0,92,107,0 days 00:00:00.096563
1849,TypeStrong/ts-node,1,v,52,3,7,83,135,0 days 00:00:00.073834
1850,brave/brave-browser,2,bsc-debug-nightly-win v,4,0,0,5124,5128,0 days 00:00:50.336280
1851,tidwall/gjson,1,v,15,0,2,42,57,0 days 00:00:00.028733
1852,redis/redis-py,2, v,15,2,9,49,64,0 days 00:00:00.105868
1853,imakewebthings/waypoints,2, v,6,1,4,17,23,0 days 00:00:00.026369
1854,okonet/lint-staged,2, v,44,3,3,145,189,0 days 00:00:00.094701
1855,aspnetboilerplate/aspnetboilerplate,3, v. v,91,42,5,125,216,0 days 00:00:00.467274
1856,s0md3v/XSStrike,1,,2,1,0,10,12,0 days 00:00:00.028389
1857,reactstrap/reactstrap,2, v,61,12,6,54,115,0 days 00:00:00.079521
1858,PrismJS/prism,2, v,29,8,11,11,40,0 days 00:00:00.269565
1859,lionsoul2014/ip2region,1,release-,0,0,0,1,1,0 days 00:00:00.017551
1860,nasa/openmct,8, open-v V-R v- t-sim-rev vista- v openmct-viper-build-,16,0,12,41,57,0 days 00:00:00.534594
1861,git-lfs/git-lfs,2, v,29,3,18,60,89,0 days 00:00:00.734822
1862,nextauthjs/next-auth,7,@next-auth/mikro-orm-adapter@v @next-auth/prisma-adapter@v next-auth@v @next-auth/upstash-redis-adapter@v @next-auth/mongodb-adapter@v v @next-auth/typeorm-legacy-adapter@v,38,7,2,79,117,0 days 00:00:00.135940
1863,shipshapecode/shepherd,1,v,46,8,7,73,119,0 days 00:00:00.253575
1864,ant-design/ant-design-mobile,2, v,28,16,4,107,135,0 days 00:00:00.498420
1865,google/blockly,2, blockly-v,19,0,9,22,41,0 days 00:00:00.521543
1866,snabbdom/snabbdom,1,v,14,1,5,33,47,0 days 00:00:00.049277
1867,mockery/mockery,1,,10,0,9,28,38,0 days 00:00:00.092255
1868,knockout/knockout,1,v,13,0,12,12,25,0 days 00:00:00.080624
1869,jquery-validation/jquery-validation,1,,14,0,12,8,22,0 days 00:00:00.043381
1870,albumentations-team/albumentations,2, v,6,0,5,7,13,0 days 00:00:00.037758
1871,lucidrains/vit-pytorch,1,,32,1,0,105,137,0 days 00:00:00.046443
1872,spencermountain/compromise,2, v,70,23,8,148,218,0 days 00:00:00.484173
1873,raspberrypi/linux,5, stable_ rpi tag oldstable_,18,9,3,1,19,0 days 00:01:10.889606
1874,debug-js/debug,1,,22,2,6,47,69,0 days 00:00:00.048143
1875,plouc/nivo,1,v,67,26,7,45,112,0 days 00:00:00.100439
1876,jedisct1/libsodium,1,,8,2,1,25,33,0 days 00:00:00.180604
1877,sql-js/sql.js,1,v,7,0,4,7,14,0 days 00:00:00.032051
1878,ToolJet/ToolJet,2,fix-ec v,25,21,0,47,72,0 days 00:00:00.255146
1879,Netflix/falcor,2,windows v,8,1,4,41,49,0 days 00:00:00.121591
1880,pagekit/vue-resource,1,,12,2,3,41,53,0 days 00:00:00.038417
1881,AppIntro/AppIntro,2, v,10,1,8,8,18,0 days 00:00:00.055373
1882,ManimCommunity/manim,1,v,15,12,0,4,19,0 days 00:00:00.242272
1883,jantimon/html-webpack-plugin,2, v,47,6,6,36,83,0 days 00:00:00.175665
1884,react-static/react-static,1,v,28,10,5,162,190,0 days 00:00:00.129154
1885,vercel/micro,2, v,21,9,3,34,55,0 days 00:00:00.038056
1886,mailhog/MailHog,2, v,10,3,2,16,26,0 days 00:00:00.019759
1887,bpampuch/pdfmake,1,,2,0,1,72,74,0 days 00:00:00.087022
1888,ml-tooling/best-of-ml-python,1,,0,0,0,86,86,0 days 00:00:00.049871
1889,goreleaser/goreleaser,1,v,193,86,0,300,493,0 days 00:00:00.486488
1890,cyclejs/cyclejs,1,v,32,9,1,50,82,0 days 00:00:00.055931
1891,veler/DevToys,1,v,6,2,0,19,25,0 days 00:00:00.038937
1892,HandBrake/HandBrake,1,,8,0,7,35,43,0 days 00:00:00.621440
1893,github/gh-ost,2,revert-pr- v,3,0,2,45,48,0 days 00:00:00.117791
1894,SpacehuhnTech/esp8266_deauther,3, v. v,10,4,3,3,13,0 days 00:00:00.049804
1895,serbanghita/Mobile-Detect,1,,6,2,1,64,70,0 days 00:00:00.070418
1896,samuelcolvin/pydantic,2,V v,42,18,6,37,79,0 days 00:00:00.095507
1897,quarkusio/quarkus,1,,28,27,0,13,41,0 days 00:00:00.664167
1898,clauderic/react-sortable-hoc,1,v,20,4,1,52,72,0 days 00:00:00.045515
1899,renovatebot/renovate,3, experiment- v,1600,20,1,4429,6029,0 days 00:01:04.431911
1900,h2o/h2o,1,v,12,3,2,32,44,0 days 00:00:00.203668
1901,openresty/lua-nginx-module,1,v,9,0,6,118,127,0 days 00:00:00.218436
1902,invertase/react-native-firebase,23, @react-native-firebase/storage@ @react-native-firebase/crashlytics@ @react-native-firebase/functions@ @react-native-firebase/perf@ @react-native-firebase/database@ @react-native-firebase/ml-vision@ @react-native-firebase/app@ @react-native-firebase/template@ @react-native-firebase/firestore@ @react-native-firebase/in-app-messaging@ @react-native-firebase/messaging@ @react-native-firebase/auth@ @react-native-firebase/remote-config@ @react-native-firebase/analytics@ @react-native-firebase/ml@ @react-native-firebase/ml-natural-language@ @react-native-firebase/admob@ @react-native-firebase/dynamic-links@ react-native-firebase-tests@ @react-native-firebase/iid@ v @react-native-firebase/app-types@,92,32,4,853,945,0 days 00:00:01.238921
1903,ceph/ceph,3,suse_cloud suse_ses_v v,122,90,14,208,330,0 days 00:00:09.760559
1904,kubesphere/kubesphere,2,advanced- v,6,0,5,5,11,0 days 00:00:00.222759
1905,postgres/postgres,4,REL_ REL PG95- Release_,88,6,68,362,450,0 days 00:00:04.412780
1906,tinygo-org/tinygo,1,v,23,9,3,4,27,0 days 00:00:00.142748
1907,apple/darwin-xnu,1,xnu-,19,0,0,104,123,0 days 00:00:00.048679
1908,microsoft/WSL2-Linux-Kernel,3,linux-msft- linux-msft-wsl- v,47,0,1,2480,2527,0 days 00:01:42.744794
1909,haltu/muuri,1,,9,0,5,14,23,0 days 00:00:00.037553
1910,vueuse/vueuse,2, v,40,24,0,123,163,0 days 00:00:00.140582
1911,atomiks/tippyjs,2, v,27,14,1,65,92,0 days 00:00:00.087632
1912,neo4j/neo4j,2, browser-,21,0,20,211,232,0 days 00:00:04.077363
1913,FredrikNoren/ungit,2, v,16,6,6,126,142,0 days 00:00:00.798326
1914,jacomyal/sigma.js,1,v,7,1,3,8,15,0 days 00:00:00.079979
1915,nhn/tui.calendar,1,v,21,6,2,42,63,0 days 00:00:00.106722
1916,leecade/react-native-swiper,2, v,2,0,1,21,23,0 days 00:00:00.029699
1917,typesense/typesense,2, v,16,4,5,8,24,0 days 00:00:00.075441
1918,esimov/caire,2, v,4,0,2,16,20,0 days 00:00:00.030215
1919,qrohlf/trianglify,1,v,12,0,4,8,20,0 days 00:00:00.022421
1920,dask/dask,1,,97,53,9,141,238,0 days 00:00:00.937646
1921,walkor/workerman,2, v,5,0,2,98,103,0 days 00:00:00.306657
1922,expressjs/multer,1,v,5,0,1,12,17,0 days 00:00:00.032721
1923,bitwarden/server,2, v,49,29,4,58,107,0 days 00:00:00.181685
1924,ktorio/ktor,3, ktor- tmp-,12,1,9,52,64,0 days 00:00:00.580618
1925,mozilla/sops,2, v,11,0,8,19,30,0 days 00:00:00.086021
1926,spotify/annoy,3, v. v,9,1,3,15,24,0 days 00:00:00.047508
1927,kubernetes-sigs/kind,2, v,14,2,6,10,24,0 days 00:00:00.182467
1928,Tencent/matrix,1,v,5,0,1,11,16,0 days 00:00:00.194161
1929,googleapis/google-api-nodejs-client,142, androidmanagement-v discovery-v abusiveexperiencereport-v pubsublite-v digitalassetlinks-v acceleratedmobilepageurl-v compute-v customsearch-v forms-v admob-v civicinfo-v sts-v prod_tt_sasportal-v sqladmin-v analytics-v youtubereporting-v cloudshell-v analyticsreporting-v firebase-v searchconsole-v cloudsearch-v tagmanager-v homegraph-v admin-v mybusinessaccountmanagement-v firebasedatabase-v storagetransfer-v adsense-v displayvideo-v chromemanagement-v siteVerification-v run-v serviceconsumermanagement-v networkmanagement-v fcm-v adsensehost-v workflowexecutions-v fitness-v doubleclicksearch-v datamigration-v content-v identitytoolkit-v adexperiencereport-v remotebuildexecution-v genomics-v firebasestorage-v calendar-v policysimulator-v vault-v adexchangebuyer-v datafusion-v vectortile-v chromepolicy-v testing-v script-v cloudkms-v gmail-v manufacturers-v serviceusage-v youtube-v sourcerepo-v iap-v healthcare-v groupssettings-v playcustomapp-v classroom-v kgsearch-v gamesConfiguration-v domainsrdap-v adexchangebuyer2-v cloudidentity-v androidpublisher-v lifesciences-v youtubeAnalytics-v toolresults-v licensing-v appsactivity-v webfonts-v localservices-v verifiedaccess-v apigateway-v storage-v sql-v sasportal-v iam-v doubleclickbidmanager-v oauth2-v firebaserules-v gmailpostmastertools-v tpu-v streetviewpublish-v factchecktools-v dfareporting-v file-v servicemanagement-v appengine-v poly-v recommendationengine-v drive-v reseller-v ondemandscanning-v pagespeedonline-v chromeuxreport-v plus-v dataflow-v ml-v webmasters-v firebasehosting-v gamesManagement-v bigtableadmin-v indexing-v trafficdirector-v eventarc-v sheets-v firebasedynamiclinks-v libraryagent-v games-v composer-v realtimebidding-v firebaseml-v smartdevicemanagement-v servicenetworking-v servicecontrol-v androidenterprise-v accesscontextmanager-v driveactivity-v alertcenter-v slides-v deploymentmanager-v chat-v androiddeviceprovisioning-v books-v blogger-v playablelocations-v groupsmigration-v cloudtasks-v googleapis-v docs-v v safebrowsing-v people-v,166,36,4,1004,1170,0 days 00:00:02.114121
1930,Ciphey/Ciphey,2, v,18,15,0,8,26,0 days 00:00:00.217980
1931,zricethezav/gitleaks,1,v,60,8,4,62,122,0 days 00:00:00.072116
1932,w7corp/easywechat,1,,47,4,4,241,288,0 days 00:00:00.242286
1933,squidfunk/mkdocs-material,1,,52,21,4,192,244,0 days 00:00:00.380687
1934,python-pillow/Pillow,1,,39,1,35,35,74,0 days 00:00:00.744999
1935,WordPress/gutenberg,97, @wordpress/primitives@ package_v @wordpress/shortcode@ @wordpress/autop@ @wordpress/token-list@ @wordpress/block-serialization-spec-parser@ rnmobile/ @wordpress/warning@ @wordpress/react-native-aztec@ @wordpress/dom-ready@ rnmobile/release-v @wordpress/lazy-import@ @wordpress/preferences@ @wordpress/data@ @wordpress/url@ @wordpress/stylelint-config@ @wordpress/block-serialization-default-parser@ @wordpress/edit-site@ @wordpress/create-block-tutorial-template@ @wordpress/priority-queue@ @wordpress/reusable-blocks@ @wordpress/admin-manifest@ @wordpress/edit-widgets@ @wordpress/react-native-bridge@ @wordpress/is-shallow-equal@ @wordpress/components@ @wordpress/compose@ @wordpress/style-engine@ @wordpress/format-library@ @wordpress/docgen@ @wordpress/api-fetch@ @wordpress/blocks@ @wordpress/jest-puppeteer-axe@ @wordpress/interface@ @wordpress/base-styles@ @wordpress/create-block@ @wordpress/prettier-config@ @wordpress/custom-templated-path-webpack-plugin@ @wordpress/element@ @wordpress/project-management-automation@ @wordpress/react-native-editor@ @wordpress/list-reusable-blocks@ @wordpress/browserslist-config@ @wordpress/eslint-plugin@ @wordpress/nux@ @wordpress/viewport@ @wordpress/plugins@ @wordpress/edit-navigation@ @wordpress/env@ @wordpress/keyboard-shortcuts@ @wordpress/blob@ @wordpress/rich-text@ @wordpress/babel-preset-default@ @wordpress/postcss-themes@ @wordpress/block-editor@ @wordpress/preferences-persistence@ @wordpress/dependency-extraction-webpack-plugin@ @wordpress/customize-widgets@ @wordpress/e2e-test-utils@ @wordpress/media-utils@ @wordpress/notices@ @wordpress/block-library@ @wordpress/scripts@ @wordpress/redux-routine@ @wordpress/postcss-plugins-preset@ @wordpress/library-export-default-webpack-plugin@ @wordpress/npm-package-json-lint-config@ @wordpress/readable-js-assets-webpack-plugin@ @wordpress/widgets@ @wordpress/deprecated@ @wordpress/escape-html@ @wordpress/server-side-render@ @wordpress/jest-preset-default@ rnmobile_v @wordpress/babel-plugin-import-jsx-pragma@ @wordpress/keycodes@ @wordpress/annotations@ @wordpress/babel-plugin-makepot@ @wordpress/date@ nmobile/ @wordpress/i18n@ @wordpress/editor@ @wordpress/jest-console@ @wordpress/edit-post@ @wordpress/block-directory@ @wordpress/e2e-tests@ @wordpress/react-i18n@ @wordpress/dom@ @wordpress/icons@ @wordpress/core-data@ @wordpress/html-entities@ @wordpress/a11y@ @wordpress/wordcount@ @wordpress/hooks@ v @wordpress/data-controls@,336,114,9,5921,6257,0 days 00:01:05.410335
1936,frida/frida,1,,54,14,6,579,633,0 days 00:00:00.626404
1937,marcotcr/lime,1,,1,0,0,17,18,0 days 00:00:00.032218
1938,NaturalNode/natural,2, v,6,0,0,44,50,0 days 00:00:00.079880
1939,pxb1988/dex2jar,2, v,2,0,1,28,30,0 days 00:00:00.047984
1940,ppy/osu,5, test osu!-v v changelog-,438,398,2,42,480,0 days 00:00:03.522905
1941,socketio/socket.io-client,1,,28,0,10,97,125,0 days 00:00:00.104023
1942,coryhouse/react-slingshot,2, v,8,2,2,7,15,0 days 00:00:00.041536
1943,balena-io/etcher,1,v,8,0,3,143,151,0 days 00:00:00.215697
1944,vega/vega,1,v,45,19,13,73,118,0 days 00:00:00.461369
1945,dromara/hutool,1,,11,1,6,102,113,0 days 00:00:00.317745
1946,pypa/pipenv,2, v,46,30,0,257,303,0 days 00:00:00.745051
1947,immerjs/immer,2, v,35,14,2,94,129,0 days 00:00:00.246134
1948,CymChad/BaseRecyclerViewAdapterHelper,4, V alpha- v,26,6,1,164,190,0 days 00:00:00.119771
1949,tj/commander.js,2, v,50,9,12,38,88,0 days 00:00:00.074585
1950,jesseduffield/lazydocker,1,v,18,7,4,27,45,0 days 00:00:00.041631
1951,rook/rook,1,v,19,1,16,103,122,0 days 00:00:05.441305
1952,dmlc/xgboost,2, v,21,1,14,12,33,0 days 00:00:00.319367
1953,Netflix/Hystrix,3, hystrix- v,6,2,3,124,130,0 days 00:00:00.160056
1954,magento/magento2,1,,5,0,4,58,63,0 days 00:00:09.246715
1955,doczjs/docz,1,v,19,11,5,66,85,0 days 00:00:00.095123
1956,alibaba/nacos,2, v,16,9,6,15,31,0 days 00:00:00.333448
1957,vercel/swr,1,,8,0,3,40,48,0 days 00:00:00.051735
1958,labstack/echo,2, v,20,2,9,75,95,0 days 00:00:00.104088
1959,mattermost/mattermost-server,1,v,79,72,0,231,310,0 days 00:00:01.598690
1960,google/python-fire,1,v,4,0,3,6,10,0 days 00:00:00.020196
1961,angular/components,1,,31,13,7,128,159,0 days 00:00:00.856342
1962,vuejs/devtools,1,v,10,3,4,36,46,0 days 00:00:00.094231
1963,alibaba/spring-cloud-alibaba,1,,1,0,0,1,2,0 days 00:00:00.121379
1964,halo-dev/halo,1,v,10,2,5,42,52,0 days 00:00:00.113671
1965,react-native-elements/react-native-elements,2, v,30,13,5,52,82,0 days 00:00:00.131053
1966,kataras/iris,1,v,2,0,0,11,13,0 days 00:00:00.102288
1967,visgl/deck.gl,2, v,32,6,11,250,282,0 days 00:00:04.670191
1968,lovell/sharp,1,v,30,3,16,88,118,0 days 00:00:00.120823
1969,pure-css/pure,1,v,9,1,7,14,23,0 days 00:00:00.058705
1970,files-community/Files,1,v,23,18,4,38,61,0 days 00:00:00.316280
1971,facebook/rocksdb,3,rocksdb- do-not-use-me v,33,16,5,186,219,0 days 00:00:01.605769
1972,n8n-io/n8n,8,n8n-core@ n8n@ n8n-editor-ui@ 8n-editor-ui@ n8n-workflow@ n8n-design-system@ n8n-nodes-base@ n8n-node-dev@,178,1,0,753,931,0 days 00:00:01.200449
1973,seata/seata,3, V v,15,2,3,18,33,0 days 00:00:00.181627
1974,balderdashy/sails,3, wl-rc v,16,1,8,144,160,0 days 00:00:00.457334
1975,appwrite/appwrite,1,,13,1,3,30,43,0 days 00:00:00.808898
1976,redux-saga/redux-saga,2, v,18,8,5,40,58,0 days 00:00:00.104324
1977,stedolan/jq,1,jq-,7,0,4,0,7,0 days 00:00:00.182477
1978,reduxjs/react-redux,1,v,26,10,4,59,85,0 days 00:00:00.196554
1979,sampotts/plyr,1,v,16,3,7,195,211,0 days 00:00:00.231259
1980,ramda/ramda,2, v,28,12,9,26,54,0 days 00:00:00.177523
1981,t4t5/sweetalert,2, v,9,0,3,23,32,0 days 00:00:00.035763
1982,swagger-api/swagger-ui,3, v/ v,69,34,10,189,258,0 days 00:00:00.532861
1983,ovity/octotree,1,v,5,0,2,26,31,0 days 00:00:00.054650
1984,signalapp/Signal-Android,3, v. v,180,145,3,860,1040,0 days 00:00:01.769268
1985,dimsemenov/PhotoSwipe,1,v,5,0,2,43,48,0 days 00:00:00.043393
1986,portainer/portainer,4, edge_m internal- v,39,12,10,71,110,0 days 00:00:00.343699
1987,apache/kafka,1,,22,0,16,29,51,0 days 00:00:00.915595
1988,guzzle/guzzle,2, v,37,14,13,96,133,0 days 00:00:00.247248
1989,fabricjs/fabric.js,2, v,34,2,11,69,103,0 days 00:00:00.231717
1990,helm/helm,2, v,32,5,12,68,100,0 days 00:00:00.586923
1991,github/hub,1,v,29,11,8,59,88,0 days 00:00:00.216974
1992,facebook/folly,2, v,34,24,0,292,326,0 days 00:00:00.856283
1993,inconshreveable/ngrok,1,,20,7,1,1,21,0 days 00:00:00.024769
1994,Tencent/wepy,34,wepy-plugin-autoprefixer@ @wepy/x@ @wepy/redux@ @wepy/plugin-eslint@ wepy-cli@ @wepy/plugin-define@ wepy-plugin-filemin@ wepy-compiler-sass@ x@ wepy-compiler-pug@ wepy-plugin-replace@ @wepy/plugin-uglifyjs@ wepy@ @wepy/use-promisify@ wepy-async-function@ wepy-ant@ @wepy/compiler-typescript@ wepy-compiler-stylus@ test@ @wepy/babel-plugin-import-regenerator@ wepy-compiler-babel@ @wepy/use-intercept@ wepy-plugin-uglifyjs@ @wepy/compiler-stylus@ wepy-plugin-imagemin@ @wepy/compiler-babel@ wepy-web@ wepy-eslint@ wepy-compiler-typescript@ wepy-redux@ @wepy/compiler-less@ v @wepy/compiler-sass@ wepy-compiler-less@,3,0,1,108,111,0 days 00:00:00.164836
1995,facebook/draft-js,2, v,11,6,3,16,27,0 days 00:00:00.062404
1996,feathericons/feather,1,v,39,6,2,12,51,0 days 00:00:00.189201
1997,Wox-launcher/Wox,2, v,4,0,2,34,38,0 days 00:00:00.289277
1998,httpie/httpie,1,,19,2,12,28,47,0 days 00:00:00.106224
1999,openfaas/faas,2, v,18,8,6,110,128,0 days 00:00:00.135335
2000,xuxueli/xxl-job,2, v,13,0,8,18,31,0 days 00:00:00.100509
2001,ehang-io/nps,3,V v. v,19,5,1,44,63,0 days 00:00:00.053864
2002,emscripten-core/emscripten,3, webidl. llvm-svn-pre-,43,23,7,345,388,0 days 00:00:02.462776
2003,emberjs/ember.js,1,v,68,19,4,184,252,0 days 00:00:02.073068
2004,coreybutler/nvm-windows,1,,2,0,1,15,17,0 days 00:00:00.028839
2005,nsqio/nsq,1,v,3,0,2,26,29,0 days 00:00:00.125037
2006,floating-ui/floating-ui,7, @floating-ui/react-dom@ v @floating-ui/core@ @floating-ui/react-native@ @floating-ui/dom@ @floating-ui/react-dom-interactions@,32,5,7,172,204,0 days 00:00:00.206690
2007,mochajs/mocha,2, v,65,26,14,110,175,0 days 00:00:00.218405
2008,usablica/intro.js,2, v,29,4,13,12,41,0 days 00:00:00.080982
2009,bevacqua/dragula,2, v,18,2,1,49,67,0 days 00:00:00.046966
2010,vercel/pkg,1,,15,5,4,42,57,0 days 00:00:00.067712
2011,bilibili/flv.js,1,v,7,1,4,8,15,0 days 00:00:00.032326
2012,mono/mono,15, moon/ cecil- type-reflector_ NUNIT_ monotouch- mono- RHYS_ MONO_BETA GMCS_MARTIN_ MONO_ MCS_JULY_ C moon- MCS_,253,75,21,172,425,0 days 00:00:07.949423
2013,rollup/rollup,1,v,169,49,3,411,580,0 days 00:00:00.953490
2014,facebookresearch/detectron2,1,v,6,0,5,5,11,0 days 00:00:00.082136
2015,conwnet/github1s,1,v,7,2,0,19,26,0 days 00:00:00.034273
2016,NativeScript/NativeScript,5, webpack- v release- core-,35,8,6,75,110,0 days 00:00:00.586779
2017,paularmstrong/normalizr,2, v,16,3,4,18,34,0 days 00:00:00.039893
2018,chenglou/react-motion,1,v,5,1,2,19,24,0 days 00:00:00.048967
2019,google/gson,3, gson-parent- gson-,17,1,11,23,40,0 days 00:00:00.163086
2020,qishibo/AnotherRedisDesktopManager,2, v,6,1,3,34,40,0 days 00:00:00.052562
2021,getredash/redash,2, v,10,0,8,19,29,0 days 00:00:00.521049
2022,Kong/insomnia,29,pkg-v insomnia-plugin-cookie-jar@ lib@ insomnia-cookies@ insomnia-plugin-prompt@ core@ insomnia-plugin-response@ insomnia-xpath@ insomnia-plugin-base64@ insomnia-plugin-default-headers@ insomnia-libcurl@ insomnia-sync@ insomnia-prettify@ insomnia-plugin-file@ test- insomnia-plugin-now@ insomnia-account@ insomnia-plugin-hash@ insomnia-importers@ insomnia-plugin-uuid@ designer@ insomnia-plugin-jsonpath@ insomnia-url@ insomnia-plugin-core-themes@ insomnia-plugin-os@ insomnia-plugin-request@ insomnia-httpsnippet@ insomnia-app@ v,47,13,11,559,606,0 days 00:00:00.645891
2023,docsifyjs/docsify,1,v,44,8,6,147,191,0 days 00:00:00.291152
2024,jlmakes/scrollreveal,1,v,10,0,3,36,46,0 days 00:00:00.056717
2025,photoprism/photoprism,0,,0,0,0,0,0,0 days 00:00:00.019844
2026,StevenBlack/hosts,2, v,24,0,3,405,429,0 days 00:00:00.512905
2027,quasarframework/quasar,14,@quasar/app-vite-v @quasar/app-webpack-v @quasar/icongenie-v @quasar/extras-v extras-v @quasar/babel-preset-app-v @quasar/cli-v @quasar/extras- v quasar-v @quasar/vite-plugin-v @quasar/app-v @quasar-extras-v quasar-,45,13,7,493,538,0 days 00:00:01.349797
2028,react-bootstrap/react-bootstrap,2, v,44,17,10,108,152,0 days 00:00:00.261932
2029,pugjs/pug,13, pug-load@ pug-runtime@ pug-linker@ pug-error@ pug-parser@ pug-walk@ pug-attrs@ pug-strip-comments@ pug-lexer@ pug-filters@ pug@ pug-code-gen@,55,22,5,170,225,0 days 00:00:00.262320
2030,slidevjs/slidev,1,v,31,2,1,143,174,0 days 00:00:00.111120
2031,sirupsen/logrus,2, v,20,6,7,35,55,0 days 00:00:00.075105
2032,dotnet-architecture/eShopOnContainers,4, vs netcore v,8,0,4,7,15,0 days 00:00:00.206469
2033,eslint/eslint,1,v,164,145,3,103,267,0 days 00:00:00.517582
2034,nicolargo/glances,1,v,22,0,15,70,92,0 days 00:00:00.221769
2035,localForage/localForage,1,,19,4,4,43,62,0 days 00:00:00.076479
2036,react-navigation/react-navigation,23, react-navigation-drawer@ @react-navigation/example@ react-navigation-animated-switch@ @react-navigation/material-bottom-tabs@ react-navigation-material-bottom-tabs@ react-navigation-stack@ @react-navigation/core@ @react-navigation/stack@ react-navigation-playground@ @react-navigation/elements@ react-navigation-tabs@ flipper-plugin-react-navigation@ @react-navigation/material-top-tabs@ @react-navigation/drawer@ @react-navigation/compat@ @react-navigation/bottom-tabs@ @react-navigation/devtools@ @react-navigation/native@ @react-navigation/routers@ v react-navigation@ @react-navigation/native-stack@,67,7,2,970,1037,0 days 00:00:01.787308
2037,yeasy/docker_practice,1,v,13,1,9,0,13,0 days 00:00:00.177943
2038,Meituan-Dianping/mpvue,1,,3,1,0,17,20,0 days 00:00:00.117791
2039,michalsnik/aos,2, v,11,2,3,24,35,0 days 00:00:00.023084
2040,vuejs/vuepress,1,v,24,10,4,50,74,0 days 00:00:00.121716
2041,postcss/autoprefixer,1,,53,16,9,133,186,0 days 00:00:00.205569
2042,ray-project/ray,3, Ray- ray-,21,6,9,41,62,0 days 00:00:00.830493
2043,uglide/RedisDesktopManager,1,,33,14,4,38,71,0 days 00:00:00.136940
2044,gofiber/fiber,1,v,42,24,0,51,93,0 days 00:00:00.201150
2045,goldfire/howler.js,1,v,4,0,3,50,54,0 days 00:00:00.059028
2046,microsoft/cascadia-code,1,v,18,2,0,0,18,0 days 00:00:00.023939
2047,jaredhanson/passport,1,v,6,0,5,26,32,0 days 00:00:00.147251
2048,homebridge/homebridge,2, v,6,1,4,51,57,0 days 00:00:00.092667
2049,petkaantonov/bluebird,1,v,24,6,7,115,139,0 days 00:00:00.172541
2050,k3s-io/k3s,1,v,11,8,0,6,17,0 days 00:00:00.287833
2051,statelyai/xstate,10,@xstate/svelte@ xstate@ @xstate/inspect@ @xstate/test@ @xstate/vue@ @xstate/fsm@ v @xstate/react@ @xstate/immer@ @xstate/graph@,53,11,6,149,202,0 days 00:00:00.335860
2052,ApolloAuto/apollo,1,v,10,0,7,0,10,0 days 00:00:02.003787
2053,highlightjs/highlight.js,2, stable-,64,18,13,37,101,0 days 00:00:00.452749
2054,DrKLO/Telegram,1,release-,47,0,0,37,84,0 days 00:00:00.050092
2055,python-poetry/poetry,1,,14,10,3,63,77,0 days 00:00:00.121797
2056,neoclide/coc.nvim,1,v,0,0,0,81,81,0 days 00:00:00.178476
2057,apache/incubator-mxnet,2, v,15,0,11,10,25,0 days 00:00:00.662350
2058,libgdx/libgdx,2, gdx-parent-,13,3,6,38,51,0 days 00:00:00.826274
2059,enzymejs/enzyme,12,enzyme-example-mocha@ enzyme-adapter-react-15@ enzyme-adapter-react-13@ enzyme-adapter-react-14@ enzyme-shallow-equal@ enzyme@ enzyme-adapter-react-helper@ enzyme-adapter-utils@ reagent-v v enzyme-adapter-react-16@ enzyme-test-suite@,39,8,4,138,177,0 days 00:00:00.173667
2060,avajs/ava,1,v,54,21,4,23,77,0 days 00:00:00.112592
2061,necolas/react-native-web,1,,17,6,5,242,259,0 days 00:00:00.745563
2062,open-mmlab/mmdetection,1,v,29,26,1,6,35,0 days 00:00:00.122799
2063,Seldaek/monolog,1,,36,7,18,26,62,0 days 00:00:00.144361
2064,numpy/numpy,1,v,26,0,25,82,108,0 days 00:00:02.000333
2065,tsenart/vegeta,3,cli/v v lib/v,39,8,3,136,175,0 days 00:00:00.093447
2066,ShareX/ShareX,1,v,50,24,11,22,72,0 days 00:00:00.489599
2067,electron-react-boilerplate/electron-react-boilerplate,1,v,32,5,7,31,63,0 days 00:00:00.078150
2068,validatorjs/validator.js,2, v,107,32,8,43,150,0 days 00:00:00.144382
2069,mozilla/DeepSpeech,1,v,9,1,6,13,22,0 days 00:00:00.174115
2070,marmelab/react-admin,1,v,46,32,4,168,214,0 days 00:00:00.902150
2071,schollz/croc,1,v,31,10,5,106,137,0 days 00:00:00.305105
2072,envoyproxy/envoy,1,v,23,0,16,53,76,0 days 00:00:00.726527
2073,zyedidia/micro,1,v,6,1,3,22,28,0 days 00:00:00.133144
2074,parse-community/parse-server,1,,34,11,11,111,145,0 days 00:00:00.179291
2075,js-cookie/js-cookie,1,v,10,1,7,13,23,0 days 00:00:00.035418
2076,youzan/vant,1,v,33,13,6,377,410,0 days 00:00:00.984220
2077,FredKSchott/snowpack,104, @snowpack/test-package-react@ snowpack-install-test-top-level-imports@ @snowpack/app-template-svelte@ @snowpack/test-dep-types-only@ @snowpack/plugin-webpack@ @snowpack/test-dep-remote-url@ @snowpack/test-error-illegal-env-var@ esinstall@ @snowpack/test-error-react-workaround@ @snowpack/web-test-runner-plugin@ @snowpack/app-template-preact@ @snowpack/app-template-react-typescript@ @snowpack/test-exclude@ @snowpack/babel-plugin-package-import@ @snowpack/test-error-empty-dep-list@ @snowpack/plugin-react-refresh@ @snowpack/test-dep-node-fetch@ @snowpack/app-template-11ty@ @snowpack/app-template-react@ @snowpack/test-include@ @snowpack/test-include-ts@ @snowpack/test-config-clean@ @snowpack/app-template-blank-typescript@ @snowpack/app-template-lit-element-typescript@ @snowpack/test-config-extends-plugins@ @snowpack/app-template-svelte-typescript@ @snowpack/test-error-file-ext@ create-snowpack-app@ plugin-dotenv@ @snowpack/test-cdn@ snowpack@ @snowpack/test-config-rollup@ @snowpack/test-source-pika@ @snowpack/test-sub-package-json@ @snowpack/test-error-no-dep-list@ @snowpack/app-scripts-preact@ @snowpack/test-config-extends@ @snowpack/test-dep-list-complex@ @snowpack/app-template-vue-typescript@ @snowpack/test-include-with-alias@ @snowpack/app-template-preact-typescript@ @snowpack/app-scripts-vue@ @snowpack/plugin-dotenv@ @snowpack/test-source-pika-webdependencies@ @snowpack/test-dep-exports@ @snowpack/app-scripts-react@ @snowpack/test-resource-proxy@ @snowpack/test-legacy-mount-scripts@ @snowpack/plugin-svelte@ @snowpack/plugin-typescript@ @snowpack/test-bugfix-named-import@ @snowpack/app-template-minimal@ @snowpack/app-template-vue@ @snowpack/plugin-postcss@ @snowpack/test-config-minify@ @snowpack/test-meta-dir@ @snowpack/test-include-missing-in-package-json@ @snowpack/test-exclude-external-packages@ @snowpack/test-custom-modules-dir@ @snowpack/test-meta-dir-local-baseurl@ @snowpack/test-plugin-build-script@ @snowpack/test-config-invalid@ @snowpack/plugin-sass@ skypack@ @snowpack/app-scripts-lit-element@ @snowpack/test-base-url@ @snowpack/test-source-pika-lockfile@ @snowpack/test-config-custom-path@ @snowpack/test-source-pika-types@ @snowpack/test-dep-list-simple@ @snowpack/test-plugin-optimize@ @snowpack/test-config-named-exports@ @snowpack/app-scripts-svelte@ @snowpack/test-include-ignore-unsupported-files@ @snowpack/test-config-alias@ @snowpack/test-base-url-remote@ @snowpack/test-app-template-preact@ @snowpack/test-error-node-builtin-unresolved@ @snowpack/test-error-react-source-pika@ @snowpack/test-error-missing-exports@ @snowpack/plugin-optimize@ @snowpack/app-template-blank@ @snowpack/test-meta-dir-remote-baseurl@ @snowpack/test-package-tippy-js@ @snowpack/test-export-maps@ @snowpack/test-config-with-cli-flags@ @snowpack/test-config-external@ @snowpack/test-dep-list-css@ app-template-svelte-typescript@ @snowpack/test-node-env@ @snowpack/plugin-run-script@ @snowpack/test-base-url-homepage@ @snowpack/plugin-vue@ @snowpack/test-resolve-imports@ @snowpack/plugin-parcel@ @snowpack/test-include-with-package-name@ @snowpack/app-template-lit-element@ @snowpack/plugin-build-script@ @snowpack/plugin-babel@ @snowpack/test-error-missing-dep@ @snowpack/test-dep-browser-entrypoint-object@ v @snowpack/test-plugin-run-script@,51,14,2,982,1033,0 days 00:00:01.649208
2078,libuv/libuv,2,node-v v,52,19,15,176,228,0 days 00:00:00.500763
2079,apache/skywalking,1,v,20,4,6,11,31,0 days 00:00:00.397203
2080,discordjs/discord.js,6, @discordjs/builders@ @discordjs/collection@ @discordjs/rest@ @discordjs/voice@ v,45,17,9,30,75,0 days 00:00:00.361294
2081,spf13/viper,1,v,13,1,6,13,26,0 days 00:00:00.064956
2082,streamlit/streamlit,2, v,83,75,1,46,129,0 days 00:00:00.518521
2083,celery/celery,2, v,22,3,17,143,165,0 days 00:00:00.715886
2084,mongodb/mongo,5, mongodb- r idxv release-,42,8,22,487,529,0 days 00:00:05.967702
2085,TeamNewPipe/NewPipe,2, v,17,3,10,100,117,0 days 00:00:00.682444
2086,google/ExoPlayer,1,r,20,1,14,84,104,0 days 00:00:00.741647
2087,benweet/stackedit,1,v,23,7,3,104,127,0 days 00:00:00.118368
2088,felixrieseberg/windows95,1,v,11,2,5,3,14,0 days 00:00:00.016068
2089,alibaba/Sentinel,2, v,8,2,3,16,24,0 days 00:00:00.045291
2090,segmentio/nightmare,1,,21,4,3,67,88,0 days 00:00:00.074996
2091,codex-team/editor.js,2, v,11,1,2,16,27,0 days 00:00:00.060176
2092,afollestad/material-dialogs,3, v. v,20,6,3,98,118,0 days 00:00:00.575671
2093,robertdavidgraham/masscan,3, kali_ v,3,0,1,8,11,0 days 00:00:00.038248
2094,taichi-dev/taichi,2, v,7,1,3,96,103,0 days 00:00:00.574640
2095,redisson/redisson,2,redisson-parent- redisson-,39,7,17,154,193,0 days 00:00:00.608200
2096,jhipster/generator-jhipster,1,v,110,86,5,114,224,0 days 00:00:02.350792
2097,eligrey/FileSaver.js,2, v,3,0,1,12,15,0 days 00:00:00.025360
2098,rancher/rancher,6, server-v agent-v agent-windows-v v agent-base-v,59,7,8,297,356,0 days 00:00:01.142019
2099,locustio/locust,2, v,27,7,10,56,83,0 days 00:00:00.183696
2100,fish-shell/fish-shell,3, OpenBeta_r LastC++,22,6,14,33,55,0 days 00:00:00.789180
2101,osquery/osquery,2, v,39,11,12,80,119,0 days 00:00:00.473358
2102,winstonjs/winston,2, v,24,4,10,62,86,0 days 00:00:00.093292
2103,Popmotion/popmotion,2, v,21,4,0,131,152,0 days 00:00:00.164753
2104,vuejs/vue-router,1,v,19,8,5,59,78,0 days 00:00:00.116191
2105,graphql/graphql-js,2, v,34,8,10,88,122,0 days 00:00:00.322065
2106,telegramdesktop/tdesktop,1,v,34,9,7,542,576,0 days 00:00:01.091799
2107,jorgebucaran/hyperapp,8, @hyperapp/svg@ @hyperapp/http@ @hyperapp/time@ @hyperapp/html@ @hyperapp/random@ @hyperapp/events@ @hyperapp/dom@,24,14,1,96,120,0 days 00:00:00.116361
2108,didi/DoKit,7, c Android-V Android_V android_dokit_v flutter_ web_,15,1,9,40,55,0 days 00:00:00.126953
2109,palantir/blueprint,30,@blueprintjs/eslint-config@ @blueprintjs/table-dev-app@ @blueprintjs/node-build-scripts@ @blueprintjs/icons@ @blueprintjs/eslint-plugin@ @blueprintjs/tslint-config@ release-table- @blueprintjs/test-commons@ test-react15@ @blueprintjs/docs-theme@ @blueprintjs/timezone@ release- @blueprintjs/demo-app@ @blueprintjs/karma-build-scripts@ @blueprintjs/landing-app@ @blueprintjs/colors@ @blueprintjs/eslint-plugin-blueprint@ @blueprintjs/docs@ @blueprintjs/docs-data@ @blueprintjs/table@ @blueprintjs/stylelint-plugin@ release-core- @blueprintjs/popover2@ @blueprintjs/docs-app@ @blueprintjs/select@ @blueprintjs/labs@ @blueprintjs/datetime@ release-datetime- @blueprintjs/core@ @blueprintjs/webpack-build-scripts@,122,37,2,1154,1276,0 days 00:00:02.005634
2110,rwightman/pytorch-image-models,1,v,0,0,0,8,8,0 days 00:00:00.057077
2111,apache/flink,1,release-,23,0,19,58,81,0 days 00:00:02.331405
2112,zhongyang219/TrafficMonitor,1,V,18,8,6,4,22,0 days 00:00:00.041012
2113,python-telegram-bot/python-telegram-bot,3, V v,49,19,6,39,88,0 days 00:00:00.110356
2114,reduxjs/reselect,1,v,11,5,4,14,25,0 days 00:00:00.037525
2115,ascoders/weekly,1,,141,3,0,0,141,0 days 00:00:00.066557
2116,sideway/joi,2, v,92,20,6,135,227,0 days 00:00:00.196850
2117,chalk/chalk,1,v,16,1,6,16,32,0 days 00:00:00.029002
2118,go-delve/delve,1,v,10,0,9,13,23,0 days 00:00:00.299509
2119,jumpserver/jumpserver,2, v,31,23,5,103,134,0 days 00:00:00.457807
2120,vnpy/vnpy,2, v,22,6,7,28,50,0 days 00:00:00.340617
2121,PyTorchLightning/pytorch-lightning,1,,16,2,4,98,114,0 days 00:00:00.413165
2122,vadimdemedes/ink,1,v,16,3,4,23,39,0 days 00:00:00.037665
2123,bazelbuild/bazel,1,,47,29,8,56,103,0 days 00:00:01.876034
2124,solidjs/solid,1,v,27,12,1,137,164,0 days 00:00:00.129078
2125,pbatard/rufus,1,v,42,8,15,28,70,0 days 00:00:00.117274
2126,mpv-player/mpv,1,v,34,10,8,46,80,0 days 00:00:02.699856
2127,sebastianbergmann/phpunit,1,,57,0,10,520,577,0 days 00:00:01.419464
2128,urfave/cli,1,v,33,14,8,34,67,0 days 00:00:00.132813
2129,mingrammer/diagrams,1,v,20,9,3,16,36,0 days 00:00:00.033080
2130,jenkinsci/jenkins,7, changes/ jenkins. prototype- hudson- jenkins- builds/,1031,625,2,485,1516,0 days 00:00:04.598767
2131,square/picasso,2, picasso-parent-,10,1,6,12,22,0 days 00:00:00.059898
2132,lyswhut/lx-music-desktop,1,v,39,29,0,46,85,0 days 00:00:00.093840
2133,nextcloud/server,3, theming- v,29,2,23,282,311,0 days 00:00:05.670975
2134,openssl/openssl,7,openssl- OpenSSL-fips- FIPS_TEST_ OpenSSL-engine- BEN_FIPS_TEST_ OpenSSL_FIPS_ OpenSSL_,12,3,4,36,48,0 days 00:00:01.721297
2135,recharts/recharts,1,v,26,10,4,93,119,0 days 00:00:00.118523
2136,Baseflow/PhotoView,2, v,8,2,2,12,20,0 days 00:00:00.030406
2137,OpenZeppelin/openzeppelin-contracts,1,v,30,9,5,22,52,0 days 00:00:00.155888
2138,PHPMailer/PHPMailer,2,phpmailer- v,11,1,6,55,66,0 days 00:00:00.108026
2139,asim/go-micro,106,plugins/wrapper/breaker/hystrix/v plugins/wrapper/breaker/gobreaker/v plugins/registry/mdns/v plugins/registry/gossip/v plugins/broker/snssqs/v plugins/broker/nsq/v plugins/transport/memory/v plugins/broker/memory/v plugins/transport/grpc/v plugins/selector/static/v plugins/wrapper/select/roundrobin/v plugins/wrapper/trace/opencensus/v plugins/broker/sqs/v plugins/client/mucp/v plugins/logger/windowseventlog/v plugins/store/consul/v plugins/config/encoder/xml/v plugins/transport/rabbitmq/v plugins/registry/multi/v plugins/broker/googlepubsub/v plugins/config/encoder/hcl/v plugins/config/source/grpc/v plugins/server/mucp/v plugins/selector/registry/v plugins/broker/rabbitmq/v plugins/config/encoder/yaml/v plugins/config/encoder/cue/v plugins/codec/bsonrpc/v plugins/acme/certmagic/v plugins/config/source/mucp/v plugins/wrapper/select/version/v plugins/broker/redis/v plugins/wrapper/monitoring/victoriametrics/v plugins/transport/utp/v plugins/wrapper/trace/awsxray/v plugins/config/source/runtimevar/v plugins/auth/jwt/v plugins/registry/consul/v plugins/transport/http/v plugins/selector/dns/v plugins/logger/apex/v plugins/transport/quic/v plugins/wrapper/ratelimiter/ratelimit/v plugins/transport/nats/v plugins/wrapper/trace/opentracing/v plugins/broker/stan/v plugins/registry/zookeeper/v plugins/server/http/v plugins/config/source/configmap/v plugins/broker/stomp/v plugins/logger/logrus/v plugins/store/cockroach/v plugins/client/grpc/v plugins/config/source/etcd/v plugins/sync/etcd/v plugins/store/memory/v plugins/config/source/consul/v plugins/broker/nats/v plugins/selector/shard/v plugins/config/source/nacos/v plugins/store/redis/v plugins/broker/segmentio/v plugins/broker/grpc/v plugins/wrapper/ratelimiter/uber/v plugins/logger/zerolog/v plugins/proxy/http/v cmd/protoc-gen-micro/v plugins/store/memcached/v plugins/registry/memory/v plugins/broker/proxy/v plugins/wrapper/trace/datadog/v plugins/registry/eureka/v plugins/server/grpc/v plugins/sync/memory/v plugins/registry/etcd/v plugins/broker/kafka/v plugins/config/source/vault/v plugins/sync/consul/v plugins/transport/tcp/v plugins/broker/gocloud/v plugins/broker/http/v plugins/client/mock/v plugins/codec/msgpackrpc/v plugins/logger/zap/v plugins/wrapper/endpoint/v plugins/wrapper/select/shard/v plugins/codec/jsonrpc2/v plugins/config/encoder/toml/v plugins/codec/segmentio/v plugins/registry/cache/v plugins/broker/mqtt/v plugins/client/http/v plugins/wrapper/validator/v plugins/registry/nats/v plugins/registry/nacos/v plugins/selector/label/v plugins/store/file/v plugins/config/source/url/v plugins/registry/kubernetes/v plugins/wrapper/monitoring/prometheus/v plugins/registry/proxy/v plugins/codec/json-iterator/v v plugins/config/source/pkger/v plugins/store/mysql/v plugins/wrapper/service/v,66,34,4,137,203,0 days 00:00:00.208303
2140,wenyan-lang/wenyan,1,v,3,1,1,12,15,0 days 00:00:00.047963
2141,websockets/ws,2, v,40,5,9,114,154,0 days 00:00:00.268515
2142,appsmithorg/appsmith,3, v. v,13,1,3,129,142,0 days 00:00:00.818862
2143,ossrs/srs,1,v,9,8,0,32,41,0 days 00:00:00.336986
2144,lensapp/lens,1,v,19,5,6,56,75,0 days 00:00:00.571105
2145,bcit-ci/CodeIgniter,2, v,4,0,3,30,34,0 days 00:00:00.639780
2146,pmndrs/react-three-fiber,3,@react-three/test-renderer@ @react-three/fiber@ v,21,3,4,311,332,0 days 00:00:00.275723
2147,dgraph-io/dgraph,1,v,13,1,9,60,73,0 days 00:00:00.416176
2148,taosdata/TDengine,6,tq- ver- autoaddcol_ release/ver- TDB-ver TDB-ver-,48,32,2,117,165,0 days 00:00:02.035244
2149,nuysoft/Mock,1,,1,0,0,7,8,0 days 00:00:00.019038
2150,iawia002/lux,2, v,15,4,4,59,74,0 days 00:00:00.052688
2151,dapr/dapr,1,v,19,9,1,23,42,0 days 00:00:00.332157
2152,google/flatbuffers,2, v,14,0,12,8,22,0 days 00:00:00.127242
2153,withfig/autocomplete,3,spec-build-no# spec-build-number- v,741,30,0,118,859,0 days 00:00:00.938854
2154,philc/vimium,2, v,11,1,5,17,28,0 days 00:00:00.398539
2155,eggjs/egg,1,,70,26,2,43,113,0 days 00:00:00.077600
2156,go-kratos/kratos,1,v,11,1,7,21,32,0 days 00:00:00.091972
2157,wekan/wekan,2, v,610,257,2,27,637,0 days 00:00:01.033576
2158,zeromicro/go-zero,2,tools/goctl/v v,4,0,3,56,60,0 days 00:00:00.095026
2159,valyala/fasthttp,1,v,43,9,3,3,46,0 days 00:00:00.081098
2160,refined-github/refined-github,1,,32,7,0,248,280,0 days 00:00:00.251871
2161,quii/learn-go-with-tests,2, v,22,3,4,27,49,0 days 00:00:00.164749
2162,svg/svgo,2, v,20,7,10,66,86,0 days 00:00:00.070988
2163,PaddlePaddle/Paddle,2,lite-v v,21,5,9,25,46,0 days 00:00:02.477386
2164,magenta/magenta,2, v,7,1,3,42,49,0 days 00:00:00.083553
2165,react-dnd/react-dnd,2, v,45,8,8,100,145,0 days 00:00:00.184981
2166,alibaba/weex,2, v,9,0,5,5,14,0 days 00:00:00.810283
2167,louislam/uptime-kuma,1,,16,14,0,35,51,0 days 00:00:00.148584
2168,arendst/Tasmota,1,v,35,2,5,58,93,0 days 00:00:00.889707
2169,aseprite/aseprite,2, v,9,1,7,84,93,0 days 00:00:00.411926
2170,apollographql/apollo-client,8,apollo-client-preset@ graphql-anywhere@ apollo-cache-inmemory@ apollo-boost@ apollo-cache@ apollo-utilities@ v apollo-client@,35,15,5,398,433,0 days 00:00:01.007337
2171,typicode/lowdb,1,v,21,0,5,36,57,0 days 00:00:00.040421
2172,google/jax,2,jax-v jaxlib-v,2,0,1,110,112,0 days 00:00:00.674123
2173,processing/p5.js,2, v,13,0,10,70,83,0 days 00:00:00.554132
2174,HelloZeroNet/ZeroNet,2,v. v,4,0,2,19,23,0 days 00:00:00.191685
2175,NickeManarin/ScreenToGif,1,,37,9,7,43,80,0 days 00:00:00.079774
2176,CarGuo/GSYVideoPlayer,2, v,9,0,4,60,69,0 days 00:00:00.071737
2177,pubkey/rxdb,1,,58,41,2,55,113,0 days 00:00:00.389385
2178,google/flexbox-layout,1,,6,0,3,14,20,0 days 00:00:00.025765
2179,flameshot-org/flameshot,1,v,11,2,5,30,41,0 days 00:00:00.200625
2180,freqtrade/freqtrade,1,,44,35,2,14,58,0 days 00:00:00.936063
2181,Redocly/redoc,1,v,39,27,1,56,95,0 days 00:00:00.104571
2182,swoole/swoole-src,2,swoole- v,15,3,9,139,154,0 days 00:00:00.623051
2183,SortableJS/Vue.Draggable,2,v. v,24,3,3,25,49,0 days 00:00:00.035225
2184,goharbor/harbor,4, src/v tile- v,20,0,16,70,90,0 days 00:00:00.954825
2185,tzutalin/labelImg,1,v,8,0,4,17,25,0 days 00:00:00.033677
2186,jsdom/jsdom,2, v,98,32,9,144,242,0 days 00:00:00.218553
2187,facebook/flux,1,,4,0,2,9,13,0 days 00:00:00.026691
2188,nosir/cleave.js,1,v,9,0,1,57,66,0 days 00:00:00.153001
2189,google/mediapipe,2, v,4,0,0,38,42,0 days 00:00:00.018984
2190,BoostIO/BoostNote-Legacy,4, v. prototype# v,15,2,6,76,91,0 days 00:00:00.285294
2191,apache/rocketmq,1,rocketmq-all-,7,0,6,9,16,0 days 00:00:00.118798
2192,TanStack/table,1,v,36,4,3,86,122,0 days 00:00:00.120125
2193,mybatis/mybatis-3,1,mybatis-,5,0,4,32,37,0 days 00:00:00.584632
2194,ValveSoftware/Proton,0,,0,0,0,0,0,0 days 00:00:00.066387
2195,mysqljs/mysql,1,v,28,5,9,26,54,0 days 00:00:00.120394
2196,alibaba/ice,3, V v,23,17,1,57,80,0 days 00:00:00.155295
2197,BabylonJS/Babylon.js,2, v,36,10,14,36,72,0 days 00:00:02.181131
2198,reduxjs/redux-thunk,1,v,7,0,3,7,14,0 days 00:00:00.025109
2199,jquense/yup,1,v,27,1,7,67,94,0 days 00:00:00.071820
2200,pmndrs/zustand,1,v,13,1,2,56,69,0 days 00:00:00.085101
2201,linlinjava/litemall,1,v,19,10,2,3,22,0 days 00:00:00.073453
2202,Molunerfinn/PicGo,1,v,11,0,5,21,32,0 days 00:00:00.115797
2203,facebookresearch/fairseq,1,v,8,1,5,6,14,0 days 00:00:00.122944
2204,microsoft/winget-cli,1,v,0,0,0,7,7,0 days 00:00:00.043290
2205,pnpm/pnpm,30,dependencies-hierarchy/ supi@  @pnpm/outdated/ pnpm-default-reporter@ @pnpm/utils@ utils@ supi/ pnpm-default-reporter/ package-requester/ @pnpm/headless@ headless/ fetch-from-npm-registry/ headless@ default-reporter/ pnpm-shrinkwrap/ lifecycle/ package-store/ default-resolver/ tarball-fetcher/ server/ pnpm-list/ package-requester@ config/ npm-resolver/ core-loggers/ default-fetcher/ v utils/ tarball-fetcher/headless/,223,83,5,1094,1317,0 days 00:00:02.312403
2206,ai/nanoid,1,,12,4,2,73,85,0 days 00:00:00.047029
2207,badges/shields,1,,8,2,4,3,11,0 days 00:00:00.203570
2208,oldj/SwitchHosts,1,v,9,1,5,36,45,0 days 00:00:00.120336
2209,cookiecutter/cookiecutter,1,,14,4,8,15,29,0 days 00:00:00.120082
2210,facebookresearch/faiss,1,v,6,0,2,11,17,0 days 00:00:00.228370
2211,eclipse-theia/theia,2, v,43,37,2,33,76,0 days 00:00:00.376356
2212,tachiyomiorg/tachiyomi,1,v,13,0,10,52,65,0 days 00:00:00.202085
2213,facebook/zstd,2,zstd- v,14,4,3,50,64,0 days 00:00:00.486730
2214,restic/restic,1,v,13,2,7,18,31,0 days 00:00:00.361380
2215,fyne-io/fyne,1,v,7,0,5,21,28,0 days 00:00:00.443827
2216,nostra13/Android-Universal-Image-Loader,1,v,3,1,1,12,15,0 days 00:00:00.053485
2217,remix-run/remix,1,v,27,19,1,61,88,0 days 00:00:00.168547
2218,facebook/fresco,1,v,35,14,13,12,47,0 days 00:00:00.288102
2219,facebookexperimental/Recoil,1,,7,0,3,15,22,0 days 00:00:00.066016
2220,less/less.js,1,v,26,5,10,42,68,0 days 00:00:00.164899
2221,brettwooldridge/HikariCP,1,HikariCP-,17,2,8,82,99,0 days 00:00:00.184187
2222,ethereum/solidity,6, prerelease- test testrelease preview- v,9,0,6,95,104,0 days 00:00:01.179459
2223,defunkt/jquery-pjax,2, v,12,4,2,15,27,0 days 00:00:00.030318
2224,angular/material,3, testtag v,12,3,4,63,75,0 days 00:00:00.228525
2225,zloirock/core-js,2, v,41,23,7,156,197,0 days 00:00:00.465828
2226,fingerprintjs/fingerprintjs,2, v,23,1,5,50,73,0 days 00:00:00.071787
2227,gorilla/mux,1,v,8,0,4,6,14,0 days 00:00:00.032960
2228,monicahq/monica,1,v,47,26,4,39,86,0 days 00:00:00.261141
2229,framework7io/framework7,1,v,43,18,9,172,215,0 days 00:00:00.511983
2230,handlebars-lang/handlebars.js,2, v,14,2,6,56,70,0 days 00:00:00.088609
2231,elastic/kibana,1,v,55,10,10,190,245,0 days 00:00:06.447563
2232,yudai/gotty,1,v,1,0,0,14,15,0 days 00:00:00.017522
2233,MichMich/MagicMirror,3,V v. v,20,0,19,15,35,0 days 00:00:00.323547
2234,handsontable/handsontable,2, v,62,24,14,117,179,0 days 00:00:00.498573
2235,oracle/graal,18,libffi- graal- idealgraphvisualizer- vm-enterprise- vm-ce- hcfdis- sdk- antlr-complete- truffle- trufflejson- vm- JDK- graal-vm- hsdis- c1visualizer- batik-all- vm-ee- vscode-,107,51,17,71,178,0 days 00:00:04.021236
2236,plotly/dash,1,v,42,25,3,33,75,0 days 00:00:00.286441
2237,dropzone/dropzone,1,v,32,5,5,83,115,0 days 00:00:00.082058
2238,grafana/k6,1,v,36,11,6,36,72,0 days 00:00:00.202892
2239,testing-library/react-testing-library,1,v,57,0,1,110,167,0 days 00:00:00.079526
2240,sqlitebrowser/sqlitebrowser,4, rc sqlb- v,14,1,8,12,26,0 days 00:00:00.187778
2241,stretchr/testify,1,v,8,0,7,9,17,0 days 00:00:00.044249
2242,PanJiaChen/vue-admin-template,2, v,8,0,5,2,10,0 days 00:00:00.018507
2243,responsively-org/responsively-app,1,v,18,14,3,10,28,0 days 00:00:00.070823
2244,derailed/k9s,2, v,25,7,2,155,180,0 days 00:00:00.120562
2245,twitter/typeahead.js,1,v,4,1,2,11,15,0 days 00:00:00.034869
2246,GoogleChromeLabs/squoosh,1,v,10,0,4,17,27,0 days 00:00:00.060251
2247,gchq/CyberChef,1,v,119,42,2,273,392,0 days 00:00:00.345384
2248,facebook/hhvm,4,nightly- gcc- HHVM- HPHP-,184,2,4,1449,1633,0 days 00:00:06.063398
2249,jamiebuilds/react-loadable,1,v,13,0,2,16,29,0 days 00:00:00.017022
2250,Tencent/tinker,1,v,7,2,2,46,53,0 days 00:00:00.055046
2251,nginx/nginx,1,release-,32,8,6,516,548,0 days 00:00:00.675936
2252,SBoudrias/Inquirer.js,3, v inquirer@,38,1,7,86,124,0 days 00:00:00.078114
2253,nfl/react-helmet,1,,15,3,4,18,33,0 days 00:00:00.024472
2254,backstage/backstage,10,release-2021-07- release-2021-06- release-2021-03- release-2021-11- release-2022-01- release-2021-04- v release-2021-01- release-2021-05- release-2021-10-,85,26,5,83,168,0 days 00:00:01.502543
2255,bokeh/bokeh,1,,23,1,14,50,73,0 days 00:00:01.227082
2256,joewalnes/websocketd,1,v,11,0,1,15,26,0 days 00:00:00.022065
2257,tensorflow/tfjs,18, tfjs-v tfjs-layers-v tfjs-tflite-v test tfjs-vis-v tfjs-react-native-v tfjs-node-gpu-v tfjs-node-v tfjs-backend-webgl-v tfjs-core-v v tfjs-backend-cpu-v tfjs-converter/-v tfjs-data-v tfjs-converter-v tfjs-backend-wasm-v tfjs-automl-v,52,23,2,331,383,0 days 00:00:00.592405
2258,hubotio/hubot,1,v,26,6,11,68,94,0 days 00:00:00.105076
2259,aFarkas/lazysizes,1,,21,7,5,45,66,0 days 00:00:00.049207
2260,sanic-org/sanic,2, v,21,2,13,49,70,0 days 00:00:00.130473
2261,matomo-org/matomo,1,,64,19,20,130,194,0 days 00:00:02.152338
2262,radareorg/radare2,2, release-,42,22,6,43,85,0 days 00:00:01.981601
2263,material-components/material-components-web,32,@material/auto-init@ @material/select@ @material/drawer@ @material/typography@ @material/form-field@ @material/elevation@ @material/radio@ @material/layout-grid@ @material/linear-progress@ @material/card@ @material/icon-toggle@ @material/animation@ @material/ripple@ @material/theme@ @material/fab@ @material/tabs@ @material/checkbox@ @material/selection-control@ @material/menu@ @material/list@ material-components-web@ @material/toolbar@ @material/snackbar@ @material/dialog@ @material/rtl@ @material/base@ @material/button@ @material/textfield@ @material/grid-list@ @material/switch@ @material/slider@ v,65,32,4,538,603,0 days 00:00:00.800271
2264,Shopify/draggable,0,,0,0,0,0,0,0 days 00:00:00.008298
2265,zadam/trilium,2, v,14,10,1,134,148,0 days 00:00:00.367780
2266,matryer/xbar,2, v,9,5,2,5,14,0 days 00:00:00.036148
2267,ionic-team/ionicons,2, v,21,3,8,51,72,0 days 00:00:00.043425
2268,grpc/grpc-go,2,cmd/protoc-gen-go-grpc/v v,46,22,2,57,103,0 days 00:00:00.206914
2269,nondanee/UnblockNeteaseMusic,1,v,23,6,0,34,57,0 days 00:00:00.030689
2270,v2fly/v2ray-core,1,v,185,108,4,217,402,0 days 00:00:00.585815
2271,nginx-proxy/nginx-proxy,1,,11,1,7,5,16,0 days 00:00:00.046002
2272,WordPress/WordPress,1,,41,0,37,534,575,0 days 00:00:02.846871
2273,saleor/saleor,4, demo/v demo/ v,32,21,7,95,127,0 days 00:00:01.294668
2274,notepad-plus-plus/notepad-plus-plus,2, v,42,7,11,159,201,0 days 00:00:00.371516
2275,directus/directus,4, LATEST_STABLE_ aug- v,26,11,5,76,102,0 days 00:00:01.208758
2276,dvajs/dva,7, dva-react-router-3@ dva-core@ dva-no-router@ dva-loading@ dva@ dva-immer@,16,1,2,129,145,0 days 00:00:00.072227
2277,visionmedia/superagent,2, v,50,14,9,84,134,0 days 00:00:00.124967
2278,amark/gun,2, v,5,0,4,24,29,0 days 00:00:00.080504
2279,trojan-gfw/trojan,1,v,24,8,4,19,43,0 days 00:00:00.033371
2280,grafana/loki,1,v,17,4,4,8,25,0 days 00:00:00.373757
2281,youzan/vant-weapp,1,v,16,6,4,91,107,0 days 00:00:00.125038
2282,filebrowser/filebrowser,1,v,34,10,4,62,96,0 days 00:00:00.112497
2283,EastWorld/wechat-app-mall,2, v,14,1,4,8,22,0 days 00:00:00.028910
2284,uber-go/zap,1,v,22,1,6,6,28,0 days 00:00:00.031731
2285,knex/knex,2, v,25,2,16,146,171,0 days 00:00:00.165363
2286,cocos2d/cocos2d-x,1,cocos2d-x-,20,2,8,17,37,0 days 00:00:02.220694
2287,artf/grapesjs,1,v,0,0,0,124,124,0 days 00:00:00.244967
2288,qbittorrent/qBittorrent,1,release-,24,4,16,145,169,0 days 00:00:00.926097
2289,jaegertracing/jaeger,1,v,40,24,3,13,53,0 days 00:00:00.304150
2290,react-grid-layout/react-grid-layout,2, v,22,1,7,86,108,0 days 00:00:00.067458
2291,oblador/react-native-vector-icons,1,v,37,3,6,42,79,0 days 00:00:00.048020
2292,wagerfield/parallax,1,v,6,0,2,5,11,0 days 00:00:00.016948
2293,briannesbitt/Carbon,1,,99,54,5,79,178,0 days 00:00:00.342460
2294,spotify/luigi,2, v,13,4,8,46,59,0 days 00:00:00.200408
2295,simdjson/simdjson,1,v,12,0,5,26,38,0 days 00:00:00.128064
2296,apache/shardingsphere,2, shardingsphere-ui-,13,2,8,20,33,0 days 00:00:01.709317
2297,buger/goreplay,2, v,18,3,9,23,41,0 days 00:00:00.069651
2298,semantic-release/semantic-release,2, v,62,5,2,206,268,0 days 00:00:00.171851
2299,ustbhuangyi/better-scroll,3, v. v,17,6,4,41,58,0 days 00:00:00.102044
2300,outline/outline,2, v,64,42,1,39,103,0 days 00:00:00.347601
2301,nikic/PHP-Parser,1,v,24,5,9,41,65,0 days 00:00:00.082633
2302,binux/pyspider,1,v,3,0,1,10,13,0 days 00:00:00.052843
2303,motdotla/dotenv,1,v,33,4,6,26,59,0 days 00:00:00.039048
2304,gentilkiwi/mimikatz,0,,0,0,0,0,0,0 days 00:00:00.008940
2305,dotnet/maui,3,release-  rui-,7,0,4,8,15,0 days 00:00:00.748271
2306,zulip/zulip,3, shared- enterprise-,30,8,11,55,85,0 days 00:00:02.301489
2307,infernojs/inferno,2, v,38,18,5,160,198,0 days 00:00:00.508872
2308,openzipkin/zipkin,3, zipkin- v,57,27,4,136,193,0 days 00:00:00.354254
2309,JedWatson/classnames,1,v,4,1,2,16,20,0 days 00:00:00.046559
2310,jhao104/proxy_pool,1,,10,1,6,2,12,0 days 00:00:00.046656
2311,jasmine/jasmine,1,v,28,4,17,29,57,0 days 00:00:00.152640
2312,janl/mustache.js,2, v,20,3,8,23,43,0 days 00:00:00.051203
2313,wulkano/Kap,1,v,13,2,5,14,27,0 days 00:00:00.068419
2314,teambit/bit,1,v,18,6,5,121,139,0 days 00:00:00.403843
2315,airbnb/visx,1,v,29,6,0,200,229,0 days 00:00:00.252506
2316,auth0/node-jsonwebtoken,1,v,29,3,5,42,71,0 days 00:00:00.038574
2317,matplotlib/matplotlib,2, v,17,0,16,45,62,0 days 00:00:02.193908
2318,KaTeX/KaTeX,1,v,15,2,9,41,56,0 days 00:00:00.114609
2319,redis/node-redis,9,search@ json@ graph@ redis@ v client@ time-series@ v. bloom@,24,5,9,85,109,0 days 00:00:00.183681
2320,facebook/yoga,2, v,19,5,8,23,42,0 days 00:00:00.196284
2321,tailwindlabs/heroicons,1,v,4,0,1,15,19,0 days 00:00:00.025043
2322,ipython/ipython,3, dev- rel-,76,34,15,50,126,0 days 00:00:01.544678
2323,huiyadanli/RevokeMsgPatcher,1,,15,2,2,0,15,0 days 00:00:00.017560
2324,catchorg/Catch2,3,V v. v,24,6,6,62,86,0 days 00:00:00.199809
2325,ueberdosis/tiptap,5,tiptap-commands@ tiptap-extensions@ tiptap-utils@ v tiptap@,59,4,0,305,364,0 days 00:00:00.561495
2326,quantopian/zipline,2, v,10,0,8,16,26,0 days 00:00:00.509684
2327,dotnet/roslyn,15,Visual-Studio-2022-Version- Visual-Studio-2017-Version- Visual-Studio-2019-Version- NetFx.Toolset. version- perf-assets-v Visual-Studio-2017-Preview-Version- Visual-Studio- Visual-Studio-2017-Preview-2-Version- Visual-Studio-2017-Preview-3-Version- v toolset_ Visual-Studio-2017-Preview-1-Version- Oss.Scan. Visual-Studio-2017-Preview-6-Version-,47,3,18,193,240,0 days 00:00:04.722052
2328,bower/bower,2, v,18,8,4,83,101,0 days 00:00:00.133927
2329,lottie-react-native/lottie-react-native,1,v,16,1,9,37,53,0 days 00:00:00.054737
2330,cool-RR/PySnooper,1,,7,0,2,10,17,0 days 00:00:00.019402
2331,tailwindlabs/headlessui,4,@headlessui/react@v @headlessui/vue@v @headlessui/tailwindcss@v v,10,2,2,33,43,0 days 00:00:00.031192
2332,icsharpcode/ILSpy,2, v,16,2,11,9,25,0 days 00:00:00.441598
2333,DapperLib/Dapper,1,,31,4,6,13,44,0 days 00:00:00.069216
2334,designmodo/Flat-UI,1,,5,0,3,5,10,0 days 00:00:00.015560
2335,fullcalendar/fullcalendar,1,v,44,14,17,72,116,0 days 00:00:00.335665
2336,pouchdb/pouchdb,2, v,24,7,8,47,71,0 days 00:00:00.342620
2337,airbnb/react-sketchapp,2, v,20,9,5,27,47,0 days 00:00:00.046860
2338,flatpickr/flatpickr,2, v,23,3,4,121,144,0 days 00:00:00.149140
2339,appium/appium,17, @appium/fake-driver@ @appium/execute-driver-plugin@ @appium/test-support@ @appium/base-driver@ @appium/eslint-config-appium@ @appium/opencv@ @appium/images-plugin@ @appium/doctor@ @appium/fake-plugin@ @appium/gulp-plugins@ @appium/types@ v @appium/schema@ @appium/support@ @appium/base-plugin@ @appium/docutils@,136,17,15,415,551,0 days 00:00:00.944850
2340,emotion-js/emotion,56,@emotion/eslint-plugin@ @emotion/primitives@ @emotion/babel-utils@ @emotion/styled.macro@ create-emotion@ @emotion/styled@ @emotion/css@ @emotion/sheet@ example@ jest-emotion@ @emotion/css.macro@ @emotion/compat-cache@ @emotion/hash@ @emotion/stylis@ @emotion/preact-styled@ @emotion/babel-plugin-core@ @emotion/serialize@ @emotion/snapshot-serializer@ @emotion/is-prop-valid@ emotion-server@ emotion-site@ @emotion/css-prettifier@ babel-tester@ babel-preset-emotion-dev@ babel-plugin-macros-register@ @emotion/react@ @emotion/babel-plugin-jsx-pragmatic@ @emotion/babel-preset-css-prop@ ssr-benchmarks@ @emotion/native@ old-babel-tester@ @emotion/jest@ create-emotion-server@ @emotion/styled-base@ @emotion/babel-plugin@ @emotion/cache@ @emotion/core@ benchmarks@ @emotion/memoize@ @emotion/preact-styled-base@ @emotion/preact-core@ emotion-theming@ @emotion/unitless@ babel-plugin-emotion-test@ @emotion/server@ babel-plugin-emotion@ test-utils@ @emotion/primitives-core@ my-razzle-app@ @emotion/weak-memoize@ build@ v @emotion/provider@ emotion@ eslint-plugin-emotion@ @emotion/utils@,40,7,2,637,677,0 days 00:00:00.547031
2341,2dust/v2rayNG,1,,8,1,0,111,119,0 days 00:00:00.050871
2342,ChainSafe/web3.js,2, v,25,15,5,54,79,0 days 00:00:00.176052
2343,LMAX-Exchange/disruptor,1,,9,0,3,22,31,0 days 00:00:00.054578
2344,acdlite/recompose,3, rx-recompose-v v,29,9,4,32,61,0 days 00:00:00.157264
2345,kovidgoyal/kitty,1,v,25,8,9,58,83,0 days 00:00:00.675209
2346,netlify/netlify-cms,38, netlify-cms-backend-test@ netlify-cms-widget-datetime@ netlify-cms-widget-list@ netlify-cms-backend-gitlab@ netlify-cms-widget-file@ netlify-cms-widget-select@ netlify-cms-lib-util@ netlify-cms-backend-proxy@ netlify-cms-widget-number@ netlify-cms-proxy-server@ netlify-cms-locales@ netlify-cms-lib-widgets@ netlify-cms@ netlify-cms-widget-object@ netlify-cms-media-library-uploadcare@ netlify-cms-default-exports@ netlify-cms-widget-relation@ netlify-cms-widget-markdown@ netlify-cms-backend-bitbucket@ netlify-cms-widget-string@ ember-legacy- netlify-cms-widget-boolean@ netlify-cms-lib-auth@ netlify-cms-widget-image@ netlify-cms-widget-text@ netlify-cms-backend-github@ netlify-cms-widget-colorstring@ netlify-cms-widget-map@ netlify-cms-widget-code@ netlify-cms-widget-date@ netlify-cms-backend-azure@ netlify-cms-core@ netlify-cms-media-library-cloudinary@ netlify-cms-app@ netlify-cms-backend-git-gateway@ netlify-cms-editor-component-image@ netlify-cms-ui-default@,102,17,3,1659,1761,0 days 00:00:03.534269
2347,jellyfin/jellyfin,1,v,8,1,4,30,38,0 days 00:00:01.371821
2348,cloudreve/Cloudreve,1,,7,1,5,14,21,0 days 00:00:00.043445
2349,yaronn/blessed-contrib,1,v,0,0,0,10,10,0 days 00:00:00.028047
2350,microsoft/react-native-windows,1,react-native-windows_v,8,0,4,146,154,0 days 00:00:00.507276
2351,allinurl/goaccess,1,v,10,0,8,31,41,0 days 00:00:00.262137
2352,Anuken/Mindustry,1,v,136,102,4,0,136,0 days 00:00:00.681893
2353,keystonejs/keystone-classic,2, v,3,0,2,63,66,0 days 00:00:00.670819
2354,desktop/desktop,1,release-,22,6,8,136,158,0 days 00:00:01.508228
2355,pyg-team/pytorch_geometric,1,,9,1,5,22,31,0 days 00:00:00.354952
2356,nhn/tui.editor,6, editor@ editor-plugin-color-syntax@ v editor-plugin-table-merged-cell@ vue-editor@,27,11,7,125,152,0 days 00:00:00.259446
2357,nodemailer/nodemailer,1,v,47,6,7,170,217,0 days 00:00:00.254605
2358,JaidedAI/EasyOCR,3, pre-v v,4,0,2,12,16,0 days 00:00:00.036762
2359,riot/riot,1,v,44,6,7,155,199,0 days 00:00:00.272961
2360,jina-ai/jina,2, v,25,14,0,280,305,0 days 00:00:00.474965
2361,gabime/spdlog,1,v,19,4,10,15,34,0 days 00:00:00.294321
2362,aosp-mirror/platform_frameworks_base,27,android-n-iot-release-polk-at gradle_ android-s-preview- android-n-iot-preview- android-wear-o-preview- studio- android-wear-n-preview- android-n-preview- platform-tools- android-o-iot-preview- android-q-preview- android-wear-p-preview- android-sdk-support_r android-p-preview- android-l-preview_r android-s-beta- android-sdk-adt_r android-o-mr1-iot-release- android-o-preview- android-m-preview- afw-test-harness- android-n-iot-release-smart-display-r android-t-preview- android-r-beta- android-n-iot-release-lg-thinq-wk android-n-iot-release-ihome-igv android-r-preview-,17,1,8,73,90,0 days 00:00:43.500007
2363,ampproject/amphtml,2, test-,1178,519,0,0,1178,0 days 00:00:02.622105
2364,kivy/kivy,1,,13,0,8,13,26,0 days 00:00:00.611411
2365,Eloston/ungoogled-chromium,1,,0,0,0,2,2,0 days 00:00:00.027431
2366,you-dont-need/You-Dont-Need-Lodash-Underscore,1,v,14,1,5,6,20,0 days 00:00:00.028455
2367,Tencent/ncnn,1,,32,9,3,0,32,0 days 00:00:00.234745
2368,pqrs-org/Karabiner-Elements,1,v,28,10,5,0,28,0 days 00:00:00.256620
2369,Tencent/vConsole,2, v,24,9,5,34,58,0 days 00:00:00.048339
2370,magic-wormhole/magic-wormhole,1,,12,1,6,22,34,0 days 00:00:00.088786
2371,iovisor/bcc,1,v,24,1,6,9,33,0 days 00:00:00.181362
2372,plotly/plotly.js,1,v,72,54,3,133,205,0 days 00:00:01.177274
2373,browsh-org/browsh,1,v,5,2,1,45,50,0 days 00:00:00.027379
2374,framer/motion,1,v,60,27,3,243,303,0 days 00:00:00.321171
2375,Tencent/MMKV,1,v,2,0,1,29,31,0 days 00:00:00.069612
2376,facebook/prophet,2, v,8,0,7,2,10,0 days 00:00:00.039965
2377,hashcat/hashcat,1,v,17,3,9,8,25,0 days 00:00:00.319812
2378,go-redis/redis,4,extra/redisotel/v extra/rediscensus/v extra/rediscmd/v v,53,11,7,191,244,0 days 00:00:00.176761
2379,antonmedv/fx,1,,27,6,1,34,61,0 days 00:00:00.034396
2380,frappe/charts,2, v,5,1,1,13,18,0 days 00:00:00.025236
2381,node-red/node-red,2, v,26,3,18,99,125,0 days 00:00:00.501914
2382,facebookarchive/prepack,2, v,0,0,0,47,47,0 days 00:00:00.084889
2383,mkdocs/mkdocs,1,,20,6,9,27,47,0 days 00:00:00.106367
2384,joke2k/faker,1,v,95,3,3,138,233,0 days 00:00:00.236232
2385,chrislusf/seaweedfs,2, v,218,155,2,0,218,0 days 00:00:00.495979
2386,hdodenhof/CircleImageView,1,v,9,1,5,6,15,0 days 00:00:00.015482
2387,InstaPy/InstaPy,2, v,6,2,1,37,43,0 days 00:00:00.231130
2388,doocs/leetcode,1,v,1,0,0,18,19,0 days 00:00:00.277882
2389,cayleygraph/cayley,1,v,5,0,3,10,15,0 days 00:00:00.062339
2390,checkly/headless-recorder,1,v,8,3,2,10,18,0 days 00:00:00.021444
2391,erusev/parsedown,2, v,17,3,4,51,68,0 days 00:00:00.041648
2392,krisk/Fuse,2, v,25,7,5,50,75,0 days 00:00:00.046518
2393,fmtlib/fmt,2, v,23,2,13,16,39,0 days 00:00:00.398821
2394,localtunnel/localtunnel,1,v,13,0,1,20,33,0 days 00:00:00.018471
2395,greensock/GSAP,1,,26,0,0,72,98,0 days 00:00:00.039869
2396,sweetalert2/sweetalert2,1,v,129,25,1,544,673,0 days 00:00:00.801381
2397,jarun/nnn,1,v,34,10,4,2,36,0 days 00:00:00.251291
2398,esp8266/Arduino,1,,9,0,6,13,22,0 days 00:00:00.182899
2399,aframevr/aframe,1,v,13,0,9,14,27,0 days 00:00:00.250403
2400,barryvdh/laravel-debugbar,2,V v,24,5,6,99,123,0 days 00:00:00.105368
2401,iBotPeaches/Apktool,1,v,12,2,8,23,35,0 days 00:00:00.120234
2402,browserify/browserify,2, v,149,16,2,264,413,0 days 00:00:00.320205
2403,google/filament,1,v,23,13,5,70,93,0 days 00:00:00.249538
2404,micropython/micropython,1,v,19,4,10,31,50,0 days 00:00:00.763243
2405,Kr328/ClashForAndroid,2, v,18,8,1,94,112,0 days 00:00:00.080745
2406,darkreader/darkreader,1,v,1,0,0,46,47,0 days 00:00:00.256262
2407,feathersjs/feathers,25, @feathersjs/cli@ @feathersjs/feathers@ @feathersjs/adapter-commons@ @feathersjs/express@ @feathersjs/authentication-oauth2@ @feathersjs/authentication-client@ @feathersjs/adapter-tests@ @feathersjs/socketio@ @feathersjs/primus@ @feathersjs/primus-client@ @feathersjs/commons@ @feathersjs/authentication-local@ generator-feathers-plugin@ @feathersjs/authentication-oauth1@ @feathersjs/configuration@ @feathersjs/client@ @feathersjs/rest-client@ @feathersjs/authentication-jwt@ @feathersjs/transport-commons@ generator-feathers@ @feathersjs/errors@ @feathersjs/authentication@ v @feathersjs/socketio-client@,22,1,7,211,233,0 days 00:00:00.215176
2408,dogecoin/dogecoin,2, v,17,3,10,64,81,0 days 00:00:00.897280
2409,be5invis/Iosevka,1,v,59,28,6,163,222,0 days 00:00:00.206306
2410,sass/sass,17,proposal.identifier-escapes.draft- proposal.slash-separator.draft- proposal.content-args.draft- proposal.more-math-functions.draft- proposal.color-4-rgb-hsl.draft- proposal.css-imports.draft- proposal.media-ranges.draft- proposal.supports-general.draft- proposal.new-js-importer.draft- proposal.import-configuration.draft- proposal.new-functions-and-values-api.draft- proposal.logger.draft- proposal.min-max.draft- proposal.module-system.draft- proposal.nested-map-functions.draft- proposal.at-rule-interpolation.draft- proposal.forward-with.draft-,15,1,2,26,41,0 days 00:00:00.028003
2411,AvaloniaUI/Avalonia,2, nuget-release-,7,0,6,32,39,0 days 00:00:00.898469
2412,kubernetes/kops,2, v,20,0,12,63,83,0 days 00:00:01.242678
2413,FormidableLabs/webpack-dashboard,2, v,12,1,2,31,43,0 days 00:00:00.029081
2414,infinitered/ignite,2, v,52,14,2,94,146,0 days 00:00:00.137513
2415,vitessio/vitess,2,vitess-parent- v,20,0,10,39,59,0 days 00:00:01.860623
2416,RasaHQ/rasa,1,,33,15,7,233,266,0 days 00:00:01.647127
2417,rsms/inter,2,display-beta- v,38,18,4,3,41,0 days 00:00:00.082223
2418,microsoft/LightGBM,1,v,9,1,6,19,28,0 days 00:00:00.129737
2419,alibaba/ARouter,1,,4,0,2,16,20,0 days 00:00:00.020935
2420,bootstrap-vue/bootstrap-vue,2, v,47,32,2,66,113,0 days 00:00:00.427969
2421,medcl/elasticsearch-analysis-ik,1,v,42,1,1,130,172,0 days 00:00:00.064883
2422,yiisoft/yii2,1,,1,0,0,61,62,0 days 00:00:00.996781
2423,janpaepke/ScrollMagic,1,v,5,1,2,21,26,0 days 00:00:00.033975
2424,CopyTranslator/CopyTranslator,2, v,6,0,3,14,20,0 days 00:00:00.050259
2425,uNetworking/uWebSockets,1,v,66,13,4,26,92,0 days 00:00:00.093497
2426,marcuswestin/store.js,1,v,4,0,2,31,35,0 days 00:00:00.026555
2427,gpujs/gpu.js,1,,21,4,2,55,76,0 days 00:00:00.076549
2428,google/libphonenumber,2,libphonenumber- v,20,7,1,149,169,0 days 00:00:00.302896
2429,hapijs/hapi,2, v,129,66,6,194,323,0 days 00:00:00.476668
2430,koel/koel,1,v,18,6,6,38,56,0 days 00:00:00.098580
2431,containers/podman,1,v,21,5,4,95,116,0 days 00:00:01.196995
2432,docker-slim/docker-slim,1,,38,3,9,17,55,0 days 00:00:00.046463
2433,material-components/material-components-android,1,,7,0,6,1,8,0 days 00:00:00.195081
2434,wangeditor-team/wangEditor,12,@wangeditor/basic-modules@ @wangeditor/upload-image-module@ @wangeditor/video-module@ @wangeditor/core@ @wangeditor/editor-for-vue@ @wangeditor/editor-cattle@ @wangeditor/table-module@ @wangeditor/code-highlight@ @wangeditor/editor@ v @wangeditor/editor-for-react@ @wangeditor/list-module@,91,5,3,458,549,0 days 00:00:00.478363
2435,Qv2ray/Qv2ray,1,v,15,9,1,32,47,0 days 00:00:00.364723
2436,Tencent/QMUI_Android,1,,4,0,3,20,24,0 days 00:00:00.077222
2437,wting/autojump,1,release-v,31,2,5,22,53,0 days 00:00:00.193092
2438,thomaspark/bootswatch,1,v,15,0,13,34,49,0 days 00:00:00.167766
2439,graphql/graphiql,22,monaco-graphql@ codemirror-graphql@ @graphiql/react@  example-graphiql-webpack@ example-graphiql-cdn@ graphiql-example-webpack@ example-graphiql-create-react-app@ graphiql-example-cdn@ graphiql@ graphql-language-service-server@ graphql-language-service-interface@ graphql-language-service-utils@ graphiql-parcel-example@ example-monaco-graphql-webpack@ graphql-language-service@ graphiql-2-rfc-context@ graphql-language-service-parser@ graphql-language-service-cli@ graphql-language-service-types@ @graphiql/toolkit@ v,44,3,3,473,517,0 days 00:00:00.462165
2440,commitizen/cz-cli,2, v,16,0,2,58,74,0 days 00:00:00.044735
2441,kamranahmedse/driver.js,2, v,8,0,1,27,35,0 days 00:00:00.030806
2442,foreversd/forever,2, v,17,1,8,51,68,0 days 00:00:00.049978
2443,infinitered/reactotron,1,v,46,22,3,40,86,0 days 00:00:00.092854
2444,markdown-it/markdown-it,1,,29,5,5,47,76,0 days 00:00:00.060133
2445,hashicorp/packer,2, v,21,5,15,82,103,0 days 00:00:01.048192
2446,xbmc/xbmc,11,Eden_rc Gotham_rc Dharma_beta Frodo_rc Frodo_beta Gotham-beta Gotham_beta Frodo_alpha Eden_beta Gotham_alpha Dharma_rc,12,8,2,29,41,0 days 00:00:01.516809
2447,vuejs/vue,2, v,15,4,7,145,160,0 days 00:00:00.273274
2448,hyperledger/fabric,2,baseimage-v v,10,0,8,34,44,0 days 00:00:00.926596
2449,ipfs/go-ipfs,2,floodsub- v,12,0,5,40,52,0 days 00:00:00.732232
2450,facebook/react,2, v,36,7,14,58,94,0 days 00:00:00.850795
2451,airbnb/javascript,2,eslint-config-airbnb-base-v eslint-config-airbnb-v,39,10,4,62,101,0 days 00:00:00.112946
2452,prestodb/presto,1,,272,237,0,51,323,0 days 00:00:01.308489
2453,twbs/bootstrap,1,v,23,3,15,36,59,0 days 00:00:01.067275
2454,facebook/react-native,2, v,67,51,8,144,211,0 days 00:00:01.463415
2455,d3/d3,1,v,91,26,7,197,288,0 days 00:00:00.504995
2456,ytdl-org/youtube-dl,1,,0,0,0,1113,1113,0 days 00:00:02.919311
2457,facebook/create-react-app,13,cra-template-typescript@ react-error-overlay@ react-app-polyfill@ babel-plugin-named-asset-import@ react-dev-utils@ confusing-browser-globals@ eslint-config-react-app@ cra-template@ react-scripts@ timer-react-scripts@ babel-preset-react-app@ v create-react-app@,40,3,1,370,410,0 days 00:00:00.599902
2458,axios/axios,2, v,27,8,8,30,57,0 days 00:00:00.076094
2459,microsoft/vscode,7, bad translation/ vsda-v master-with-conflict- v release/,92,73,2,118,210,0 days 00:00:05.157248
2460,golang/go,7,release.r weekly.2010-10- go weekly.2011-02- weekly.2010-12- weekly.2009-11- weekly.2011-03-,35,4,18,152,187,0 days 00:00:03.394861
2461,vercel/next.js,2, v,33,8,7,122,155,0 days 00:00:00.929513
2462,tensorflow/tensorflow,3, tflite-v v,33,7,11,53,86,0 days 00:00:07.506184
2463,microsoft/terminal,2, v,3,0,2,91,94,0 days 00:00:00.463234
2464,electron/electron,1,v,113,60,16,595,708,0 days 00:00:07.031996
2465,mrdoob/three.js,1,r,132,97,5,0,132,0 days 00:00:02.420774
2466,angular/angular,4, ngcontainer_ v zone.js-,42,16,11,257,299,0 days 00:00:02.092681
2467,nodejs/node,2,heads/tags/v v,254,191,25,449,703,0 days 00:00:04.994213
2468,microsoft/TypeScript,1,v,12,2,2,120,132,0 days 00:00:02.332963
2469,puppeteer/puppeteer,1,v,61,43,1,33,94,0 days 00:00:00.148467
2470,iluwatar/java-design-patterns,1,,19,3,13,0,19,0 days 00:00:00.227192
2471,microsoft/PowerToys,2, v,28,17,3,31,59,0 days 00:00:00.396664
2472,ant-design/ant-design,1,,79,64,4,329,408,0 days 00:00:01.343100
2473,nvbn/thefuck,1,,79,33,7,4,83,0 days 00:00:00.069765
2474,tensorflow/models,2,v. v,19,3,9,6,25,0 days 00:00:00.733005
2475,mui/material-ui,6, olivier-material-ui-icons@ olivier-material-ui-lab@ olivier-material-ui-codemod@ v olivier-eslint-plugin-material-ui@,57,39,10,177,234,0 days 00:00:01.449973
2476,FortAwesome/Font-Awesome,2, v,30,1,11,40,70,0 days 00:00:00.068927
2477,Genymobile/scrcpy,1,v,25,9,5,2,27,0 days 00:00:00.094855
2478,laravel/laravel,1,v,40,6,15,134,174,0 days 00:00:00.371060
2479,kubernetes/kubernetes,1,v,45,20,19,329,374,0 days 00:00:07.508168
2480,huggingface/transformers,2, v,46,41,1,49,95,0 days 00:00:00.614553
2481,bitcoin/bitcoin,1,v,25,0,20,82,107,0 days 00:00:02.261125
2482,opencv/opencv,1,,14,0,13,64,78,0 days 00:00:01.707125
2483,typicode/json-server,2, v,17,2,6,106,123,0 days 00:00:00.077991
2484,django/django,1,,19,0,15,248,267,0 days 00:00:02.595912
2485,storybookjs/storybook,1,v,107,16,13,323,430,0 days 00:00:02.938590
2486,hakimel/reveal.js,1,,27,2,19,11,38,0 days 00:00:00.141572
2487,moby/moby,5,upstream/  autorun/ builder/ v,30,9,9,114,144,0 days 00:00:03.276574
2488,webpack/webpack,1,v,152,121,5,224,376,0 days 00:00:01.296339
2489,gin-gonic/gin,1,v,13,3,8,13,26,0 days 00:00:00.081416
2490,spring-projects/spring-boot,1,v,4,0,3,35,39,0 days 00:00:01.967566
2491,angular/angular.js,1,v,11,0,9,136,147,0 days 00:00:00.742730
2492,gohugoio/hugo,1,v,93,72,10,101,194,0 days 00:00:00.550130
2493,netdata/netdata,4, issue_ poc v,40,13,11,19,59,0 days 00:00:00.958075
2494,pallets/flask,1,,16,5,10,25,41,0 days 00:00:00.227915
2495,reduxjs/redux,1,v,26,11,5,42,68,0 days 00:00:00.163454
2496,sveltejs/svelte,1,v,134,87,2,244,378,0 days 00:00:00.438466
2497,tailwindlabs/tailwindcss,1,v,21,9,8,127,148,0 days 00:00:00.445005
2498,expressjs/express,1,,61,31,11,185,246,0 days 00:00:00.443878
2499,chartjs/Chart.js,2, v,21,7,10,31,52,0 days 00:00:00.224854
2500,fatedier/frp,1,v,42,16,11,30,72,0 days 00:00:00.058616
2501,jquery/jquery,1,,23,0,21,63,86,0 days 00:00:00.396994
2502,socketio/socket.io,1,,30,2,12,118,148,0 days 00:00:00.127455
2503,521xueweihan/HelloGitHub,1,vol.,19,2,1,0,19,0 days 00:00:00.017342
2504,adam-p/markdown-here,1,v,15,6,6,34,49,0 days 00:00:00.043724
2505,keras-team/keras,2, v,15,0,11,40,55,0 days 00:00:00.371779
2506,apple/swift,6,tranch smokes tranche ran- release- ran,9,1,2,2,11,0 days 00:00:03.917217
2507,atom/atom,2, v,271,217,2,104,375,0 days 00:00:02.333079
2508,protocolbuffers/protobuf,1,v,29,3,13,46,75,0 days 00:00:00.469081
2509,shadowsocks/shadowsocks-windows,1,,13,3,7,49,62,0 days 00:00:00.084605
2510,coder/code-server,2, v,20,9,4,22,42,0 days 00:00:00.227376
2511,redis/redis,3, v twitter-,14,1,11,157,171,0 days 00:00:00.827599
2512,lodash/lodash,1,,48,35,3,59,107,0 days 00:00:00.589134
2513,pytorch/pytorch,17,ciflow/binaries_conda/ ciflow/none/ ciflow/slow-gradcheck/ ciflow/slow/ ciflow/trunk/ ciflow/macos/ ciflow/periodic/ ciflow/linux/ ciflow/cpu/ ciflow/nightly/ ciflow/libtorch/ ciflow/all/ ciflow/cuda/ ciflow/binaries/ ci/binaries/ v ciflow/android/,119,59,14,49,168,0 days 00:00:03.400186
2514,h5bp/html5-boilerplate,2, v,19,2,12,10,29,0 days 00:00:00.112020
2515,elastic/elasticsearch,1,v,67,22,15,231,298,0 days 00:00:06.592067
2516,apache/echarts,1,,29,5,14,64,93,0 days 00:00:00.717150
2517,godotengine/godot,0,,0,0,0,0,0,0 days 00:00:00.008595
2518,scikit-learn/scikit-learn,2, sprint,26,0,19,30,56,0 days 00:00:01.821783
2519,azl397985856/leetcode,2, v,35,15,3,5,40,0 days 00:00:00.073447
2520,home-assistant/core,1,,129,126,0,397,526,0 days 00:00:03.460880
2521,ansible/ansible,2, v,26,4,13,174,200,0 days 00:00:03.920892
2522,mermaid-js/mermaid,3, real- v,21,7,8,76,97,0 days 00:00:00.288828
2523,psf/requests,2, v,43,11,22,101,144,0 days 00:00:00.400594
2524,grafana/grafana,2, v,46,7,9,181,227,0 days 00:00:02.489324
2525,spring-projects/spring-framework,1,v,1,0,0,20,21,0 days 00:00:01.197107
2526,nestjs/nest,2, v,33,18,5,167,200,0 days 00:00:00.924565
2527,moment/moment,1,,40,14,12,46,86,0 days 00:00:00.318702
2528,remix-run/react-router,1,v,39,17,10,76,115,0 days 00:00:00.445087
2529,ionic-team/ionic-framework,2, v,43,26,10,140,183,0 days 00:00:01.282837
2530,tiangolo/fastapi,2, v,77,36,3,52,129,0 days 00:00:00.120919
2531,ReactiveX/RxJava,3, rxjava- v,25,10,3,183,208,0 days 00:00:00.329108
2532,tesseract-ocr/tesseract,1,,15,0,10,8,23,0 days 00:00:00.322137
2533,apache/superset,4, airbnb_prod. superset-helm-chart- v,82,37,8,191,273,0 days 00:00:00.921700
2534,syncthing/syncthing,2,phabricator/diff/ v,36,15,10,240,276,0 days 00:00:00.612164
2535,google/guava,3,failureaccess-v jdk5-backport-v v,44,8,19,15,59,0 days 00:00:00.405801
2536,junegunn/fzf,1,,27,8,13,76,103,0 days 00:00:00.124435
2537,strapi/strapi,1,v,16,7,2,79,95,0 days 00:00:01.089605
2538,3b1b/manim,2, v,8,1,1,10,18,0 days 00:00:00.315634
2539,soimort/you-get,1,v,3,1,1,143,146,0 days 00:00:00.268131
2540,scrapy/scrapy,1,,32,1,17,58,90,0 days 00:00:00.539802
2541,prettier/prettier,2, v,39,19,8,71,110,0 days 00:00:00.438071
2542,serverless/serverless,3,v. beta v,181,150,3,175,356,0 days 00:00:01.067816
2543,juliangarnier/anime,2, v,8,2,5,6,14,0 days 00:00:00.039829
2544,prometheus/prometheus,2, v,67,32,5,79,146,0 days 00:00:00.560134
2545,vitejs/vite,8,plugin-react-refresh@ create-app@ plugin-legacy@ plugin-vue-jsx@ create-vite@ plugin-vue@ plugin-react@ v,21,3,2,261,282,0 days 00:00:00.306366
2546,square/okhttp,2, parent-,39,11,12,56,95,0 days 00:00:00.390704
2547,meteor/meteor,59,release/sso- release/node-no-fsevents- release/fix-issue- test release/ANUBHAV-ERROR-APP-TEST@ release/proxy-minimum-tags- release/nim-pull-requests-test- temp release/selftest-built- release/TEMPLATE-CURRENT-DATA@ release/blaze-test-rc release/emily-test-old release/SLAVA-TEST@ release/PLUGINS-PREVIEW@ release/OPLOG-BACKLOG@ release/METEOR@refreshpolicy-test. release/template-engine-preview-release- release/redis-wip- release/METEOR@new-version-solver- release/ANUBHAV-TEST@ release/fix- release/rendering-preview- release/METEOR@ release/invalidation-key-v release/linker-pre release/mongo-new-devbundle- release/GLASSER-TEST@ release/blaze-rc release/test-fix- release/bundler-profile- release/METEOR@cordova- release/galaxy-zdt- release/oplog-limits-preview- release/galaxy-appconfig- release/CORDOVA-PREVIEW@ release/GLASSER-TEST@maybe-rc release/GITHUBBLE@ release-fixed/CORDOVA-PREVIEW@ release/galaxy- mother-dev-bundle-node- release/ release/oplog-alpha release/blaze-refactor-rc release/oplog-limits-preview-blaze- release/test-slow-tests- release/galaxy-follower- release/download-test- ejson@ accounts-password@ release/METEOR@CORDOVA- release/WINDOWS-PREVIEW@ v release/galaxy-sso- release/EACH-IN@ release/TMEASDAY-RELEASE-TESTING@ release/template-engine-preview- note release/test-fooz release/oplog-preview-,68,14,21,328,396,0 days 00:00:02.031099
2548,localstack/localstack,2,localstack- v,8,0,4,41,49,0 days 00:00:00.171824
2549,ColorlibHQ/AdminLTE,2, v,13,2,5,47,60,0 days 00:00:00.159723
2550,babel/babel,1,v,90,55,8,606,696,0 days 00:00:01.568886
2551,parcel-bundler/parcel,11,@parcel/test-utils@ @parcel/integration-tests@ parcel-bundler@ @parcel/fs@ @parcel/logger@ @parcel/babel-register@ @parcel/watcher@ @parcel/utils@ v @react-spectrum/actiongroup@ @parcel/workers@,19,11,4,52,71,0 days 00:00:00.202758
2552,caddyserver/caddy,1,v,14,2,10,49,63,0 days 00:00:00.354998
2553,yarnpkg/yarn,2, v,50,35,1,114,164,0 days 00:00:00.173460
2554,nuxt/nuxt.js,1,v,30,12,7,112,142,0 days 00:00:00.363961
2555,python/cpython,2, v,24,0,21,171,195,0 days 00:00:06.809573
2556,git/git,2,gitgui- v,89,22,30,438,527,0 days 00:00:04.160943
2557,TryGhost/Ghost,2, v,170,125,6,318,488,0 days 00:00:01.168817
2558,square/retrofit,2, parent-,25,1,11,19,44,0 days 00:00:00.106026
2559,gogs/gogs,1,v,11,4,6,51,62,0 days 00:00:00.714781
2560,danielmiessler/SecLists,1,,16,0,10,1,17,0 days 00:00:00.071250
2561,facebook/jest,2, v,68,38,10,143,211,0 days 00:00:00.380748
2562,v2ray/v2ray-core,1,v,168,95,3,182,350,0 days 00:00:00.591027
2563,etcd-io/etcd,11, tests/v etcdutl/v etcdctl/v client/v pkg/v client/pkg/v raft/v v server/v api/v,16,0,11,207,223,0 days 00:00:01.272832
2564,iamkun/dayjs,1,v,11,3,4,99,110,0 days 00:00:00.419321
2565,nwjs/nw.js,2,nw-v v,60,19,11,207,267,0 days 00:00:00.323079
2566,Dogfalo/materialize,2, v,17,9,3,20,37,0 days 00:00:00.177694
2567,vercel/hyper,2, v,18,9,6,43,61,0 days 00:00:00.169607
2568,ocornut/imgui,1,v,72,41,5,2,74,0 days 00:00:00.415901
2569,mozilla/pdf.js,3, milestone- v,2,0,0,57,59,0 days 00:00:01.112157
2570,x64dbg/x64dbg,0,,0,0,0,0,0,0 days 00:00:00.009229
2571,cypress-io/cypress,13,create-cypress-tests-v @cypress/schematic-v @cypress/mount-utils-v @cypress/vite-dev-server-v @cypress/eslint-plugin-dev-v @cypress/react-v @cypress/webpack-preprocessor-v v @cypress/rollup-dev-server-v @cypress/webpack-batteries-included-preprocessor-v @cypress/webpack-dev-server-v @cypress/vue-v @cypress/design-system-v,99,58,6,351,450,0 days 00:00:01.231543
2572,obsproject/obs-studio,1,,30,1,13,89,119,0 days 00:00:00.628654
2573,microsoft/playwright,1,v,32,26,0,37,69,0 days 00:00:00.630145
2574,Textualize/rich,3, v. v,66,56,0,73,139,0 days 00:00:00.195667
2575,traefik/traefik,1,v,16,0,14,128,144,0 days 00:00:00.326188
2576,impress/impress.js,1,,8,4,3,4,12,0 days 00:00:00.018965
2577,styled-components/styled-components,4, styled-components@ sandbox@ v,28,11,6,106,134,0 days 00:00:00.144004
2578,apache/dubbo,2, dubbo-,8,2,3,83,91,0 days 00:00:00.517606
2579,dcloudio/uni-app,2, v,8,1,1,8,16,0 days 00:00:00.478019
2580,FiloSottile/mkcert,1,v,6,2,2,8,14,0 days 00:00:00.014298
2581,ethereum/go-ethereum,5, buildbot-testing-tag- poc v PoC,14,0,11,169,183,0 days 00:00:00.770416
2582,ventoy/Ventoy,1,v,0,0,0,69,69,0 days 00:00:00.044878
2583,PhilJay/MPAndroidChart,1,v,8,2,4,33,41,0 days 00:00:00.084559
2584,commaai/openpilot,1,v,8,0,4,62,70,0 days 00:00:00.055051
2585,pixijs/pixijs,3, project_v v,27,4,14,109,136,0 days 00:00:00.349085
2586,hexojs/hexo,1,,38,13,11,101,139,0 days 00:00:00.172480
2587,Leaflet/Leaflet,1,v,16,1,13,27,43,0 days 00:00:00.410172
2588,vuetifyjs/vuetify,1,v,23,6,8,284,307,0 days 00:00:00.734833
2589,pandas-dev/pandas,2, v,28,1,22,56,84,0 days 00:00:01.416443
2590,PowerShell/PowerShell,2,SD/ v,24,15,6,40,64,0 days 00:00:00.570345
2591,supabase/supabase,2, v,0,0,0,20,20,0 days 00:00:00.371078
2592,alvarotrigo/fullPage.js,3, v. v,7,0,3,76,83,0 days 00:00:00.093321
2593,facebook/docusaurus,1,v,14,7,1,37,51,0 days 00:00:00.159646
2594,minio/minio,1,release-,1,0,0,0,1,0 days 00:00:00.098790
2595,grpc/grpc,4,release-  objective-c-v v,55,19,3,109,164,0 days 00:00:03.063105
2596,sahat/hackathon-starter,1,,8,2,4,6,14,0 days 00:00:00.355712
2597,videojs/video.js,2, v,70,26,13,220,290,0 days 00:00:00.379528
2598,shadowsocks/shadowsocks,1,,4,1,2,14,18,0 days 00:00:00.042506
2599,Eugeny/tabby,1,v,0,0,0,116,116,0 days 00:00:00.261706
2600,NationalSecurityAgency/ghidra,0,,0,0,0,0,0,0 days 00:00:00.008163
2601,rclone/rclone,1,v,69,15,10,21,90,0 days 00:00:00.317254
2602,airbnb/lottie-android,2,v. v,21,5,8,42,63,0 days 00:00:00.184361
2603,quilljs/quill,1,v,23,11,5,99,122,0 days 00:00:00.391816
2604,lerna/lerna,1,v,39,16,6,70,109,0 days 00:00:00.161327
2605,d2l-ai/d2l-zh,1,v,9,4,3,0,9,0 days 00:00:00.146374
2606,koajs/koa,1,,43,9,9,44,87,0 days 00:00:00.085841
2607,BVLC/caffe,3, rc v,10,2,5,0,10,0 days 00:00:00.321973
2608,bumptech/glide,1,v,21,6,11,15,36,0 days 00:00:00.140909
2609,shadowsocks/shadowsocks-android,1,v,24,4,8,156,180,0 days 00:00:00.224648
2610,gulpjs/gulp,2, v,6,2,3,13,19,0 days 00:00:00.065511
2611,hashicorp/terraform,2, v,18,2,12,158,176,0 days 00:00:01.560350
2612,zenorocha/clipboard.js,1,v,9,1,0,33,42,0 days 00:00:00.181664
2613,marktext/marktext,1,v,7,0,4,20,27,0 days 00:00:00.072664
2614,ant-design/ant-design-pro,2, v,18,4,6,12,30,0 days 00:00:00.098034
2615,wg/wrk,1,,10,0,1,11,21,0 days 00:00:00.012587
2616,wagoodman/dive,1,v,10,1,2,15,25,0 days 00:00:00.028238
2617,immutable-js/immutable-js,2, v,16,8,3,39,55,0 days 00:00:00.081135
2618,evanw/esbuild,1,v,12,4,1,284,296,0 days 00:00:00.218320
2619,RocketChat/Rocket.Chat,1,,103,93,1,245,348,0 days 00:00:01.621803
2620,photonstorm/phaser,2, v,39,20,10,59,98,0 days 00:00:00.853039
2621,agalwood/Motrix,1,v,2,0,1,22,24,0 days 00:00:00.060609
2622,preactjs/preact,4, server- server-v v,60,18,7,162,222,0 days 00:00:00.289499
2623,google/zx,1,,23,6,0,19,42,0 days 00:00:00.022542
2624,php/php-src,12,MODERN_SYMMETRIC_SESSION_BEHAVIOUR_ SQLITE_ php- BEFORE_IMPORT_OF_MYSQLND_IN_ BEFORE_SAPIFICATION_FEB_ ZEND_OPTIMIZER_B RELEASE_ php yaf- oci8- ZO_B BEFORE_REMOVING_GC_STEP,41,4,28,434,475,0 days 00:00:06.767140
2625,XX-net/XX-Net,1,,51,17,3,285,336,0 days 00:00:00.345770
2626,nolimits4web/swiper,1,v,49,7,12,139,188,0 days 00:00:00.174173
2627,NervJS/taro,1,v,12,2,5,272,284,0 days 00:00:00.571753
2628,Blankj/AndroidUtilCode,1,,27,7,7,89,116,0 days 00:00:00.071758
2629,nativefier/nativefier,2, v,56,19,5,90,146,0 days 00:00:00.087061
2630,pingcap/tidb,5, rc beta v Beta,14,1,5,99,113,0 days 00:00:01.387464
2631,jaredpalmer/formik,4, formik@ formik-native@ v,19,4,2,100,119,0 days 00:00:00.287788
2632,gorhill/uBlock,2, npm_,70,29,9,228,298,0 days 00:00:00.633334
2633,carbon-app/carbon,1,,24,5,3,194,218,0 days 00:00:00.140760
2634,bilibili/ijkplayer,3,n k wk,10,0,5,63,73,0 days 00:00:00.110894
2635,skylot/jadx,1,v,10,0,9,11,21,0 days 00:00:00.222512
2636,SheetJS/sheetjs,1,v,10,0,1,98,108,0 days 00:00:00.054074
2637,nlohmann/json,2, v,15,2,8,36,51,0 days 00:00:00.204051
2638,vuejs/core,1,v,3,0,1,52,55,0 days 00:00:00.183426
2639,istio/istio,1,,22,4,12,143,165,0 days 00:00:01.283543
2640,getsentry/sentry,2, v,102,81,9,294,396,0 days 00:00:02.937720
2641,go-gitea/gitea,1,v,17,0,13,91,108,0 days 00:00:00.823036
2642,microsoft/monaco-editor,2, v,28,6,8,36,64,0 days 00:00:00.132914
2643,streamich/react-use,1,v,134,35,2,117,251,0 days 00:00:00.206154
2644,zxing/zxing,4,ZXingTest- BSGlass- BS- zxing-,10,2,4,19,29,0 days 00:00:00.281543
2645,jeecgboot/jeecg-boot,2, v,6,0,3,16,22,0 days 00:00:00.035258
2646,laurent22/joplin,25, plugin-repo-cli-v android-v ios-v @joplin/plugin-repo-cli@ cloud-v @joplin/app-mobile@ plugin-generator-v @joplin/fork-sax@ @joplin/turndown-plugin-gfm@ generator-joplin@ joplin@ server-v @joplin/app-desktop@ @joplin/fork-htmlparser2@ @joplin/turndown@ cli-v @joplin/plugins@ @joplin/tools@ @joplin/lib@ @joplin/app-clipper@ clipper- @joplin/renderer@ v @joplin/server@,3,0,0,894,897,0 days 00:00:01.653465
2647,netty/netty,0,,0,0,0,0,0,0 days 00:00:00.029461
2648,vuejs/vue-cli,22,@vue/cli-plugin-unit-jest@ vue-cli-version-marker@ @vue/cli-plugin-e2e-cypress@ @vue/cli-shared-utils@ @vue/cli-ui@ @vue/eslint-config-typescript@ @vue/eslint-config-prettier@ @vue/cli@ @vue/cli-plugin-babel@ @vue/cli-plugin-pwa@ @vue/cli-plugin-unit-mocha@ @vue/cli-init@ @vue/cli-plugin-eslint@ @vue/cli-ui-addon-widgets@ @vue/cli-plugin-e2e-nightwatch@ @vue/cli-upgrade@ @vue/cli-plugin-typescript@ @vue/cli-service-global@ @vue/cli-service@ @vue/cli-test-utils@ v @vue/cli-ui-addon-webpack@,30,10,6,107,137,0 days 00:00:00.341518
2649,alibaba/arthas,2, arthas-all-,6,0,3,35,41,0 days 00:00:00.085221
2650,google/leveldb,2, v,21,1,3,0,21,0 days 00:00:00.026640
2651,jgraph/drawio,2,testDeploy v,111,0,0,726,837,0 days 00:00:00.855291
2652,2dust/v2rayN,1,,117,12,0,2,119,0 days 00:00:00.061256
2653,ariya/phantomjs,1,,12,0,10,11,23,0 days 00:00:00.104931
2654,certbot/certbot,1,v,68,54,2,31,99,0 days 00:00:00.598926
2655,fxsjy/jieba,1,v,23,0,5,5,28,0 days 00:00:00.028580
2656,date-fns/date-fns,2,v. v,77,25,7,42,119,0 days 00:00:00.285129
2657,cli/cli,1,v,36,31,0,31,67,0 days 00:00:00.359090
2658,react-boilerplate/react-boilerplate,1,v,17,5,5,13,30,0 days 00:00:00.076418
2659,react-hook-form/react-hook-form,2, v,103,39,0,410,513,0 days 00:00:00.419515
2660,typeorm/typeorm,1,,3,0,1,79,82,0 days 00:00:00.339570
2661,go-gorm/gorm,1,v,5,0,2,77,82,0 days 00:00:00.109436
2662,beego/beego,1,v,16,3,10,24,40,0 days 00:00:00.187376
2663,jashkenas/backbone,2, v,10,2,7,22,32,0 days 00:00:00.267195
2664,tastejs/todomvc,2, v,7,1,3,6,13,0 days 00:00:00.117342
2665,nocodb/nocodb,2, v,9,5,2,86,95,0 days 00:00:00.146890
2666,mitmproxy/mitmproxy,2, v,30,4,17,35,65,0 days 00:00:00.508646
2667,openai/gym,2, v,15,5,2,34,49,0 days 00:00:00.078863
2668,markedjs/marked,2, v,16,1,9,94,110,0 days 00:00:00.134391
2669,vuejs/vuex,1,v,21,4,7,24,45,0 days 00:00:00.059858
2670,dotnet/aspnetcore,8, blazor-wasm-rc rc beta blazor-wasm-preview v blazor-wasm- release/,13,1,5,116,129,0 days 00:00:02.827551
2671,caolan/async,2, v,25,9,10,52,77,0 days 00:00:00.204278
2672,Dreamacro/clash,1,v,28,9,3,14,42,0 days 00:00:00.039788
2673,jesseduffield/lazygit,2, v,33,19,5,151,184,0 days 00:00:00.265913
2674,alibaba/p3c,4,p3c-pmd- eclipse-pmd- eclipse-plugin- idea-plugin-,2,0,1,25,27,0 days 00:00:00.029486
2675,square/leakcanary,1,v,14,4,9,10,24,0 days 00:00:00.090201
2676,kenwheeler/slick,2, v,8,0,3,43,51,0 days 00:00:00.065085
2677,psf/black,1,,2,0,0,0,2,0 days 00:00:00.064152
2678,ReactiveX/rxjs,1,,19,6,6,45,64,0 days 00:00:00.318502
2679,tannerlinsley/react-query,1,v,77,5,0,294,371,0 days 00:00:00.371017
2680,atlassian/react-beautiful-dnd,2, v,24,5,4,46,70,0 days 00:00:00.069458
2681,standard/standard,1,v,66,16,8,87,153,0 days 00:00:00.174163
2682,FFmpeg/FFmpeg,3,n ffmpeg- v,29,0,24,303,332,0 days 00:00:07.487056
2683,naptha/tesseract.js,2, v,4,1,2,28,32,0 days 00:00:00.059882
2684,apolloconfig/apollo,2, v,19,2,9,16,35,0 days 00:00:00.182717
2685,spf13/cobra,2, v,5,0,3,13,18,0 days 00:00:00.069596
2686,laravel/framework,2, v,163,143,12,630,793,0 days 00:00:02.237695
2687,airbnb/lottie-web,2,v. v,24,8,7,144,168,0 days 00:00:00.201005
2688,composer/composer,1,,15,1,11,110,125,0 days 00:00:00.781310
2689,typicode/husky,1,v,34,8,9,88,122,0 days 00:00:00.105323
2690,dbeaver/dbeaver,1,,24,0,22,138,162,0 days 00:00:01.250249
2691,jashkenas/underscore,1,,20,1,12,54,74,0 days 00:00:00.125986
2692,google/googletest,1,release-,11,0,8,3,14,0 days 00:00:00.160813
2693,aria2/aria2,1,release-,53,19,18,87,140,0 days 00:00:00.993577
2694,webtorrent/webtorrent,1,v,125,41,7,284,409,0 days 00:00:00.468169
2695,topjohnwu/Magisk,2,manager-v v,80,27,6,43,123,0 days 00:00:00.240824
2696,denysdovhan/wtfjs,1,v,23,3,4,16,39,0 days 00:00:00.029049
2697,JetBrains/kotlin,10, m8- M native-merge- idea mercury-test build- v idea13- mercury-test-,19,2,10,3219,3238,0 days 00:00:28.566423
2698,postcss/postcss,1,,20,1,10,207,227,0 days 00:00:00.340866
2699,symfony/symfony,2,vPR v,31,5,21,497,528,0 days 00:00:04.733259
2700,sequelize/sequelize,2, v,137,36,9,334,471,0 days 00:00:01.163241
2701,layui/layui,2, v,7,1,2,41,48,0 days 00:00:00.025209
2702,iamadamdev/bypass-paywalls-chrome,1,v,4,0,3,28,32,0 days 00:00:00.042614
2703,docker/compose,2, v,41,12,15,67,108,0 days 00:00:00.856503
2704,niklasvh/html2canvas,2, v,7,0,2,17,24,0 days 00:00:00.049306
2705,hankcs/HanLP,1,v,9,1,4,44,53,0 days 00:00:00.084432
2706,JakeWharton/butterknife,2, butterknife-parent-,26,6,9,19,45,0 days 00:00:00.074180
2707,alibaba/druid,1,,3,0,2,78,81,0 days 00:00:00.578949
2708,apache/airflow,81, providers-qubole/ providers-plexus/ providers-sendgrid/ providers-influxdb/ providers-samba/ providers-exasol/ providers-apache-hive/ constraints- providers-dbt-cloud/ providers-apache-cassandra/ providers-cloudant/ providers-zendesk/ providers-mysql/ providers-google/ providers-apache-drill/ providers-asana/ providers-apache-hdfs/ providers-ftp/ providers-apache-pig/ providers-discord/ providers-microsoft-azure/ providers-singularity/ helm-chart/ providers-snowflake/ providers-grpc/ providers-odbc/ providers-microsoft-mssql/ providers-apache-druid/ providers-apache-sqoop/ providers-yandex/ providers-ssh/ providers-apache-livy/ providers-arangodb/ providers-jira/ providers-microsoft-psrp/ providers-imap/ providers-opsgenie/ providers-http/ providers-apache-spark/ providers-papermill/ backport-providers- airbnb_prod. providers-trino/ providers-cncf-kubernetes/ providers-dingding/ providers-airbyte/ providers-databricks/ providers-microsoft-winrm/ providers-mongo/ providers-openfaas/ providers-facebook/ providers-apache-pinot/ providers-alibaba/ providers-hashicorp/ providers-docker/ providers-salesforce/ providers-segment/ providers-datadog/ providers-pagerduty/ providers-github/ providers-jenkins/ providers-sqlite/ providers-presto/ providers-celery/ providers-vertica/ providers-slack/ providers-amazon/ providers-tableau/ providers-telegram/ providers-jdbc/ providers-postgres/ providers-apache-beam/ providers-sftp/ providers-elasticsearch/ upgrade-check/ providers-neo4j/ providers-redis/ providers-oracle/ v providers-apache-kylin/,50,9,5,788,838,0 days 00:00:01.832095
2709,bannedbook/fanqiang,3,FQNews-v ChromeGo-v v,12,2,2,12,24,0 days 00:00:00.051211
2710,request/request,1,v,73,27,5,71,144,0 days 00:00:00.181539
2711,yt-dlp/yt-dlp,1,,0,0,0,55,55,0 days 00:00:01.284207
2712,github/fetch,1,v,21,6,7,19,40,0 days 00:00:00.036887
2713,select2/select2,1,,9,2,5,27,36,0 days 00:00:00.113524
2714,angular/angular-cli,4, v. temporary-tag- v,36,14,7,279,315,0 days 00:00:00.970731
2715,mobxjs/mobx,7, mobx-react@ mobx-react-lite@ mobx-undecorate@ eslint-plugin-mobx@ v mobx@,65,23,4,238,303,0 days 00:00:00.476902
2716,Modernizr/Modernizr,1,v,20,4,10,23,43,0 days 00:00:00.146499
2717,rethinkdb/rethinkdb,4,windows-alpha javascript-v ruby-v v,24,6,8,80,104,0 days 00:00:01.656034
2718,cheeriojs/cheerio,2, v,22,6,6,30,52,0 days 00:00:00.053021
2719,harness/drone,1,v,31,10,8,44,75,0 days 00:00:00.346828
2720,codemirror/CodeMirror,3, beta v,122,96,6,45,167,0 days 00:00:00.314945
2721,tmux/tmux,1,,25,1,19,0,25,0 days 00:00:00.484590
2722,SortableJS/Sortable,1,,17,2,11,18,35,0 days 00:00:00.051408
2723,curl/curl,3,c-ares- tiny-curl- curl-,84,1,23,86,170,0 days 00:00:01.749420
2724,GitbookIO/gitbook,1,,22,13,2,68,90,0 days 00:00:00.150159
2725,hashicorp/consul,4,sdk/v v internal/v api/v,22,2,9,151,173,0 days 00:00:01.079539
2726,GoogleChrome/lighthouse,2, v,56,39,4,42,98,0 days 00:00:00.234219
2727,JedWatson/react-select,3, react-select@ v,28,13,8,73,101,0 days 00:00:00.321961
2728,nektos/act,1,v,2,0,1,34,36,0 days 00:00:00.037440
2729,chakra-ui/chakra-ui,78,@chakra-ui/icon@ @chakra-ui/form-control@ @chakra-ui/docs@ @chakra-ui/radio@ @chakra-ui/button@ gatsby-plugin-chakra-ui@ @chakra-ui/props-docs@ @chakra-ui/machine@ @chakra-ui/progress@ @chakra-ui/textarea@ @chakra-ui/slider@ @chakra-ui/input@ @chakra-ui/descendant@ next-js@ @chakra-ui/icons@ @chakra-ui/number-input@ @chakra-ui/live-region@ @chakra-ui/theme-tools@ @chakra-ui/tag@ @chakra-ui/avatar@ gatsby-starter-chakra-ui@ @chakra-ui/clickable@ @chakra-ui/checkbox@ create-react-app@ @chakra-ui/gatsby-plugin@ @chakra-ui/tabs@ @chakra-ui/spinner@ @chakra-ui/counter@ @chakra-ui/close-button@ @chakra-ui/react-utils@ @chakra-ui/table@ @chakra-ui/breadcrumb@ @chakra-ui/tooltip@ @chakra-ui/accordion@ @chakra-ui/media-query@ @chakra-ui/select@ @chakra-ui/test-utils@ storybook-addon@ @chakra-ui/layout@ @chakra-ui/skeleton@ @chakra-ui/react-env@ @chakra-ui/focus-lock@ @chakra-ui/utils@ @chakra-ui/menu@ @chakra-ui/alert@ @chakra-ui/hooks@ @chakra-ui/pin-input@ @chakra-ui/anatomy@ @chakra-ui/image@ chakra-nextjs-ts@ @chakra-ui/react@ @chakra-ui/toast@ @chakra-ui/switch@ @chakra-ui/transition@ chakra-cra@ @chakra-ui/css-reset@ @chakra-ui/cli@ @chakra-ui/storybook-addon@ @chakra-ui/popover@ @chakra-ui/system@ @chakra-ui/theme@ @chakra-ui/editable@ @chakra-ui/control-box@ @chakra-ui/cra-template@ @chakra-ui/babel-plugin@ chakra-nextjs@ @chakra-ui/modal@ @chakra-ui/skip-nav@ @chakra-ui/stat@ @chakra-ui/cra-template-typescript@ @chakra-ui/visually-hidden@ @chakra-ui/provider@ @chakra-ui/color-mode@ @chakra-ui/styled-system@ @chakra-ui/core@ with-chakra-ui@ @chakra-ui/popper@ @chakra-ui/portal@,32,1,1,1907,1939,0 days 00:00:07.212271
2730,alibaba/fastjson,1,,1,0,0,94,95,0 days 00:00:00.489813
2731,transloadit/uppy,49,@uppy/informer@ remark-lint-uppy@ @uppy/aws-s3@ @uppy/robodog@ @uppy/file-input@ @uppy/thumbnail-generator@ @uppy/tus@ @uppy/server-utils@ @uppy/redux-dev-tools@ @uppy/url@ @uppy/drop-target@ @uppy/react@ @uppy/unsplash@ @uppy/facebook@ @uppy/webcam@ @uppy/xhr-upload@ @uppy/golden-retriever@ @uppy/store-redux@ @uppy/compressor@ @uppy/instagram@ @uppy/vue@ @uppy/companion-client@ @uppy/react-native@ @uppy/form@ @uppy/store-default@ @uppy/google-drive@ @uppy/svelte@ @uppy/audio@ @uppy/locales@ @uppy/dropbox@ @uppy/aws-s3-multipart@ @uppy/companion@ @uppy/core@ @uppy/status-bar@ @uppy/dashboard@ @uppy/box@ @uppy/utils@ @uppy/screen-capture@ @uppy/provider-views@ @uppy/zoom@ uppy@ @uppy/onedrive@ @uppy/transloadit@ test-edgly @uppy/drag-drop@ @uppy/angular@ v @uppy/progress-bar@ @uppy/image-editor@,82,12,0,2258,2340,0 days 00:00:06.457597
2732,ajaxorg/ace,3, cloud v,8,0,7,46,54,0 days 00:00:00.310487
2733,parallax/jsPDF,3, v. v,9,1,7,26,35,0 days 00:00:00.100065
2734,ccxt/ccxt,1,,0,0,0,505,505,0 days 00:00:03.108721
2735,rstacruz/nprogress,2, v,2,0,1,8,10,0 days 00:00:00.014492
2736,YMFE/yapi,2, v,9,2,2,68,77,0 days 00:00:00.465000
2737,CMU-Perceptual-Computing-Lab/openpose,1,v,8,0,5,4,12,0 days 00:00:00.030482
2738,Binaryify/NeteaseCloudMusicApi,2, v,52,10,5,102,154,0 days 00:00:00.105905
2739,Automattic/mongoose,2, v,58,12,18,646,704,0 days 00:00:01.402601
2740,cockroachdb/cockroach,8,beta- staging-202011191818-v staging-202011251758-v staging-202011251240-v @cockroacklabs/cluster-ui@ @cockroachlabs/cluster-ui@ v @cockroachlabs/clusterui@,55,40,10,138,193,0 days 00:00:05.575183
2741,remy/nodemon,1,v,20,3,3,101,121,0 days 00:00:00.086869
2742,lenve/vhr,1,v,12,0,1,0,12,0 days 00:00:00.013389
2743,hashicorp/vault,11,api/auth/aws/v api/auth/userpass/v old-stable-website- api/auth/approle/v api/auth/azure/v sdk/v api/auth/gcp/v api/auth/ldap/v api/auth/kubernetes/v v api/v,23,1,17,145,168,0 days 00:00:00.933056
2744,OAI/OpenAPI-Specification,1,,2,0,1,3,5,0 days 00:00:00.204788
2745,kubernetes/minikube,1,v,61,43,1,45,106,0 days 00:00:01.054929
2746,bvaughn/react-virtualized,2, v,71,33,3,129,200,0 days 00:00:00.208686
2747,ianstormtaylor/slate,19,slate-simulator@ slate-dev-benchmark@ slate-html-serializer@ slate-hotkeys@ slate-plain-serializer@ slate-hyperscript@ slate-base64-serializer@ slate@ slate-dev-logger@ slate-dev-warning@ slate-prop-types@ slate-dev-environment@ slate-schema-violations@ slate-dev-test-utils@ slate-react@ slate-react-placeholder@ slate-schema@ slate-history@ v,76,11,2,1634,1710,0 days 00:00:05.000092
2748,ggreer/the_silver_searcher,1,,37,16,8,12,49,0 days 00:00:00.098286
2749,alibaba/easyexcel,2, v,3,0,2,26,29,0 days 00:00:00.052531
2750,akveo/ngx-admin,1,v,19,2,6,8,27,0 days 00:00:00.065503
2751,scwang90/SmartRefreshLayout,1,V,3,0,2,10,13,0 days 00:00:00.066224
2752,cmderdev/cmder,1,v,4,0,2,24,28,0 days 00:00:00.075838
2753,ClickHouse/ClickHouse,1,,39,15,0,0,39,0 days 00:00:01.213270
2754,SeleniumHQ/selenium,7, ide- rc- selenium- atoms-base- atoms- core-,76,43,15,28,104,0 days 00:00:01.306262
2755,sqlmapproject/sqlmap,1,,11,0,7,72,83,0 days 00:00:00.610391
2756,fastify/fastify,1,v,104,75,0,90,194,0 days 00:00:00.234812
2757,CodeHubApp/CodeHub,1,,15,3,2,13,28,0 days 00:00:00.039367
2758,explosion/spaCy,2, v,28,14,11,72,100,0 days 00:00:00.881087
2759,encode/django-rest-framework,1,,22,1,17,106,128,0 days 00:00:00.564123
2760,alibaba/canal,2,canal- v,1,0,0,15,16,0 days 00:00:00.070716
2761,go-kit/kit,1,v,12,0,9,0,12,0 days 00:00:00.117496
2762,hammerjs/hammer.js,2, v,3,0,1,22,25,0 days 00:00:00.116301
2763,pmndrs/react-spring,1,v,22,9,2,150,172,0 days 00:00:00.429208
2764,prisma/prisma,1,,44,43,0,35,79,0 days 00:00:00.510774
2765,influxdata/influxdb,2, v,26,6,14,133,159,0 days 00:00:02.169615
2766,torvalds/linux,1,v,60,0,1,28,88,0 days 00:01:12.182635
2767,microsoft/fluentui,132,@fluentui/react-compose_v @fluentui/react-experiments_v @uifabric/variants_v @fluentui/react-icons_v @uifabric/azure-themes_v @fluentui/foundation-legacy_v @fluentui/react-monaco-editor_v @fluentui/react-toggle_v @fluentui/react-make-styles_v @fluentui/react-northstar-styles-renderer_v lts- @uifabric/jest-serializer-merge-styles_v @uifabric/react-cards_v office-ui-fabric-react_v @fluentui/react-image_v @uifabric/pr-deploy-site_v @fluentui/monaco-editor_v @fluentui/styles_v @uifabric/utilities_v @fluentui/react-file-type-icons_v @fluentui/react-stylesheets_v @uifabric/api-docs_v @fluentui/react-hooks_v '@fluentui/react-northstar_v' @fluentui/make-styles-webpack-loader_v @fluentui/dom-utilities_v @fluentui/react-northstar_v @fluentui/react-theme_v @fluentui/react-cards_v @fluentui/ie11-polyfills_v @fluentui/react-component-ref_v @uifabric/set-version_v @fluentui/merge-styles_v @uifabric/dashboard_v @fluentui/react-provider_v @fluentui/react-component-event-listener_v @fluentui/react-menu_v @fluentui/api-docs_v @fluentui/react-bindings_v @fluentui/example-data_v @uifabric/react-hooks_v @uifabric/mdl2-theme_v @fluentui/azure-themes_v @uifabric/foundation_v @uifabric/example-data_v @fluentui/react-badge_v @uifabric/tsx-editor_v @fluentui/public-docsite_v @fluentui/test-utilities_v @fluentui/react-context-selector_v @fluentui/react-text_v @fluentui/keyboard-key_v @fluentui/react-builder_v @fluentui/cra-template_v @fluentui/react-theming_v @fluentui/react-tabs_v @fluentui/react-flex_v @fluentui/react-utils_v @fluentui/common-styles_v @fluentui/public-docsite-setup_v @fluentui/react-northstar-fela-renderer_v @uifabric/fluent-theme_v @uifabric/migration_v @uifabric/dashboard-grid-layout_v @uifabric/webpack-utils_v @fluentui/react-component-nesting-registry_v @fluentui/react-button_v @fluentui/jest-serializer-merge-styles_v @uifabric/fabric-website-resources_v @fluentui/webpack-utilities_v @uifabric/test-utilities_v fluentuizero_v @uifabric/codepen-loader_v @fluentui/react-examples_v @fluentui/accessibility_v @fluentui/react_v @uifabric/date-time_v @fluentui/theme-samples_v @fluentui/react-date-time_v @fluentui/utilities_v @fluentui/react-avatar_v @fluentui/react-theme-provider_v @fluentui/react-link_v @uifabric/prettier-rules_v @fluentui/date-time-utilities_v @uifabric/example-app-base_v fabric-website_v 'fluentuizero_v' @uifabric/icons_v @fluentui/codemods_v @fluentui/bundle-size_v @fluentui/public-docsite-resources_v @fluentui/scheme-utilities_v @uifabric/theme-samples_v @fluentui/docs-components_v @fluentui/react-telemetry_v @fluentui/code-sandbox_v @fluentui/react-conformance_v @fluentui/react-proptypes_v @fluentui/style-utilities_v @fluentui/react-icon-provider_v @fluentui/react-slider_v @fluentui/eslint-plugin_v @uifabric/charting_v @fluentui/react-northstar-emotion-renderer_v @fluentui/set-version_v @fluentui/playground_v @fluentui/make-styles_v @uifabric/monaco-editor_v @fluentui/react-focus_v @uifabric/foundation-scenarios_v @uifabric/experiments_v @fluentui/examples_v @uifabric/tslint-rules_v @fluentui/state_v @fluentui/web-components_v @fluentui/theme_v @uifabric/styling_v @fluentui/react-docsite-components_v @fluentui/react-window-provider_v @fluentui/react-charting_v @fluentui/react-shared-contexts_v @uifabric/fabric-website_v @fluentui/storybook_v fluentui_v @fluentui/react-icons-northstar_v @fluentui/react-utilities_v @uifabric/file-type-icons_v @uifabric/merge-styles_v @fluentui/react-icons-mdl2-branded_v v @fluentui/react-checkbox_v,827,54,1,12663,13490,0 days 00:05:16.993433
2768,jupyterlab/jupyterlab,182,@jupyterlab/nbformat@ @jupyterlab/ui-components-extension@ @jupyterlab/application-top@ @jupyterlab/example-federated-core@ @jupyterlab/inspector@ @jupyterlab/vega4-extension@ @jupyterlab/example-federated@ @jupyterlab/console@ @jupyterlab/rendermime@ @jupyterlab/services-extension@ @jupyterlab/celltags@ @jupyterlab/example-filebrowser@ @jupyterlab/theme-dark-extension@ @jupyterlab/faq-extension@ @jupyterlab/codemirror-extension@ @jupyterlab/test-application@ @jupyterlab/extension-builder@ @jupyterlab/test-filebrowser@ @jupyterlab/notebook@ @jupyterlab/docregistry@ @jupyterlab/launcher@ @jupyterlab/test-all@ @jupyterlab/mainmenu-extension@ @jupyterlab/theme-light-extension@ @jupyterlab/test-docregistry@ @jupyterlab/documentsearch-extension@ @jupyterlab/settingeditor-extension@ @jupyterlab/example-terminal@ @jupyterlab/main@ @jupyterlab/logconsole-extension@ @jupyterlab/example-services-outputarea@ @jupyterlab/landing-extension@ @jupyterlab/example-services-browser@ @jupyterlab/completer-extension@ @jupyterlab/docprovider-extension@ @jupyterlab/template-for-tests@ @jupyterlab/test-csvviewer@ @jupyterlab/example-notebook@ @jupyterlab/builder@ @jupyterlab/completer@ @jupyterlab/ui-components@ @jupyterlab/inspector-extension@ @jupyterlab/application-extension@ @jupyterlab/statusbar-extension@ @jupyterlab/docregistry-extension@ @jupyterlab/imagewidget@ @jupyterlab/documentsearch@ @jupyterlab/example-federated-md@ @jupyterlab/toc@ @jupyterlab/test-statusbar@ @jupyterlab/docmanager@ @jupyterlab/javascript-extension@ @jupyterlab/markdownviewer-extension@ @jupyterlab/imageviewer-extension@ @jupyterlab/celltags-extension@ @jupyterlab/debugger-extension@ jupyterlab-example-filebrowser@ @jupyterlab/codemirror@ @jupyterlab/apputils@ @jupyterlab/coreutils@ @jupyterlab/filebrowser-extension@ @jupyterlab/test-nbformat@ @jupyterlab/galata@ jupyterlab-example-app@ @jupyterlab/example-federated-phosphor@ @jupyterlab/application@ @jupyterlab/imageviewer@ @jupyterlab/example-console@ @jupyterlab/statedb@ @jupyterlab/test-inspector@ @jupyterlab/test-docmanager@ @jupyterlab/test-mainmenu@ @jupyterlab/mock-provider@ @jupyterlab/apputils-extension@ @jupyterlab/translation-extension@ @jupyterlab/test-statedb@ @jupyterlab/mathjax2@ @jupyterlab/about-extension@ @jupyterlab/fileeditor-extension@ @jupyterlab/settingeditor@ @jupyterlab/test-apputils@ @jupyterlab/tabmanager-extension@ @jupyterlab/markdownwidget@ @jupyterlab/mock-token@ @jupyterlab/test-console@ @jupyterlab/test-settingregistry@ @jupyterlab/default-theme@ @jupyterlab/debugger@ @jupyterlab/htmlviewer@ @jupyterlab/shared-models@ @jupyterlab/test-services@ @jupyterlab/csvwidget-extension@ @jupyterlab/testutils@ @jupyterlab/test-notebook@ @jupyterlab/test-terminal@ @jupyterlab/docprovider@ @jupyterlab/test-observables@ @jupyterlab/example-cell@ @jupyterlab/test-logconsole@ @jupyterlab/help-extension@ @jupyterlab/mock-mime-extension@ @jupyterlab/codeeditor@ @jupyterlab/extensionmanager@ @jupyterlab/all-packages@ @jupyterlab/json-extension@ @jupyterlab/services@ @jupyterlab/translation@ @jupyterlab/template@ @jupyterlab/htmlviewer-extension@ @jupyterlab/rendermime-extension@ jupyterlab-example-terminal@ @jupyterlab/tooltip@ jupyterlab-example-console@ @jupyterlab/terminal-extension@ @jupyterlab/shortcuts-extension@ @jupyterlab/console-extension@ @jupyterlab/tooltip-extension@ @jupyterlab/property-inspector@ @jupyterlab/test-root@ @jupyterlab/test-ui-components@ @jupyterlab/launcher-extension@ @jupyterlab/pdf-extension@ @jupyterlab/metapackage@ node-example@ @jupyterlab/notebook-extension@ @jupyterlab/chatbox-extension@ @jupyterlab/vega5-extension@ @jupyterlab/cell-toolbar-extension@ @jupyterlab/markdownviewer@ @jupyterlab/mock-consumer@ @jupyterlab/test-imageviewer@ @jupyterlab/running-extension@ @jupyterlab/vega3-extension@ @jupyterlab/running@ @jupyterlab/test-codemirror@ @jupyterlab/editorwidget@ @jupyterlab/csvviewer-extension@ @jupyterlab/observables@ @jupyterlab/csvwidget@ @jupyterlab/editorwidget-extension@ @jupyterlab/settingregistry@ @jupyterlab/csvviewer@ @jupyterlab/test-outputarea@ @jupyterlab/chatbox@ @jupyterlab/docmanager-extension@ @jupyterlab/example-federated-middle@ @jupyterlab/vega2-extension@ @jupyterlab/mime-extension-test@ @jupyterlab/outputarea@ @jupyterlab/buildutils@ @jupyterlab/hub-extension@ @jupyterlab/filebrowser@ @jupyterlab/test-codeeditor@ @jupyterlab/test-rendermime@ typescript-browser-with-output@ @jupyterlab/mathjax2-extension@ @jupyterlab/logconsole@ @jupyterlab/mainmenu@ @jupyterlab/test-coreutils@ @jupyterlab/terminal@ @jupyterlab/vdom@ @jupyterlab/rendermime-interfaces@ @jupyterlab/attachments@ @jupyterlab/vdom-extension@ @jupyterlab/mock-extension@ @jupyterlab/test-cells@ browser-example@ @jupyterlab/imagewidget-extension@ @jupyterlab/statusbar@ @jupyterlab/example-app@ @jupyterlab/extensionmanager-extension@ @jupyterlab/markdownwidget-extension@ @jupyterlab/toc-extension@ @jupyterlab/test-completer@ jupyterlab-example-notebook@ @jupyterlab/fileeditor@ @jupyterlab/cell-toolbar@ @jupyterlab/theming@ v @jupyterlab/cells@ @jupyterlab/test-fileeditor@ @jupyterlab/nbconvert-css@,79,16,1,12902,12981,0 days 00:04:59.337680
2769,jitsi/jitsi-meet,7, android- ios- stable/jitsi-meet_ android-sdk- ios-sdk- jitsi-meet_,7115,17,0,4680,11795,0 days 00:04:10.842489
2770,gatsbyjs/gatsby,140, gatsby-plugin-manifest@ gatsby-plugin-jss@ gatsby-remark-copy-linked-files@ gatsby-link@ gatsby-theme-notes@ gatsby-transformer-yaml@ gatsby-plugin-utils@ gatsby-plugin-image@ gatsby-plugin-mdx@ gatsby-plugin-stylus@ gatsby-transformer-documentationjs@ gatsby-plugin-gatsby-cloud@ babel-plugin-remove-graphql-queries@ gatsby-source-contentful@ gatsby-react-router-scroll@ gatsby-plugin-layout@ gatsby-cli@ gatsby-source-lever@ gatsby-script@ gatsby-page-utils@ gatsby-plugin-styled-components@ gatsby-plugin-styletron@ gatsby-plugin-twitter@ gatsby-plugin-less@ gatsby-plugin-remove-trailing-slashes@ gatsby-transformer-asciidoc@ gatsby-parcel-namer-relative-to-cwd@ gatsby-remark-images-contentful@ gatsby-plugin-page-creator@ create-gatsby@ gatsby-transformer-pdf@ gatsby-remark-prismjs@ gatsby@ gatsby-plugin-netlify-headers@ gatsby-1-config-extract-plugin@ gatsby-transformer-hjson@ gatsby-source-npm-package-search@ gatsby-source-mongodb@ gatsby-plugin-subfont@ gatsby-transformer-remark@ gatsby-remark-images@ gatsby-plugin-guess-js@ gatsby-plugin-sass@ gatsby-remark-embed-snippet@ gatsby-transformer-xml@ @gatsbyjs/parcel-namer-relative-to-cwd@ gatsby-plugin-emotion@ gatsby-plugin-postcss-sass@ gatsby-source-medium@ gatsby-source-wordpress-com@ gatsby-transformer-react-docgen@ gatsby-plugin-create-client-paths@ gatsby-source-hacker-news@ gatsby-plugin-nprogress@ gatsby-recipes@ gatsby-graphiql-explorer@ gatsby-plugin-no-sourcemaps@ gatsby-plugin-react-next@ gatsby-plugin-catch-links@ gatsby-plugin-glamorous@ gatsby-source-graphql@ gatsby-cypress@ gatsby-plugin-canonical-urls@ gatsby-plugin-glamor@ gatsby-plugin-coffeescript@ gatsby-plugin-typescript@ gatsby-plugin-graphql-config@ gatsby-plugin-fullstory@ gatsby-worker@ gatsby-plugin-preact@ gatsby-plugin-react-helmet@ gatsby-transformer-json@ gatsby-remark-code-repls@ gatsby-codemods@ gatsby-theme-workspace@ gatsby-core-utils@ gatsby-dev-cli@ gatsby-plugin-facebook-analytics@ gatsby-remark-graphviz@ gatsby-source-wikipedia@ gatsby-plugin-aphrodite@ gatsby-design-tokens@ gatsby-remark-responsive-iframe@ gatsby-plugin-benchmark-reporting@ gatsby-plugin-netlify@ gatsby-plugin-google-analytics@ babel-preset-gatsby-package@ gatsby-transformer-csv@ gatsby-plugin-typography@ gatsby-transformer-docx@ gatsby-plugin-lodash@ gatsby-source-filesystem@ gatsby-plugin-react-css-modules@ gatsby-transformer-pdfimages@ gatsby-plugin-preload-fonts@ gatsby-plugin-sharp@ gatsby-transformer-screenshot@ gatsby-transformer-javascript-static-exports@ graphql-skip-limit@ babel-preset-gatsby@ gatsby-starter-default@ gatsby-source-shopify@ gatsby-transformer-toml@ gatsby-remark-katex@ gatsby-source-drupal@ gatsby-theme-ui-preset@ gatsby-remark-custom-blocks@ gatsby-plugin-netlify-cms@ gatsby-plugin-google-gtag@ gatsby-theme-blog@ gatsby-plugin-sitemap@ gatsby-remark-smartypants@ gatsby-transformer-sharp@ gatsby-image@ gatsby-plugin-flow@ gatsby-transformer-sqip@ gatsby-transformer-excel@ gatsby-plugin-feed@ gatsby-admin@ gatsby-source-wordpress@ gatsby-plugin-google-tagmanager@ gatsby-source-faker@ gatsby-plugin-postcss@ gatsby-module-loader@ gatsby-plugin-styled-jsx@ gatsby-legacy-polyfills@ gatsby-plugin-offline@ gatsby-theme-blog-core@ gatsby-telemetry@ gatsby-plugin-schema-snapshot@ gatsby-transformer-javascript-frontmatter@ gatsby-remark-autolink-headers@ gatsby-plugin-cxs@ gatsby-theme@ gatsby-sharp@ cypress-gatsby@ gatsby-parcel-config@ v gatsby-1-config-css-modules@,156,9,2,16855,17011,0 days 00:08:24.767632
2771,v8/v8,3, test_tag lkgr/,89,0,0,21687,21776,0 days 00:20:35.133062
