project,prefixes,prefixes_names,main_releases,rapid_releases,trad_releases,patches,releases,time
1adrianb/face-alignment,1,v,5,1,2,5,10,0 days 00:00:00.024031
bytedance/IconPark,1,v,4,1,1,32,36,0 days 00:00:00.028332
FaisalUmair/udemy-downloader-gui,1,v,9,4,2,12,21,0 days 00:00:00.028206
robinvdvleuten/vuex-persistedstate,1,v,21,9,7,14,35,0 days 00:00:00.035616
stevenjoezhang/live2d-widget,1,v,8,5,2,9,17,0 days 00:00:00.014831
mindoc-org/mindoc,1,v,14,10,3,17,31,0 days 00:00:00.050495
expressjs/session,1,v,17,7,6,45,62,0 days 00:00:00.057081
Yelp/dumb-init,1,v,8,4,3,14,22,0 days 00:00:00.025800
kalcaddle/KodExplorer,2, v,31,15,10,3,34,0 days 00:00:00.025802
jquense/react-big-calendar,1,v,37,18,12,77,114,0 days 00:00:00.091865
vuejs/apollo,2, v,5,1,2,8,13,0 days 00:00:00.044070
listen1/listen1_desktop,1,v,26,18,5,40,66,0 days 00:00:00.032575
botman/botman,2, v,17,9,6,44,61,0 days 00:00:00.067191
googleapis/google-api-python-client,1,v,60,50,6,52,112,0 days 00:00:00.132420
bblanchon/ArduinoJson,1,v,42,20,11,56,98,0 days 00:00:00.105236
telegraf/telegraf,2, v,68,48,5,112,180,0 days 00:00:00.143134
go-yaml/yaml,1,v,6,2,3,10,16,0 days 00:00:00.029802
VirusTotal/yara,1,v,17,1,12,16,33,0 days 00:00:00.168106
projectdiscovery/subfinder,2, v,10,5,4,24,34,0 days 00:00:00.065632
matthewmueller/x-ray,1,,5,2,2,13,18,0 days 00:00:00.021565
bchavez/Bogus,1,v,7,5,1,97,104,0 days 00:00:00.067910
substack/tape,1,v,50,23,16,85,135,0 days 00:00:00.092533
joeyespo/grip,1,v,15,3,10,9,24,0 days 00:00:00.039664
encode/apistar,1,,6,2,3,88,94,0 days 00:00:00.068431
ecrmnn/collect.js,1,,35,24,5,154,189,0 days 00:00:00.143500
maaslalani/slides,1,v,8,4,1,8,16,0 days 00:00:00.020657
eternnoir/pyTelegramBotAPI,1,,15,3,7,37,52,0 days 00:00:00.109620
graphql-editor/graphql-editor,2, v,19,15,1,127,146,0 days 00:00:00.071043
neutralinojs/neutralinojs,1,v,26,18,4,4,30,0 days 00:00:00.081715
lightbend/config,1,v,9,1,4,19,28,0 days 00:00:00.154517
Dman95/SASM,1,v,15,4,9,11,26,0 days 00:00:00.112117
assaf/zombie,2, v,21,12,7,111,132,0 days 00:00:00.214329
Xhofe/alist,1,v,9,5,2,33,42,0 days 00:00:00.144065
capstone-engine/capstone,1,,5,2,2,9,14,0 days 00:00:00.299595
kickstarter/android-oss,1,v,36,18,5,36,72,0 days 00:00:00.408910
thephpleague/omnipay,2, v,12,4,5,18,30,0 days 00:00:00.044683
ml5js/ml5-library,3, V v,9,3,3,45,54,0 days 00:00:00.245161
tijsverkoyen/CssToInlineStyles,1,,9,2,5,20,29,0 days 00:00:00.024355
roots/bedrock,1,,21,3,12,82,103,0 days 00:00:00.064084
MikeMcl/bignumber.js,2, v,20,3,11,27,47,0 days 00:00:00.025494
golden-layout/golden-layout,2, v,7,1,3,25,32,0 days 00:00:00.048988
datreeio/datree,1,,14,11,2,93,107,0 days 00:00:00.103043
OpenNMT/OpenNMT-py,2, v,15,6,8,14,29,0 days 00:00:00.244510
kyleconroy/sqlc,2, v,15,6,3,1,16,0 days 00:00:00.054578
shaka-project/shaka-player,1,v,18,2,10,119,137,0 days 00:00:00.516435
lebab/lebab,1,v,14,8,2,28,42,0 days 00:00:00.060731
modulz/stitches,1,v,5,2,1,22,27,0 days 00:00:00.062084
docker/docker-py,1,,40,7,11,63,103,0 days 00:00:00.333048
Respect/Validation,1,,11,1,8,108,119,0 days 00:00:00.142231
nodeca/js-yaml,1,,23,2,18,51,74,0 days 00:00:00.079228
documentationjs/documentation,1,v,36,23,7,49,85,0 days 00:00:00.106905
haifengl/smile,1,v,12,3,6,10,22,0 days 00:00:00.124942
vuejs/vetur,2, v,23,12,6,47,70,0 days 00:00:00.224864
google/ios-webkit-debug-proxy,2, v,9,2,5,9,18,0 days 00:00:00.020186
graphql-java/graphql-java,2, v,40,13,14,2,42,0 days 00:00:00.178796
sockeqwe/mosby,1,,7,3,2,8,15,0 days 00:00:00.035015
tilt-dev/tilt,1,v,30,18,4,172,202,0 days 00:00:00.316793
antonioru/beautiful-react-hooks,1,,5,2,1,6,11,0 days 00:00:00.032626
Lexikos/AutoHotkey_L,2,L v,56,48,2,146,202,0 days 00:00:00.174292
gzu-liyujiang/AndroidPicker,1,,11,3,5,45,56,0 days 00:00:00.039990
benbusby/whoogle-search,2, v,7,1,2,15,22,0 days 00:00:00.042268
dinerojs/dinero.js,2, v,13,8,3,17,30,0 days 00:00:00.035556
dotnetcore/CAP,1,v,22,5,11,30,52,0 days 00:00:00.108231
nl8590687/ASRT_SpeechRecognition,1,v,10,4,4,4,14,0 days 00:00:00.020283
doctrine/common,2, v,18,1,16,31,49,0 days 00:00:00.305124
express-validator/express-validator,1,v,55,29,15,60,115,0 days 00:00:00.086320
tensorflow/serving,2, r,25,6,10,27,52,0 days 00:00:00.419025
pagekit/pagekit,1,,4,1,2,31,35,0 days 00:00:00.320779
expressjs/cors,1,v,11,3,5,23,34,0 days 00:00:00.026805
hashicorp/serf,1,v,9,3,3,22,31,0 days 00:00:00.193577
jackc/pgx,1,v,36,11,14,18,54,0 days 00:00:00.210496
bfenetworks/bfe,1,v,18,10,3,0,18,0 days 00:00:00.059657
missive/emoji-mart,1,v,20,8,7,40,60,0 days 00:00:00.056268
mikaelbr/node-notifier,1,v,24,4,13,45,69,0 days 00:00:00.144798
MinecraftForge/MinecraftForge,2, v,59,33,13,10,69,0 days 00:00:00.631609
jbaysolutions/vue-grid-layout,1,,5,1,1,29,34,0 days 00:00:00.027037
jrnl-org/jrnl,2, v,13,2,5,24,37,0 days 00:00:00.098985
johnkerl/miller,2, v,29,15,8,23,52,0 days 00:00:00.482099
evernote/android-job,1,v,4,1,2,36,40,0 days 00:00:00.042880
serilog/serilog,1,v,19,3,7,13,32,0 days 00:00:00.098639
lutris/lutris,2, v,3,1,1,63,66,0 days 00:00:00.347975
weaveworks/scope,2, v,31,17,5,30,61,0 days 00:00:00.326355
jaywcjlove/hotkeys,1,v,12,4,7,62,74,0 days 00:00:00.049277
SixLabors/ImageSharp,1,v,3,1,1,6,9,0 days 00:00:01.130863
jonls/redshift,2, v,17,6,7,2,19,0 days 00:00:00.041183
NVIDIA/TensorRT,2, v,27,17,2,6,33,0 days 00:00:00.029431
angular-ui/ui-grid,1,v,24,10,11,86,110,0 days 00:00:00.250482
anishathalye/dotbot,1,v,20,6,11,28,48,0 days 00:00:00.029269
nathancahill/split,2, v,10,5,3,38,48,0 days 00:00:00.028718
gcanti/io-ts,1,,20,10,3,84,104,0 days 00:00:00.070032
algolia/places,1,v,34,26,4,69,103,0 days 00:00:00.081614
valor-software/ngx-bootstrap,2, v,31,15,9,81,112,0 days 00:00:00.150143
fatih/color,1,v,16,4,10,1,17,0 days 00:00:00.017832
jonschlinkert/remarkable,2, v,9,6,2,13,22,0 days 00:00:00.034590
ppoffice/hexo-theme-icarus,2, v,22,9,9,9,31,0 days 00:00:00.042433
ly525/luban-h5,1,v,18,12,3,14,32,0 days 00:00:00.044544
chyroc/WechatSogou,1,v,8,1,3,15,23,0 days 00:00:00.022035
mwouts/jupytext,3, v. v,20,10,7,75,95,0 days 00:00:00.129708
kaorun343/vue-property-decorator,1,v,24,8,5,16,40,0 days 00:00:00.035940
log4js-node/log4js-node,1,v,32,19,9,90,122,0 days 00:00:00.132648
arachnys/cabot,1,,6,4,1,33,39,0 days 00:00:00.050804
go-flutter-desktop/go-flutter,1,v,39,33,3,15,54,0 days 00:00:00.034813
alan-turing-institute/sktime,1,v,10,1,4,14,24,0 days 00:00:00.147042
open-cli-tools/concurrently,2, v,27,7,14,18,45,0 days 00:00:00.030184
go-acme/lego,1,v,34,15,7,17,51,0 days 00:00:00.092090
bytedance/xgplayer,1,v,4,1,2,44,48,0 days 00:00:00.048836
mixn/carbon-now-cli,2, v,5,2,1,7,12,0 days 00:00:00.134653
barryvdh/laravel-dompdf,1,v,10,1,8,24,34,0 days 00:00:00.019812
gorakhargosh/watchdog,1,v,12,2,6,35,47,0 days 00:00:00.181007
devicons/devicon,1,v,17,6,5,4,21,0 days 00:00:00.064257
agentejo/cockpit,1,,8,1,5,27,35,0 days 00:00:00.252567
django/channels,1,,20,9,8,44,64,0 days 00:00:00.073891
ExactTarget/fuelux,1,,25,10,6,59,84,0 days 00:00:00.223918
oauth2-proxy/oauth2-proxy,1,v,18,1,10,9,27,0 days 00:00:00.198627
berty/berty,1,v,390,387,1,579,969,0 days 00:00:01.496127
i-tu/Hasklig,2, v,12,5,4,0,12,0 days 00:00:00.036258
PyGithub/PyGithub,2, v,62,40,9,23,85,0 days 00:00:00.123948
containers/buildah,3, V v,42,22,3,70,112,0 days 00:00:00.402583
domlysz/BlenderGIS,2, v,3,1,1,0,3,0 days 00:00:00.029382
tjanczuk/edge,1,v,11,5,5,23,34,0 days 00:00:00.041959
tzapu/WiFiManager,2, v,16,10,3,0,16,0 days 00:00:00.024364
alibaba/transmittable-thread-local,2, v,18,6,8,31,49,0 days 00:00:00.053787
leongersen/noUiSlider,1,,45,19,16,58,103,0 days 00:00:00.073796
arturbien/React95,1,v,13,7,3,6,19,0 days 00:00:00.040930
encode/uvicorn,1,,17,4,4,119,136,0 days 00:00:00.106609
mher/flower,1,v,9,1,6,15,24,0 days 00:00:00.067396
crowdsecurity/crowdsec,1,v,7,1,3,39,46,0 days 00:00:00.059786
substack/minimist,1,,6,2,2,20,26,0 days 00:00:00.014636
wasabeef/Blurry,1,,6,1,4,7,13,0 days 00:00:00.014850
graphql-dotnet/graphql-dotnet,2, v,42,24,7,45,87,0 days 00:00:00.124760
h6ah4i/android-advancedrecyclerview,1,,8,1,6,22,30,0 days 00:00:00.135773
release-it/release-it,1,,84,66,12,176,260,0 days 00:00:00.172802
kartik-v/bootstrap-fileinput,1,v,26,18,7,61,87,0 days 00:00:00.093553
crossplane/crossplane,1,v,23,11,3,34,57,0 days 00:00:00.309564
nodegit/nodegit,1,v,27,9,10,67,94,0 days 00:00:00.212133
naver/billboard.js,1,,21,1,13,54,75,0 days 00:00:00.192206
go-task/task,1,v,26,9,7,26,52,0 days 00:00:00.068627
sachinchoolur/lightGallery,2, v,16,4,8,66,82,0 days 00:00:00.081332
phan/phan,1,,33,13,10,127,160,0 days 00:00:00.399560
nhn/tui.image-editor,2, v,21,7,12,17,38,0 days 00:00:00.048736
bestiejs/benchmark.js,1,,5,2,2,19,24,0 days 00:00:00.064086
wangyu-/udp2raw,1,,38,31,2,0,38,0 days 00:00:00.132414
vrana/adminer,1,v,17,4,11,35,52,0 days 00:00:00.267352
snorkel-team/snorkel,1,v,4,1,2,11,15,0 days 00:00:00.220769
arkime/arkime,1,v,32,2,17,70,102,0 days 00:00:00.281886
hiroppy/fusuma,1,v,37,32,3,59,96,0 days 00:00:00.082995
GoogleChrome/lighthouse-ci,1,v,9,1,5,24,33,0 days 00:00:00.051527
onionshare/onionshare,2, v,18,5,11,9,27,0 days 00:00:00.378296
share/sharedb,1,v,23,7,9,111,134,0 days 00:00:00.117274
windicss/windicss,1,v,13,8,1,81,94,0 days 00:00:00.066326
lancedikson/bowser,2, v,26,11,8,33,59,0 days 00:00:00.065673
ai/size-limit,1,,45,29,7,101,146,0 days 00:00:00.094286
rectorphp/rector,2, v,13,1,9,351,364,0 days 00:00:00.957056
reviewdog/reviewdog,2, v,6,1,4,21,27,0 days 00:00:00.136925
rmax/scrapy-redis,2, v,6,1,3,12,18,0 days 00:00:00.020036
timolins/react-hot-toast,1,v,7,3,2,5,12,0 days 00:00:00.021535
vuejs/v2.vuejs.org,1,v,8,4,3,9,17,0 days 00:00:00.031135
microsoft/Windows-driver-samples,1,,609,57,1,0,609,0 days 00:00:00.522342
reactchartjs/react-chartjs-2,3, v. v,24,9,9,51,75,0 days 00:00:00.049231
laravel/socialite,1,v,18,2,9,62,80,0 days 00:00:00.061362
msiemens/tinydb,2, v,34,10,16,26,60,0 days 00:00:00.052110
chainer/chainer,1,v,60,47,3,18,78,0 days 00:00:02.474178
luraproject/lura,2, v,15,2,10,12,27,0 days 00:00:00.049494
reek/anti-adblock-killer,1,v,31,29,1,0,31,0 days 00:00:00.031661
nhn/tui.chart,2, v,38,21,8,60,98,0 days 00:00:00.151379
jvm-profiling-tools/async-profiler,1,v,14,2,9,9,23,0 days 00:00:00.041787
expressjs/body-parser,1,,21,9,8,47,68,0 days 00:00:00.056991
openpgpjs/openpgpjs,1,v,40,18,13,109,149,0 days 00:00:00.166968
jarun/buku,2, v,36,18,6,3,39,0 days 00:00:00.114128
btraceio/btrace,3, release- v,5,1,2,34,39,0 days 00:00:00.078059
healthchecks/healthchecks,2, v,28,10,1,8,36,0 days 00:00:00.129538
journeyapps/zxing-android-embedded,1,v,15,4,9,7,22,0 days 00:00:00.065957
minbrowser/min,2, v,26,4,8,31,57,0 days 00:00:00.135171
pypa/pipx,1,,15,7,5,36,51,0 days 00:00:00.044039
spectreconsole/spectre.console,1,,44,38,1,3,47,0 days 00:00:00.040606
laravel-mix/laravel-mix,1,v,27,19,3,105,132,0 days 00:00:00.132504
TommyLemon/Android-ZBLibrary,1,,21,13,4,4,25,0 days 00:00:00.196656
Mailtrain-org/mailtrain,1,v,25,20,2,10,35,0 days 00:00:00.081694
standard-things/esm,1,,29,27,1,160,189,0 days 00:00:00.527781
uber/prototool,1,v,18,13,3,2,20,0 days 00:00:00.035724
Snapchat/KeyDB,1,v,6,1,2,16,22,0 days 00:00:01.562495
lukeed/polka,1,v,5,2,2,9,14,0 days 00:00:00.021522
ZipArchive/ZipArchive,2, v,17,4,9,80,97,0 days 00:00:00.075627
wiremock/wiremock,2, release-,55,28,16,28,83,0 days 00:00:00.137981
zhaojun1998/zfile,1,,32,26,3,11,43,0 days 00:00:00.035741
json5/json5,1,v,10,1,7,8,18,0 days 00:00:00.034375
johannesjo/super-productivity,1,v,58,48,3,296,354,0 days 00:00:00.645274
uNetworking/uWebSockets.js,1,v,59,51,3,6,65,0 days 00:00:00.069002
istanbuljs/nyc,1,v,58,43,4,56,114,0 days 00:00:00.201838
kedacore/keda,1,v,14,3,4,3,17,0 days 00:00:00.108059
timber/timber,2, v,32,10,14,96,128,0 days 00:00:00.337068
material-shell/material-shell,2, v,11,7,2,0,11,0 days 00:00:00.055820
panjf2000/gnet,1,v,8,2,5,35,43,0 days 00:00:00.055632
aws/aws-sdk-php,1,,234,217,7,1228,1462,0 days 00:00:02.585693
rauchg/slackin,1,,14,8,3,26,40,0 days 00:00:00.031992
pedroslopez/whatsapp-web.js,1,v,18,8,3,39,57,0 days 00:00:00.045535
google/benchmark,1,v,8,2,5,9,17,0 days 00:00:00.083058
Angel-ML/angel,2,Release- v,14,2,6,4,18,0 days 00:00:00.165501
reactjs/react-rails,2, v,24,9,9,31,55,0 days 00:00:00.087118
fengyuanchen/viewerjs,1,v,21,6,10,28,49,0 days 00:00:00.040279
kubeedge/kubeedge,1,v,14,1,10,11,25,0 days 00:00:00.289373
docker/machine,2, v,16,2,8,16,32,0 days 00:00:00.235953
roadrunner-server/roadrunner,2, v,22,7,7,81,103,0 days 00:00:00.192907
SigmaHQ/sigma,1,,19,6,6,10,29,0 days 00:00:00.655024
vitalets/x-editable,1,,6,4,1,9,15,0 days 00:00:00.036197
LonamiWebs/Telethon,1,v,44,26,4,91,135,0 days 00:00:00.208558
go-admin-team/go-admin,1,v,6,1,3,27,33,0 days 00:00:00.074936
ponylang/ponyc,2, release-,51,31,9,56,107,0 days 00:00:00.550748
hajimehoshi/ebiten,1,v,17,2,13,66,83,0 days 00:00:00.482518
meetecho/janus-gateway,1,v,11,1,7,53,64,0 days 00:00:00.425104
glidejs/glide,1,v,8,1,5,25,33,0 days 00:00:00.038945
sghall/react-move,1,v,28,19,7,21,49,0 days 00:00:00.161820
hotoo/pinyin,1,,13,1,10,28,41,0 days 00:00:00.033379
espnet/espnet,1,v.,11,1,6,32,43,0 days 00:00:00.985119
ServiceStack/ServiceStack,1,v,17,2,12,41,58,0 days 00:00:00.786049
mobxjs/mobx-state-tree,2, v,38,28,7,64,102,0 days 00:00:00.271737
electronicarts/EASTL,1,,14,1,8,31,45,0 days 00:00:00.043747
boto/boto,2, v,50,28,10,29,79,0 days 00:00:00.507139
0x7c13/Notepads,1,v,14,9,2,42,56,0 days 00:00:00.068739
wilsonpage/fastdom,2, v,8,5,2,23,31,0 days 00:00:00.025772
ocrmypdf/OCRmyPDF,1,v,63,40,7,115,178,0 days 00:00:00.228256
mbdavid/LiteDB,2,v. v,8,1,3,27,35,0 days 00:00:00.123145
electerm/electerm,2, v,35,23,5,292,327,0 days 00:00:00.217957
sebastianbergmann/exporter,1,,7,2,4,12,19,0 days 00:00:00.042176
mRemoteNG/mRemoteNG,2, v,17,9,7,23,40,0 days 00:00:00.232268
baconjs/bacon.js,1,,9,3,3,200,209,0 days 00:00:00.265318
zendesk/android-floating-action-button,1,,11,9,1,4,15,0 days 00:00:00.020466
zo0r/react-native-push-notification,2, v,16,10,2,19,35,0 days 00:00:00.058648
kelektiv/node.bcrypt.js,2, v,11,1,9,39,50,0 days 00:00:00.045092
rs/zerolog,1,v,27,9,8,16,43,0 days 00:00:00.029827
houtianze/bypy,1,,5,1,2,69,74,0 days 00:00:00.053476
appleboy/gorush,2, v,16,6,8,15,31,0 days 00:00:00.057450
mautic/mautic,1,,30,6,13,59,89,0 days 00:00:01.521411
linkedin/css-blocks,2, v,17,9,4,22,39,0 days 00:00:00.092693
rancher/os,1,v,15,4,6,43,58,0 days 00:00:00.159713
opencart/opencart,1,,11,4,5,24,35,0 days 00:00:00.905932
sindresorhus/caprine,2, v,70,49,3,43,113,0 days 00:00:00.072620
optuna/optuna,1,v,36,27,2,4,40,0 days 00:00:00.616235
doctrine/annotations,2, v,14,1,9,20,34,0 days 00:00:00.384120
conventional-changelog/standard-version,1,v,24,8,13,13,37,0 days 00:00:00.033264
the-benchmarker/web-frameworks,2, v,3,1,1,13,16,0 days 00:00:00.054133
Squirrel/Squirrel.Windows,1,,17,5,7,48,65,0 days 00:00:00.084914
sebastianbergmann/environment,1,,11,1,6,27,38,0 days 00:00:00.140785
ramboxapp/community-edition,1,,7,3,3,36,43,0 days 00:00:00.080215
kpdecker/jsdiff,1,v,15,3,9,24,39,0 days 00:00:00.132497
dylanaraps/pywal,1,,17,10,2,65,82,0 days 00:00:00.083734
yugabyte/yugabyte-db,2, v,18,1,12,73,91,0 days 00:00:01.012701
simeji/jid,2, v,7,4,1,14,21,0 days 00:00:00.020427
Uberi/speech_recognition,1,,16,6,6,29,45,0 days 00:00:00.038102
graphql/express-graphql,1,v,12,3,7,31,43,0 days 00:00:00.057899
isomorphic-git/isomorphic-git,1,v,96,86,3,238,334,0 days 00:00:00.224224
vmware-tanzu/velero,1,v,17,2,8,43,60,0 days 00:00:00.194574
gocd/gocd,1,,69,48,4,2,71,0 days 00:00:01.035666
automl/auto-sklearn,3, v. v,12,2,6,21,33,0 days 00:00:00.161089
Cyan4973/xxHash,2,r v,12,4,4,11,23,0 days 00:00:00.088983
katspaugh/wavesurfer.js,2, v,26,5,10,105,131,0 days 00:00:00.143718
baldurk/renderdoc,1,v,39,6,11,0,39,0 days 00:00:00.924238
arc298/instagram-scraper,2, v,11,3,4,68,79,0 days 00:00:00.051369
symfony/translation,1,v,26,4,21,462,488,0 days 00:00:00.401495
FreeRDP/FreeRDP,1,,9,2,4,8,17,0 days 00:00:01.023125
invoiceninja/invoiceninja,1,v,41,21,5,387,428,0 days 00:00:01.509019
node-formidable/formidable,2, v,12,8,3,33,45,0 days 00:00:00.050802
feross/simple-peer,1,v,50,34,10,71,121,0 days 00:00:00.099331
maxogden/menubar,1,v,18,4,8,47,65,0 days 00:00:00.038000
Radarr/Radarr,2, v,99,64,14,13,112,0 days 00:00:00.750429
elasticsearch-dump/elasticsearch-dump,2, v,113,92,6,137,250,0 days 00:00:00.172273
PHPOffice/PHPWord,1,,12,3,7,8,20,0 days 00:00:00.228964
albertlauncher/albert,1,v,17,9,5,64,81,0 days 00:00:00.094613
99designs/aws-vault,1,v,34,17,9,32,66,0 days 00:00:00.085235
doccano/doccano,1,v,8,2,3,19,27,0 days 00:00:00.179169
dtm-labs/dtm,1,v,21,18,1,35,56,0 days 00:00:00.070355
StackExchange/blackbox,1,v,18,6,8,0,18,0 days 00:00:00.039400
amoffat/sh,1,,34,26,5,17,51,0 days 00:00:00.080131
JetBrains/Exposed,1,,8,3,3,78,86,0 days 00:00:00.126059
yocontra/react-responsive,1,v,8,2,4,28,36,0 days 00:00:00.029951
apache/storm,2, v,11,1,9,26,37,0 days 00:00:01.026912
gitalk/gitalk,1,v,5,1,3,16,21,0 days 00:00:00.020459
Zizaco/entrust,1,,10,2,7,8,18,0 days 00:00:00.034932
RichardKnop/machinery,1,v,11,1,7,86,97,0 days 00:00:00.087167
medialize/URI.js,2,v. v,20,7,11,54,74,0 days 00:00:00.069634
jackocnr/intl-tel-input,2, v,62,41,10,262,324,0 days 00:00:00.324208
DIYgod/APlayer,2, v,6,3,2,15,21,0 days 00:00:00.028364
yagop/node-telegram-bot-api,1,v,26,14,6,13,39,0 days 00:00:00.045013
react-native-video/react-native-video,2, v,24,13,7,49,73,0 days 00:00:00.191072
shentao/vue-multiselect,2, v,5,2,1,20,25,0 days 00:00:00.034218
maxence-charriere/go-app,2, v,37,24,6,69,106,0 days 00:00:00.098038
i18next/i18next,2, v,91,66,9,222,313,0 days 00:00:00.323262
jiaaro/pydub,1,v,17,3,9,19,36,0 days 00:00:00.046694
NixOS/nix,1,,37,5,23,53,90,0 days 00:00:00.854883
go-resty/resty,1,v,34,14,10,7,41,0 days 00:00:00.163645
baskerville/bspwm,1,,9,5,1,15,24,0 days 00:00:00.080462
dataarts/dat.gui,2, v,6,1,2,18,24,0 days 00:00:00.041502
redux-offline/redux-offline,2, v,7,1,4,9,16,0 days 00:00:00.033357
swaggo/swag,2,v. v,9,1,5,23,32,0 days 00:00:00.046797
software-mansion/react-native-reanimated,1,,23,10,2,19,42,0 days 00:00:00.105603
securego/gosec,2, v,16,3,8,8,24,0 days 00:00:00.055999
thephpleague/oauth2-server,1,,25,3,11,72,97,0 days 00:00:00.165956
ArthurHub/Android-Image-Cropper,1,,9,2,6,23,32,0 days 00:00:00.039683
fruitcake/laravel-cors,2,V v,16,5,10,33,49,0 days 00:00:00.035603
simonw/datasette,1,,55,43,6,39,94,0 days 00:00:00.138380
faker-js/faker,1,v,22,10,9,26,48,0 days 00:00:00.138775
gruntwork-io/terratest,1,v,39,21,9,296,335,0 days 00:00:00.304591
garris/BackstopJS,2, v,25,9,8,106,131,0 days 00:00:00.123210
electerious/Lychee,2, v,11,1,6,31,42,0 days 00:00:00.088973
dylang/npm-check,2, v,12,4,6,33,45,0 days 00:00:00.030075
bpmn-io/bpmn-js,2, v,75,46,7,155,230,0 days 00:00:00.404169
belluzj/fantasque-sans,2, v,5,1,2,10,15,0 days 00:00:00.023445
centrifugal/centrifugo,1,v,24,5,9,57,81,0 days 00:00:00.107509
chrismaltby/gb-studio,2, v,6,3,2,6,12,0 days 00:00:00.214170
pahen/madge,2, v,30,13,11,29,59,0 days 00:00:00.051716
marshmallow-code/marshmallow,1,,48,22,11,77,125,0 days 00:00:00.216048
react-native-svg/react-native-svg,2, v,45,30,7,164,209,0 days 00:00:00.278838
snipe/snipe-it,3, V v,30,12,13,130,160,0 days 00:00:00.713895
PaddlePaddle/Paddle-Lite,3, release/ v,15,4,7,6,21,0 days 00:00:00.524765
uber/cadence,1,v,22,9,7,55,77,0 days 00:00:00.334032
gsoft-inc/craco,1,v,32,24,2,27,59,0 days 00:00:00.044913
jenssegers/laravel-mongodb,2, v,19,3,12,91,110,0 days 00:00:00.123671
tindy2013/subconverter,1,v,7,3,2,28,35,0 days 00:00:00.046797
chancejs/chancejs,2, v,9,3,5,47,56,0 days 00:00:00.066024
crater-invoice/crater,1,,11,4,4,19,30,0 days 00:00:00.079938
aws/aws-sam-cli,1,v,96,89,1,36,132,0 days 00:00:00.145332
concourse/concourse,1,v,134,117,4,81,215,0 days 00:00:01.864955
thedevs-network/kutt,1,v,10,5,2,51,61,0 days 00:00:00.050208
filhodanuvem/gitql,2, v,10,2,6,8,18,0 days 00:00:00.029692
mcollina/autocannon,1,v,52,36,9,43,95,0 days 00:00:00.062553
supertokens/supertokens-core,1,v,22,15,2,17,39,0 days 00:00:00.051690
SocketCluster/socketcluster,3, v. v,17,13,3,26,43,0 days 00:00:00.073324
hashicorp/raft,1,v,5,1,3,15,20,0 days 00:00:00.058052
wojtekmaj/react-pdf,1,v,27,13,6,36,63,0 days 00:00:00.078928
xonsh/xonsh,1,,12,1,10,100,112,0 days 00:00:00.644980
flot/flot,2, v,16,6,7,35,51,0 days 00:00:00.188213
reactiveui/refit,2, v,13,3,6,39,52,0 days 00:00:00.132233
onsi/ginkgo,1,v,19,3,11,21,40,0 days 00:00:00.062903
fabiospampinato/cash,1,,16,8,5,36,52,0 days 00:00:00.049115
burnash/gspread,2, v,19,9,8,21,40,0 days 00:00:00.073950
sindresorhus/query-string,2, v,34,12,12,38,72,0 days 00:00:00.044441
plantuml/plantuml,1,v,9,2,4,78,87,0 days 00:00:00.092863
OJ/gobuster,1,v,11,1,7,4,15,0 days 00:00:00.034539
google/error-prone,1,v,15,3,5,34,49,0 days 00:00:00.394470
karatelabs/karate,1,v,11,1,6,27,38,0 days 00:00:00.204271
bytedeco/javacv,1,,17,1,14,14,31,0 days 00:00:00.041068
jazzband/pip-tools,1,,45,22,12,49,94,0 days 00:00:00.222701
ractivejs/ractive,1,v,10,1,6,88,98,0 days 00:00:00.160913
Graylog2/graylog2-server,1,,25,1,20,124,149,0 days 00:00:01.452564
trpc/trpc,2, v,57,54,1,48,105,0 days 00:00:00.141234
heroiclabs/nakama,1,v,38,17,5,29,67,0 days 00:00:00.085547
rest-assured/rest-assured,1,rest-assured-,32,6,15,40,72,0 days 00:00:00.129942
spulec/moto,2, v,14,2,8,152,166,0 days 00:00:00.401656
ianstormtaylor/superstruct,1,v,14,7,4,55,69,0 days 00:00:00.077206
platformio/platformio-core,3, v. v,43,22,13,72,115,0 days 00:00:00.495291
webslides/WebSlides,1,,7,4,1,7,14,0 days 00:00:00.042769
File-New-Project/EarTrumpet,1,,9,2,6,29,38,0 days 00:00:00.089052
perkeep/perkeep,1,,11,5,5,0,11,0 days 00:00:00.528821
moroshko/react-autosuggest,1,v,41,30,6,54,95,0 days 00:00:00.157113
gruntwork-io/terragrunt,1,v,37,18,12,337,374,0 days 00:00:00.396917
geerlingguy/ansible-for-devops,1,,32,16,9,1,33,0 days 00:00:00.036302
Shougo/deoplete.nvim,1,,14,1,11,0,14,0 days 00:00:00.117780
twitchtv/twirp,1,v,18,8,8,10,28,0 days 00:00:00.048701
kulshekhar/ts-jest,2, v,30,14,8,88,118,0 days 00:00:00.254913
sparklemotion/nokogiri,2,REL_ v,15,2,10,89,104,0 days 00:00:00.484019
neuecc/UniRx,1,,18,8,5,7,25,0 days 00:00:00.061622
Unleash/unleash,2, v,34,19,7,132,166,0 days 00:00:00.454147
airbnb/hypernova,1,v,9,1,4,8,17,0 days 00:00:00.020821
cupy/cupy,1,v,56,48,1,6,62,0 days 00:00:01.894494
mahmoud/boltons,1,,24,9,9,21,45,0 days 00:00:00.089049
yuliskov/SmartTubeNext,1,,73,54,1,0,73,0 days 00:00:00.298703
postmanlabs/newman,3, v. v,26,8,8,80,106,0 days 00:00:00.268577
mitchellh/mapstructure,1,v,6,2,3,11,17,0 days 00:00:00.031376
davidjbradshaw/iframe-resizer,2, v,26,16,7,96,122,0 days 00:00:00.108220
weibocom/motan,1,,5,1,3,17,22,0 days 00:00:00.041371
TypeStrong/typedoc,2, v,22,3,13,127,149,0 days 00:00:00.139720
vmware-tanzu/octant,1,v,25,16,3,15,40,0 days 00:00:00.330991
travist/jsencrypt,2, v,7,2,3,3,10,0 days 00:00:00.019109
ethereum-mining/ethminer,1,v,10,1,5,3,13,0 days 00:00:01.112286
react-native-device-info/react-native-device-info,1,v,57,43,7,114,171,0 days 00:00:00.276680
Jrohy/multi-v2ray,1,v,18,10,4,79,97,0 days 00:00:00.135681
voidcosmos/npkill,1,v,8,5,2,19,27,0 days 00:00:00.035837
Financial-Times/polyfill-service,2, v,87,65,5,87,174,0 days 00:00:00.270635
gevent/gevent,2, v,19,4,12,35,54,0 days 00:00:00.339438
pentaho/pentaho-kettle,1,,31,10,16,37,68,0 days 00:00:00.972056
HMBSbige/ShadowsocksR-Windows,1,,28,12,13,127,155,0 days 00:00:00.147822
vuejs/vue-class-component,1,v,10,2,5,15,25,0 days 00:00:00.022622
deepmipt/DeepPavlov,1,,17,6,4,28,45,0 days 00:00:00.158337
mattn/go-sqlite3,1,v,16,4,7,19,35,0 days 00:00:00.067608
python-visualization/folium,1,v,11,1,7,10,21,0 days 00:00:00.231857
redux-observable/redux-observable,2, v,23,13,7,8,31,0 days 00:00:00.042826
plasma-umass/scalene,2, v,3,1,1,22,25,0 days 00:00:00.129583
kelseyhightower/confd,1,v,15,3,8,7,22,0 days 00:00:00.060758
vercel/serve,2, v,49,34,7,96,145,0 days 00:00:00.190078
taigaio/taiga-back,1,,24,7,9,74,98,0 days 00:00:00.336569
brython-dev/brython,1,,12,1,9,46,58,0 days 00:00:00.325260
UKPLab/sentence-transformers,1,v,10,3,5,20,30,0 days 00:00:00.064268
jsx-eslint/eslint-plugin-react,1,v,81,55,6,88,169,0 days 00:00:00.403296
PrestaShop/PrestaShop,1,,30,14,3,83,113,0 days 00:00:04.752788
mozilla/nunjucks,3, v. v,14,1,7,37,51,0 days 00:00:00.104003
carla-simulator/carla,1,,9,4,3,38,47,0 days 00:00:00.257624
hoffstadt/DearPyGui,1,v,8,4,1,10,18,0 days 00:00:00.250582
adnanh/webhook,1,,9,5,3,21,30,0 days 00:00:00.045734
hybridgroup/gobot,3, v. v,29,10,11,16,45,0 days 00:00:00.160273
metalsmith/metalsmith,2, v,24,15,3,60,84,0 days 00:00:00.044379
ffmpegwasm/ffmpeg.wasm,1,v,10,6,2,18,28,0 days 00:00:00.026973
sindresorhus/type-fest,1,v,40,29,3,34,74,0 days 00:00:00.036786
gcanti/fp-ts,1,,38,23,8,115,153,0 days 00:00:00.259208
remix-run/history,1,v,38,24,7,40,78,0 days 00:00:00.099797
cortexlabs/cortex,1,v,42,36,1,20,62,0 days 00:00:00.163147
colinhacks/zod,2, v,20,15,2,23,43,0 days 00:00:00.095550
rebassjs/rebass,1,v,11,3,5,42,53,0 days 00:00:00.100638
alibaba/formily,1,v,9,1,4,85,94,0 days 00:00:00.192342
beautify-web/js-beautify,1,v,13,3,7,74,87,0 days 00:00:00.192116
BeyondDimension/SteamTools,1,,10,6,3,28,38,0 days 00:00:00.238134
mvt-project/mvt,1,v,4,2,1,36,40,0 days 00:00:00.043122
mrdoob/stats.js,1,r,16,6,8,0,16,0 days 00:00:00.017532
prompt-toolkit/python-prompt-toolkit,1,,5,1,1,51,56,0 days 00:00:00.147131
sindresorhus/ora,1,v,24,9,9,13,37,0 days 00:00:00.024730
yjs/yjs,1,v,19,9,8,151,170,0 days 00:00:00.139545
nodegui/nodegui,1,v,48,42,1,45,93,0 days 00:00:00.103729
probot/probot,2, v,71,58,3,124,195,0 days 00:00:00.242488
chromedp/chromedp,1,v,8,1,5,33,41,0 days 00:00:00.045218
tailscale/tailscale,1,v,19,8,2,54,73,0 days 00:00:00.281244
yiminghe/async-validator,2, v,18,4,11,59,77,0 days 00:00:00.039383
paramiko/paramiko,3, release- v,23,3,13,152,175,0 days 00:00:00.250550
signalapp/Signal-Server,1,v,215,206,2,18,233,0 days 00:00:00.200448
theonedev/onedev,2, v,26,17,2,131,157,0 days 00:00:00.257528
go-swagger/go-swagger,2, v,29,8,11,26,55,0 days 00:00:00.192202
sindresorhus/ky,1,v,29,15,2,18,47,0 days 00:00:00.031227
ckeditor/ckeditor5,2, v,48,30,3,6,54,0 days 00:00:03.180575
kubernetes/kompose,1,v,34,22,6,3,37,0 days 00:00:00.100277
developit/mitt,2, v,6,1,3,5,11,0 days 00:00:00.017871
99designs/gqlgen,2, v,16,7,6,35,51,0 days 00:00:00.173859
react-native-image-picker/react-native-image-picker,2, v,37,22,8,86,123,0 days 00:00:00.101375
konvajs/konva,1,,41,18,8,131,172,0 days 00:00:00.305887
react-grid-layout/react-draggable,1,v,24,9,7,57,81,0 days 00:00:00.057062
chaijs/chai,2, v,30,11,9,48,78,0 days 00:00:00.107266
akveo/nebular,1,v,23,9,4,23,46,0 days 00:00:00.143614
symfony/http-kernel,1,v,26,4,21,489,515,0 days 00:00:00.710195
swagger-api/swagger-editor,3, v/ v,27,11,11,364,391,0 days 00:00:00.734621
retejs/rete,2, v,12,4,3,35,47,0 days 00:00:00.041638
dropwizard/metrics,1,v,10,1,8,77,87,0 days 00:00:00.216807
go-vgo/robotgo,2, v,21,4,9,24,45,0 days 00:00:00.073379
secdev/scapy,1,v,80,71,8,432,512,0 days 00:00:00.656716
streamlink/streamlink,1,,30,9,7,17,47,0 days 00:00:00.223265
isaacs/node-glob,2, v,18,5,10,102,120,0 days 00:00:00.062346
NginxProxyManager/nginx-proxy-manager,2, v,10,4,2,48,58,0 days 00:00:00.287003
QuantConnect/Lean,2, v,1917,1077,4,10,1927,0 days 00:00:05.448841
visionmedia/page.js,2, v,10,3,4,29,39,0 days 00:00:00.050196
xupefei/Locale-Emulator,2, v,13,7,5,14,27,0 days 00:00:00.031864
HangfireIO/Hangfire,2,v. v,13,4,4,92,105,0 days 00:00:00.206501
trustedsec/social-engineer-toolkit,1,,17,4,9,87,104,0 days 00:00:00.878281
prometheus/node_exporter,2, v,17,2,12,11,28,0 days 00:00:00.325789
DaveGamble/cJSON,1,v,9,5,1,36,45,0 days 00:00:00.083176
guzzle/psr7,1,,12,1,9,17,29,0 days 00:00:00.043844
twigphp/Twig,1,v,66,29,23,139,205,0 days 00:00:00.532983
metricsgraphics/metrics-graphics,3,V v. v,25,12,5,10,35,0 days 00:00:00.107713
doctrine/cache,2, v,17,4,9,27,44,0 days 00:00:00.067385
symfony/polyfill-mbstring,1,v,25,2,13,9,34,0 days 00:00:00.018294
InsertKoinIO/koin,1,,13,5,6,33,46,0 days 00:00:00.122365
FormidableLabs/radium,1,v,17,6,6,46,63,0 days 00:00:00.074784
react-cosmos/react-cosmos,2, v,33,18,8,41,74,0 days 00:00:00.138951
altair-viz/altair,2, v,13,3,7,8,21,0 days 00:00:00.183507
ionic-team/capacitor,2, v,18,6,3,138,156,0 days 00:00:00.322901
openspug/spug,2,V v,8,3,3,34,42,0 days 00:00:00.071044
webdriverio/webdriverio,1,v,91,65,12,415,506,0 days 00:00:01.031956
wix/react-native-calendars,2, v,1248,229,2,59,1307,0 days 00:00:02.210442
webpack/webpack-dev-server,1,v,42,25,9,70,112,0 days 00:00:00.150874
kelektiv/node-cron,2, v,12,2,8,23,35,0 days 00:00:00.037859
gotify/server,1,v,5,1,3,41,46,0 days 00:00:00.043454
gogf/gf,1,v,14,2,4,106,120,0 days 00:00:00.420701
krallin/tini,1,v,19,6,6,14,33,0 days 00:00:00.026393
oclif/oclif,1,v,59,50,5,261,320,0 days 00:00:00.288162
cryptomator/cryptomator,1,,18,7,6,73,91,0 days 00:00:00.385123
lanpa/tensorboardX,1,v,15,2,9,1,16,0 days 00:00:00.039258
facebook/jscodeshift,2, v,11,1,8,45,56,0 days 00:00:00.041142
lib/pq,1,v,11,3,5,10,21,0 days 00:00:00.051525
LeetCode-OpenSource/vscode-leetcode,1,v,17,9,4,26,43,0 days 00:00:00.029937
sosedoff/pgweb,1,v,11,6,3,31,42,0 days 00:00:00.070617
Supervisor/supervisor,1,,8,1,6,22,30,0 days 00:00:00.149240
numba/numba,2, v,54,9,8,51,105,0 days 00:00:01.528866
sandboxie-plus/Sandboxie,2, v,11,3,4,58,69,0 days 00:00:00.107958
cerebroapp/cerebro,2, v,5,1,3,16,21,0 days 00:00:00.056561
mopidy/mopidy,1,v,29,6,16,38,67,0 days 00:00:00.567100
Sonarr/Sonarr,1,v,44,27,6,8,52,0 days 00:00:00.557837
i18next/react-i18next,2, v,84,68,6,164,248,0 days 00:00:00.169389
mamedev/mame,1,mame,124,89,11,0,124,0 days 00:00:05.309051
fideloper/TrustedProxy,1,,13,1,11,11,24,0 days 00:00:00.024862
winsw/winsw,1,v,21,6,12,10,31,0 days 00:00:00.054185
symfony/debug,1,v,16,2,13,354,370,0 days 00:00:00.303760
davemorrissey/subsampling-scale-image-view,1,v,13,7,5,8,21,0 days 00:00:00.031119
JeffreySu/WeiXinMPSDK,2, v,4,1,2,40,44,0 days 00:00:00.550967
AlessandroZ/LaZagne,2, v,14,6,5,6,20,0 days 00:00:00.067233
facebook/litho,1,v,41,25,3,157,198,0 days 00:00:00.913448
be5invis/Sarasa-Gothic,1,v,25,12,8,93,118,0 days 00:00:00.059125
FluentValidation/FluentValidation,1,,49,14,24,60,109,0 days 00:00:00.144965
AppImage/AppImageKit,1,,13,4,8,0,13,0 days 00:00:00.110947
rocksdanister/lively,1,v,18,15,2,29,47,0 days 00:00:00.037318
xo/usql,1,v,10,4,5,22,32,0 days 00:00:00.045890
terkelg/prompts,1,v,9,2,4,24,33,0 days 00:00:00.028386
PointCloudLibrary/pcl,1,pcl-,13,2,8,12,25,0 days 00:00:00.857722
sebastianbergmann/php-timer,1,,7,1,3,19,26,0 days 00:00:00.028967
evilsocket/opensnitch,1,v,4,1,2,7,11,0 days 00:00:00.067926
MichalLytek/type-graphql,1,v,19,13,1,18,37,0 days 00:00:00.050759
cjbassi/gotop,1,,9,5,1,24,33,0 days 00:00:00.030745
pennersr/django-allauth,1,,42,13,18,13,55,0 days 00:00:00.151736
smartystreets/goconvey,2, v,7,3,3,20,27,0 days 00:00:00.064500
styled-components/polished,2,v. v,22,12,6,56,78,0 days 00:00:00.069202
qemu/qemu,2,release_ v,48,2,42,86,134,0 days 00:00:07.950626
fancyapps/fancybox,3, V v,5,1,3,30,35,0 days 00:00:00.032154
pytube/pytube,2, v,31,18,9,78,109,0 days 00:00:00.210623
sveltejs/sapper,1,v,29,23,4,149,178,0 days 00:00:00.139514
ngrx/platform,2, v,35,19,5,25,60,0 days 00:00:00.240115
inorganik/countUp.js,2, v,13,3,8,26,39,0 days 00:00:00.033163
chrisvfritz/prerender-spa-plugin,2, v,10,4,3,1,11,0 days 00:00:00.018605
barteksc/AndroidPdfViewer,1,,14,8,2,8,22,0 days 00:00:00.020367
graphql-python/graphene,2,v. v,16,7,5,29,45,0 days 00:00:00.101308
angular/angularfire,2, v,11,2,5,28,39,0 days 00:00:00.082498
jpillora/chisel,2, v,8,2,4,21,29,0 days 00:00:00.024445
OWASP/Amass,2, v,37,25,6,123,160,0 days 00:00:00.138431
java-native-access/jna,2, v,26,3,18,32,58,0 days 00:00:00.227584
symfony/routing,1,v,26,4,21,441,467,0 days 00:00:00.407494
leeoniya/uPlot,1,,7,3,1,44,51,0 days 00:00:00.073837
lz4/lz4,2,v r,18,11,2,11,29,0 days 00:00:00.128444
es-shims/es5-shim,1,v,19,8,7,77,96,0 days 00:00:00.178833
kekingcn/kkFileView,2, v,5,1,2,5,10,0 days 00:00:00.027862
nopSolutions/nopCommerce,1,release-,29,20,8,6,35,0 days 00:00:00.799306
sebastianbergmann/diff,1,,7,1,5,11,18,0 days 00:00:00.026040
boto/boto3,1,,24,8,11,1045,1069,0 days 00:00:01.820474
pillarjs/path-to-regexp,2, v,24,9,11,28,52,0 days 00:00:00.033788
surmon-china/vue-quill-editor,1,v,6,2,2,21,27,0 days 00:00:00.018851
metafizzy/flickity,1,v,10,3,6,24,34,0 days 00:00:00.041591
hrydgard/ppsspp,1,v,20,3,14,46,66,0 days 00:00:01.932385
vercel/styled-jsx,2, v,15,5,8,78,93,0 days 00:00:00.052330
AmruthPillai/Reactive-Resume,1,v,7,4,2,24,31,0 days 00:00:00.167502
yhirose/cpp-httplib,1,v,9,3,5,75,84,0 days 00:00:00.077291
ljharb/qs,1,v,25,11,10,49,74,0 days 00:00:00.066084
google/android-classyshark,1,,15,9,3,0,15,0 days 00:00:00.039659
Zettlr/Zettlr,3, v. v,28,14,6,49,77,0 days 00:00:00.336808
apache/cassandra,1,cassandra-,23,8,13,183,206,0 days 00:00:02.078537
laravel/tinker,1,v,9,3,4,17,26,0 days 00:00:00.114640
marionettejs/backbone.marionette,1,v,32,15,10,93,125,0 days 00:00:00.572089
phpmyadmin/phpmyadmin,2, RELEASE_,37,9,15,300,337,0 days 00:00:07.675985
jazzband/django-debug-toolbar,2, v,25,4,15,24,49,0 days 00:00:00.149892
sebastianbergmann/php-file-iterator,1,,7,1,5,27,34,0 days 00:00:00.027649
gitkraken/vscode-gitlens,2, v,45,33,4,91,136,0 days 00:00:00.331886
jemalloc/jemalloc,1,,22,4,14,24,46,0 days 00:00:00.338068
symfony/css-selector,1,v,26,4,20,434,460,0 days 00:00:00.384824
encode/starlette,1,,19,8,5,94,113,0 days 00:00:00.090130
raineorshine/npm-check-updates,2, v,56,34,11,194,250,0 days 00:00:00.310591
symfony/process,1,v,26,4,21,450,476,0 days 00:00:00.380573
mqttjs/MQTT.js,2, v,42,22,7,109,151,0 days 00:00:00.116277
developit/microbundle,2, v,15,7,6,24,39,0 days 00:00:00.058905
ThreeMammals/Ocelot,1,,31,19,6,110,141,0 days 00:00:00.118717
deepstreamIO/deepstream.io,2, v,25,7,8,98,123,0 days 00:00:00.133949
DevinVinson/WordPress-Plugin-Boilerplate,1,,9,5,2,5,14,0 days 00:00:00.033325
TrinityCore/TrinityCore,1,TDB,74,41,22,6,80,0 days 00:00:03.103676
Turfjs/turf,2, v,23,15,5,65,88,0 days 00:00:00.213930
xmrig/xmrig,1,v,46,34,7,73,119,0 days 00:00:00.232922
FullHuman/purgecss,2, v,23,11,7,20,43,0 days 00:00:00.080751
final-form/react-final-form,2,v. v,23,16,3,47,70,0 days 00:00:00.058900
reach/router,1,v,5,2,2,13,18,0 days 00:00:00.024978
wallabag/wallabag,1,,20,6,10,40,60,0 days 00:00:00.448005
matthew-andrews/isomorphic-fetch,1,v,12,7,3,14,26,0 days 00:00:00.016995
projectstorm/react-diagrams,2, v,16,6,6,23,39,0 days 00:00:00.067423
reactjs/react-modal,1,v,19,7,6,91,110,0 days 00:00:00.078163
ffuf/ffuf,1,v,18,8,5,6,24,0 days 00:00:00.031925
cython/cython,1,,19,2,10,71,90,0 days 00:00:00.915825
readthedocs/readthedocs.org,1,,76,55,5,152,228,0 days 00:00:01.382009
symfony/var-dumper,1,v,20,4,15,355,375,0 days 00:00:00.381857
abel533/Mapper,1,,18,8,5,33,51,0 days 00:00:00.050590
jsplumb/jsplumb,1,,28,5,18,188,216,0 days 00:00:00.523902
trentm/node-bunyan,1,,33,18,7,81,114,0 days 00:00:00.070209
cosmtrek/air,1,v,5,1,2,18,23,0 days 00:00:00.024905
kennethreitz/records,1,v,5,3,1,6,11,0 days 00:00:00.027191
rr-debugger/rr,1,,28,9,14,6,34,0 days 00:00:00.377177
verlok/vanilla-lazyload,2, v,81,56,15,77,158,0 days 00:00:00.133187
taskflow/taskflow,1,v,13,3,8,1,14,0 days 00:00:00.125309
musescore/MuseScore,1,v,11,1,9,24,35,0 days 00:00:01.534333
monero-project/monero,1,v,19,7,7,34,53,0 days 00:00:00.961167
Humanizr/Humanizer,3, V v,16,8,5,49,65,0 days 00:00:00.146969
bigskysoftware/htmx,2, v,12,6,1,18,30,0 days 00:00:00.215900
guess-js/guess,2, v,4,1,2,42,46,0 days 00:00:00.045757
microsoft/DeepSpeed,1,v,6,1,3,36,42,0 days 00:00:00.072514
hashicorp/terraform-provider-aws,1,v,226,223,1,33,259,0 days 00:00:03.790416
olivere/elastic,1,v,8,1,6,317,325,0 days 00:00:00.340574
brunch/brunch,1,,24,11,8,107,131,0 days 00:00:00.480227
reactiveui/ReactiveUI,2, v,41,24,6,181,222,0 days 00:00:00.754093
barry-ran/QtScrcpy,1,v,9,3,3,15,24,0 days 00:00:00.046835
monkeytypegame/monkeytype,1,v,16,6,1,111,127,0 days 00:00:00.486977
transmission/transmission,1,,99,69,12,1,100,0 days 00:00:00.769337
filamentgroup/loadCSS,2, v,9,2,6,14,23,0 days 00:00:00.026926
DylanVann/react-native-fast-image,1,v,20,8,7,90,110,0 days 00:00:00.061008
gobuffalo/buffalo,2, v,15,3,9,107,122,0 days 00:00:00.216233
ds300/patch-package,1,v,17,9,3,40,57,0 days 00:00:00.045427
ssssssss-team/spider-flow,1,v,5,3,1,6,11,0 days 00:00:00.028510
vercel/ncc,1,,31,21,4,46,77,0 days 00:00:00.056002
ajenti/ajenti,2, v,5,2,2,123,128,0 days 00:00:00.223412
needim/noty,1,v,10,2,5,37,47,0 days 00:00:00.031500
mongodb/mongo-go-driver,2, v,13,4,7,60,73,0 days 00:00:00.133134
cssinjs/jss,2, v,60,41,8,86,146,0 days 00:00:00.252774
tgalal/yowsup,1,v,8,3,4,20,28,0 days 00:00:00.079422
twpayne/chezmoi,1,v,27,16,4,106,133,0 days 00:00:00.219513
Nuitka/Nuitka,1,,13,8,4,238,251,0 days 00:00:00.632037
NLPchina/elasticsearch-sql,1,,46,21,13,144,190,0 days 00:00:00.118646
SigNoz/signoz,2, v,7,1,2,28,35,0 days 00:00:00.175548
alibaba/MNN,1,,13,9,3,36,49,0 days 00:00:00.231881
microsoft/azuredatastudio,2, v,40,28,2,89,129,0 days 00:00:00.907091
infracost/infracost,2, v,10,6,3,62,72,0 days 00:00:00.120985
kazupon/vue-i18n,1,v,64,37,7,83,147,0 days 00:00:00.140574
jupyterhub/jupyterhub,1,,19,2,11,20,39,0 days 00:00:00.337182
cockpit-project/cockpit,2, v,314,303,8,1,315,0 days 00:00:01.546255
ActivityWatch/activitywatch,1,v,8,4,3,11,19,0 days 00:00:00.049105
SirVer/ultisnips,1,,11,2,7,0,11,0 days 00:00:00.094720
Vincit/objection.js,1,,19,3,10,101,120,0 days 00:00:00.140228
lcobucci/jwt,1,,11,3,6,34,45,0 days 00:00:00.083628
kanboard/kanboard,1,v,3,1,1,71,74,0 days 00:00:00.220960
aheckmann/gm,2, v,31,13,12,35,66,0 days 00:00:00.049150
lucas-clemente/quic-go,2,v. v,24,5,10,33,57,0 days 00:00:00.358907
sindresorhus/fkill-cli,2, v,23,9,10,3,26,0 days 00:00:00.018925
BoyceLig/Clash_Chinese_Patch,1,,7,1,3,57,64,0 days 00:00:00.029147
ElemeFE/v-charts,1,v,14,9,2,72,86,0 days 00:00:00.055360
sindresorhus/np,1,v,42,24,10,34,76,0 days 00:00:00.043507
schollz/howmanypeoplearearound,1,v,4,2,1,11,15,0 days 00:00:00.016506
Rob--W/cors-anywhere,2, v,3,1,1,18,21,0 days 00:00:00.017057
juice-shop/juice-shop,2, v,91,67,8,101,192,0 days 00:00:01.225228
open-policy-agent/opa,1,v,40,22,6,80,120,0 days 00:00:00.351704
grpc/grpc-web,1,,7,4,2,9,16,0 days 00:00:00.056798
gregberge/loadable-components,1,v,30,19,6,35,65,0 days 00:00:00.046692
xojs/xo,1,v,43,24,8,43,86,0 days 00:00:00.066320
hugapi/hug,1,,18,11,5,44,62,0 days 00:00:00.159966
visgl/react-map-gl,2, v,22,10,9,143,165,0 days 00:00:00.137386
electron/fiddle,2, v,29,14,3,22,51,0 days 00:00:00.103206
enquirer/enquirer,1,,6,2,3,27,33,0 days 00:00:00.042610
aws/aws-sdk-js,1,v,1089,1078,5,301,1390,0 days 00:00:02.675628
jaredpalmer/tsdx,1,v,13,6,3,40,53,0 days 00:00:00.053472
Laravel-Lang/lang,1,,20,12,6,174,194,0 days 00:00:00.553980
flyway/flyway,1,flyway-,40,20,13,101,141,0 days 00:00:00.230942
wailsapp/wails,1,v,19,10,2,44,63,0 days 00:00:00.146311
wasabeef/glide-transformations,1,,9,3,5,10,19,0 days 00:00:00.020927
Hacker0x01/react-datepicker,2, v,107,85,2,73,180,0 days 00:00:00.347379
eclipse/che,1,,100,95,2,126,226,0 days 00:00:00.746280
migueldeicaza/gui.cs,1,v,13,6,4,9,22,0 days 00:00:00.270937
QUANTAXIS/QUANTAXIS,2, V,15,4,5,44,59,0 days 00:00:00.364975
Sylius/Sylius,1,v,30,4,16,151,181,0 days 00:00:01.972896
grpc/grpc-java,1,v,52,22,4,58,110,0 days 00:00:00.393366
josdejong/jsoneditor,1,v,71,48,11,125,196,0 days 00:00:00.284481
svgdotjs/svg.js,1,,50,38,8,48,98,0 days 00:00:00.201508
snapappointments/bootstrap-select,2, v,13,3,7,52,65,0 days 00:00:00.113975
stylelint/stylelint,2, v,97,78,4,88,185,0 days 00:00:00.509661
iterative/dvc,1,,92,83,3,258,350,0 days 00:00:00.601122
mdbootstrap/material-design-for-bootstrap,1,,18,11,5,46,64,0 days 00:00:00.031793
addyosmani/critical,2, v,17,4,9,44,61,0 days 00:00:00.057098
TranslucentTB/TranslucentTB,1,,14,7,6,0,14,0 days 00:00:00.090159
sindresorhus/pageres,2, v,24,8,7,23,47,0 days 00:00:00.037796
meliorence/react-native-snap-carousel,2,V v,22,15,2,29,51,0 days 00:00:00.038508
pockethub/PocketHub,2, v,11,5,3,9,20,0 days 00:00:00.176183
react-native-camera/react-native-camera,1,v,84,69,5,96,180,0 days 00:00:00.433257
TarsCloud/Tars,2, v,15,7,4,32,47,0 days 00:00:00.064145
senchalabs/connect,1,,52,27,11,174,226,0 days 00:00:00.248002
jhen0409/react-native-debugger,1,v,12,3,7,74,86,0 days 00:00:00.066014
lvgl/lvgl,2, v,26,10,7,20,46,0 days 00:00:00.506147
FormidableLabs/victory,1,v,65,43,8,156,221,0 days 00:00:00.642668
apidoc/apidoc,1,,27,7,10,19,46,0 days 00:00:00.056848
mswjs/msw,2, v,38,31,1,90,128,0 days 00:00:00.109793
Automattic/kue,2, v,10,2,7,47,57,0 days 00:00:00.081334
BookStackApp/BookStack,3, v. v,36,10,9,113,149,0 days 00:00:00.283777
botpress/botpress,2, v,88,76,4,234,322,0 days 00:00:00.965040
charmbracelet/glow,1,v,7,4,1,10,17,0 days 00:00:00.145648
deepmind/sonnet,1,v,35,24,1,0,35,0 days 00:00:00.058191
vnotex/vnote,2, v,47,34,4,13,60,0 days 00:00:00.101303
pinojs/pino,2, v,90,69,7,150,240,0 days 00:00:00.186141
argoproj/argo-cd,1,v,25,9,4,115,140,0 days 00:00:00.453604
future-architect/vuls,1,v,19,4,6,64,83,0 days 00:00:00.091260
catboost/catboost,3, v. v,25,7,3,57,82,0 days 00:00:01.374042
upx/upx,1,v,31,7,18,0,31,0 days 00:00:00.191057
Atmosphere-NX/Atmosphere,1,,18,7,6,48,66,0 days 00:00:00.194954
uncss/uncss,1,,9,2,5,9,18,0 days 00:00:00.037904
dingo/api,2, v,16,9,5,41,57,0 days 00:00:00.098983
reactjs/react-transition-group,1,v,19,9,7,19,38,0 days 00:00:00.039573
FormidableLabs/spectacle,2, v,35,12,11,77,112,0 days 00:00:00.098951
oblador/react-native-animatable,1,v,10,4,4,13,23,0 days 00:00:00.023313
squizlabs/PHP_CodeSniffer,1,,19,5,12,51,70,0 days 00:00:00.495422
mongodb/node-mongodb-native,3,V v. v,25,4,18,387,412,0 days 00:00:00.832252
r-spacex/SpaceX-API,2, v,15,9,3,8,23,0 days 00:00:00.201956
acaudwell/Gource,1,gource-,20,5,11,0,20,0 days 00:00:00.057582
deployphp/deployer,1,v,20,6,9,47,67,0 days 00:00:00.123011
arasatasaygin/is.js,1,v,8,5,2,13,21,0 days 00:00:00.031468
cheat/cheat,1,,18,10,4,67,85,0 days 00:00:00.088194
hackware1993/MagicIndicator,1,,8,4,2,5,13,0 days 00:00:00.018591
bulletphysics/bullet3,1,,18,5,9,6,24,0 days 00:00:00.594616
callstack/react-native-paper,2, v,53,40,5,61,114,0 days 00:00:00.123756
coredns/coredns,1,v,20,7,7,42,62,0 days 00:00:00.205061
docmirror/dev-sidecar,2, v,7,3,2,16,23,0 days 00:00:00.129770
chimurai/http-proxy-middleware,1,v,26,19,6,30,56,0 days 00:00:00.035821
exceljs/exceljs,2, v,41,28,7,180,221,0 days 00:00:00.335487
direnv/direnv,2, v,33,8,16,42,75,0 days 00:00:00.073584
crimx/ext-saladict,3, V v,59,47,6,139,198,0 days 00:00:00.229654
boardgameio/boardgame.io,1,v,39,28,4,111,150,0 days 00:00:00.143695
phpDocumentor/ReflectionDocBlock,1,,14,4,8,24,38,0 days 00:00:00.063941
rough-stuff/wired-elements,1,v,9,2,4,26,35,0 days 00:00:00.033745
javascript-obfuscator/javascript-obfuscator,1,,63,47,4,122,185,0 days 00:00:00.182644
ydataai/pandas-profiling,2,v. v,20,10,7,14,34,0 days 00:00:00.066548
coleifer/peewee,1,,35,12,13,139,174,0 days 00:00:00.375123
cure53/DOMPurify,2, v,12,3,8,68,80,0 days 00:00:00.110239
aksonov/react-native-router-flux,2, v,13,3,6,34,47,0 days 00:00:00.089729
Gallopsled/pwntools,1,,26,5,8,35,61,0 days 00:00:00.240211
didi/cube-ui,2, v,13,10,1,69,82,0 days 00:00:00.126630
react-dropzone/react-dropzone,2, v,55,34,12,120,175,0 days 00:00:00.091685
pyinstaller/pyinstaller,2, v,28,5,19,6,34,0 days 00:00:00.574390
ginuerzh/gost,2, v,21,11,7,11,32,0 days 00:00:00.042517
sinonjs/sinon,2, v,57,27,18,121,178,0 days 00:00:00.314156
paulmillr/chokidar,1,,28,10,14,70,98,0 days 00:00:00.110680
symfony/console,1,v,26,4,21,466,492,0 days 00:00:00.596723
thumbor/thumbor,1,,61,33,14,178,239,0 days 00:00:00.206716
sonic-pi-net/sonic-pi,1,v,16,5,7,9,25,0 days 00:00:00.561915
helmetjs/helmet,1,v,51,23,8,34,85,0 days 00:00:00.074019
mayswind/AriaNg,1,,9,1,6,14,23,0 days 00:00:00.036604
inversify/InversifyJS,2, v,25,15,7,22,47,0 days 00:00:00.085940
dromara/Sa-Token,1,v,23,18,2,1,24,0 days 00:00:00.053640
didi/chameleon,2, v,4,1,1,19,23,0 days 00:00:00.076209
callstack/linaria,1,v,14,9,4,24,38,0 days 00:00:00.131124
marmelab/gremlins.js,2, v,5,1,3,2,7,0 days 00:00:00.026476
capnproto/capnproto,1,v,9,1,6,12,21,0 days 00:00:00.338982
phpDocumentor/TypeResolver,1,,14,2,9,18,32,0 days 00:00:00.034611
gka/chroma.js,2, v,9,3,5,26,35,0 days 00:00:00.038737
aws/chalice,1,,38,17,8,43,81,0 days 00:00:00.146540
OWASP/owasp-mstg,2, v,5,1,3,7,12,0 days 00:00:00.502045
fkhadra/react-toastify,1,v,33,16,8,60,93,0 days 00:00:00.120679
crawlab-team/crawlab,1,v,6,1,3,21,27,0 days 00:00:00.135195
PrefectHQ/prefect,1,,17,5,6,102,119,0 days 00:00:00.931062
react-page/react-page,2, v,58,45,6,214,272,0 days 00:00:00.181917
TuSimple/naive-ui,2, v,26,23,1,70,96,0 days 00:00:00.415072
webtorrent/webtorrent-desktop,1,v,25,18,5,13,38,0 days 00:00:00.144833
heartexlabs/label-studio,2,v. v,14,4,2,24,38,0 days 00:00:00.119824
antvis/G6,1,,9,2,3,64,73,0 days 00:00:00.366469
facebook/chisel,1,,10,1,6,3,13,0 days 00:00:00.035802
remarkjs/react-markdown,2, v,22,7,11,46,68,0 days 00:00:00.047001
tinode/chat,1,v,6,1,4,45,51,0 days 00:00:00.258768
cert-manager/cert-manager,1,v,25,3,3,49,74,0 days 00:00:00.449653
facebookresearch/ParlAI,2, v,10,5,2,10,20,0 days 00:00:00.327205
encode/httpx,1,,23,10,4,47,70,0 days 00:00:00.083250
golang-migrate/migrate,1,v,24,7,7,25,49,0 days 00:00:00.080895
tweepy/tweepy,2, v,40,17,15,4,44,0 days 00:00:00.198731
Aircoookie/WLED,1,v,8,1,6,15,23,0 days 00:00:00.107550
zerotier/ZeroTierOne,1,,15,4,6,68,83,0 days 00:00:00.448792
GoogleChromeLabs/comlink,1,v,15,8,4,23,38,0 days 00:00:00.165710
OpenRefine/OpenRefine,2, v,13,1,10,9,22,0 days 00:00:00.498665
mementum/backtrader,1,,7,2,1,132,139,0 days 00:00:00.142119
coursera-dl/coursera-dl,1,,8,1,5,12,20,0 days 00:00:00.067208
gregberge/svgr,1,v,36,29,4,19,55,0 days 00:00:00.054625
desandro/imagesloaded,1,v,11,3,5,27,38,0 days 00:00:00.027447
ultralytics/yolov3,1,v,12,6,4,0,12,0 days 00:00:00.127870
mapeditor/tiled,1,v,27,3,20,56,83,0 days 00:00:00.359193
libretro/RetroArch,2, v,15,3,7,77,92,0 days 00:00:03.478972
pyodide/pyodide,2, v,20,11,6,25,45,0 days 00:00:00.213368
caprover/caprover,2,V v,12,6,5,17,29,0 days 00:00:00.093231
cefsharp/CefSharp,1,v,27,5,11,70,97,0 days 00:00:00.470941
piskelapp/piskel,1,v,14,2,9,16,30,0 days 00:00:00.101836
microsoft/Windows-universal-samples,2, v,438,13,9,171,609,0 days 00:00:00.454227
cyrus-and/gdb-dashboard,1,v,15,6,8,15,30,0 days 00:00:00.030812
tweenjs/tween.js,3, v r,30,12,12,23,53,0 days 00:00:00.057457
openframeworks/openFrameworks,1,,10,1,6,16,26,0 days 00:00:01.133885
mailpile/Mailpile,1,,5,1,2,6,11,0 days 00:00:00.218623
spotDL/spotify-downloader,1,v,14,4,4,38,52,0 days 00:00:00.087068
questdb/questdb,2, v,12,1,8,39,51,0 days 00:00:00.291060
EpistasisLab/tpot,2, v,9,1,5,15,24,0 days 00:00:00.127759
aws/serverless-application-model,2, v,42,25,6,9,51,0 days 00:00:00.083511
Automattic/node-canvas,2, v,30,11,13,88,118,0 days 00:00:00.134573
claudiodangelis/qrcp,1,,6,2,3,17,23,0 days 00:00:00.029544
doctrine/dbal,2, v,18,2,14,79,97,0 days 00:00:00.752084
pytest-dev/pytest,1,,42,10,17,122,164,0 days 00:00:00.991773
XTLS/Xray-core,1,v,6,3,1,21,27,0 days 00:00:00.035492
muesli/duf,1,v,8,5,2,4,12,0 days 00:00:00.019391
Justson/AgentWeb,2, v,4,1,1,13,17,0 days 00:00:00.042463
google/go-github,1,v,59,43,6,35,94,0 days 00:00:00.145219
nextapps-de/flexsearch,1,,4,2,1,13,17,0 days 00:00:00.022597
welldone-software/why-did-you-render,2,v. v,19,8,6,67,86,0 days 00:00:00.045918
jprichardson/node-fs-extra,2, v,43,18,12,42,85,0 days 00:00:00.080718
shipshapecode/tether,1,v,13,6,4,60,73,0 days 00:00:00.075014
Shopify/sarama,1,v,34,10,15,18,52,0 days 00:00:00.174672
listen1/listen1_chrome_extension,1,v,32,22,7,36,68,0 days 00:00:00.045630
pmndrs/jotai,1,v,24,17,1,88,112,0 days 00:00:00.162858
wkentaro/labelme,1,v,50,38,9,125,175,0 days 00:00:00.142608
chakra-core/ChakraCore,1,v,9,1,3,52,61,0 days 00:00:00.734391
gskinner/regexr,1,,5,2,1,6,11,0 days 00:00:00.023577
MarshallOfSound/Google-Play-Music-Desktop-Player-UNOFFICIAL-,2, v,26,17,3,32,58,0 days 00:00:00.209348
tsayen/dom-to-image,1,,13,7,3,23,36,0 days 00:00:00.030520
blevesearch/bleve,1,v,14,3,7,27,41,0 days 00:00:00.190171
restsharp/RestSharp,2, v,30,14,11,29,59,0 days 00:00:00.228134
nilaoda/N_m3u8DL-CLI,1,,18,9,3,65,83,0 days 00:00:00.042451
OnsenUI/OnsenUI,1,,20,6,8,68,88,0 days 00:00:00.632957
James-Yu/LaTeX-Workshop,1,v,89,74,1,126,215,0 days 00:00:00.399459
node-schedule/node-schedule,2, v,10,3,5,36,46,0 days 00:00:00.035618
nodejs/node-gyp,2, v,37,7,18,98,135,0 days 00:00:00.112534
cesanta/mongoose,1,,43,12,22,1,44,0 days 00:00:00.202088
jwtk/jjwt,1,,11,4,6,15,26,0 days 00:00:00.040678
giampaolo/psutil,1,release-,32,8,17,52,84,0 days 00:00:00.290256
KurtBestor/Hitomi-Downloader,1,v,17,3,8,0,17,0 days 00:00:00.018440
rq/rq,2, v,24,2,15,44,68,0 days 00:00:00.108778
projectdiscovery/nuclei,2,v. v,10,2,6,43,53,0 days 00:00:00.177216
junit-team/junit4,1,r,8,1,6,5,13,0 days 00:00:00.141720
cytoscape/cytoscape.js,1,v,29,10,13,198,227,0 days 00:00:00.383938
chocolatey/choco,1,,5,1,2,38,43,0 days 00:00:00.185141
HabitRPG/habitica,2, v,351,348,2,612,963,0 days 00:00:02.617795
panjf2000/ants,1,v,9,4,4,15,24,0 days 00:00:00.039298
Nozbe/WatermelonDB,1,v,19,5,6,17,36,0 days 00:00:00.277045
uber/react-vis,2, v,22,14,3,77,99,0 days 00:00:00.076067
MonoGame/MonoGame,2, v,12,1,9,4,16,0 days 00:00:00.889009
myclabs/DeepCopy,1,,12,1,10,18,30,0 days 00:00:00.023020
borgbackup/borg,1,,22,13,5,36,58,0 days 00:00:00.472523
sebastianbergmann/php-code-coverage,1,,23,4,13,138,161,0 days 00:00:00.256870
agenda/agenda,2, v,20,5,11,65,85,0 days 00:00:00.068219
square/moshi,1,moshi-parent-,15,1,12,4,19,0 days 00:00:00.070266
dat-ecosystem-archive/dat,1,v,43,31,8,64,107,0 days 00:00:00.232741
benoitc/gunicorn,1,,31,12,14,51,82,0 days 00:00:00.282199
protobufjs/protobuf.js,2, v,23,11,6,55,78,0 days 00:00:00.079949
coil-kt/coil,1,,15,5,6,12,27,0 days 00:00:00.071810
stanfordnlp/CoreNLP,1,v,11,5,3,12,23,0 days 00:00:00.936071
MahApps/MahApps.Metro,1,,21,5,11,33,54,0 days 00:00:00.541206
vector-im/element-web,1,v,27,9,9,172,199,0 days 00:00:00.830407
jopohl/urh,1,v,17,8,7,74,91,0 days 00:00:00.166218
pre-commit/pre-commit,1,v,60,32,9,111,171,0 days 00:00:00.197228
libgit2/libgit2,1,v,29,7,16,48,77,0 days 00:00:01.321508
devhubapp/devhub,2, v,55,47,3,61,116,0 days 00:00:00.197120
NG-ZORRO/ng-zorro-antd,1,,41,30,5,65,106,0 days 00:00:00.157906
lima-vm/lima,1,v,11,6,1,16,27,0 days 00:00:00.077267
bloomrpc/bloomrpc,2, v,6,2,3,9,15,0 days 00:00:00.018780
tidwall/tile38,1,,27,6,7,59,86,0 days 00:00:00.093888
googleapis/google-api-php-client,2, v,13,2,8,32,45,0 days 00:00:00.101522
hediet/vscode-drawio,1,v,10,6,2,13,23,0 days 00:00:00.028742
OpenFeign/feign,3, release- v,72,48,10,54,126,0 days 00:00:00.104195
olivernn/lunr.js,1,v,12,1,6,46,58,0 days 00:00:00.041958
knadh/listmonk,1,v,4,1,2,0,4,0 days 00:00:00.148301
dropwizard/dropwizard,1,v,15,1,11,119,134,0 days 00:00:00.541429
ninja-build/ninja,2,release- v,14,1,10,12,26,0 days 00:00:00.387023
symfony/http-foundation,1,v,26,4,21,464,490,0 days 00:00:00.534236
google/or-tools,1,v,32,7,8,3,35,0 days 00:00:00.657076
paragonie/random_compat,2, v,7,3,1,54,61,0 days 00:00:00.040342
apache/tvm,1,v,7,1,5,1,8,0 days 00:00:00.440682
symfony/event-dispatcher,1,v,26,4,21,436,462,0 days 00:00:00.413803
resilience4j/resilience4j,3, v. v,22,5,9,15,37,0 days 00:00:00.086853
happyfish100/fastdfs,1,V,16,7,5,0,16,0 days 00:00:00.026225
rofl0r/proxychains-ng,1,v,16,3,10,1,17,0 days 00:00:00.033013
electron/electron-packager,1,v,53,30,10,42,95,0 days 00:00:00.085442
PaddlePaddle/PaddleHub,2, v,12,3,1,10,22,0 days 00:00:00.207728
Koenkk/zigbee2mqtt,1,,28,16,5,33,61,0 days 00:00:00.224962
shwenzhang/AndResGuard,1,,3,1,1,35,38,0 days 00:00:00.037454
OpenIMSDK/Open-IM-Server,1,v,3,1,1,15,18,0 days 00:00:00.209202
VulcanJS/Vulcan,2, v,22,11,6,45,67,0 days 00:00:00.399663
sockjs/sockjs-client,1,v,11,1,7,20,31,0 days 00:00:00.055751
Stuk/jszip,1,v,19,5,11,14,33,0 days 00:00:00.049872
dotnet/machinelearning,1,v,18,12,4,5,23,0 days 00:00:00.174050
szimek/signature_pad,1,v,11,3,4,19,30,0 days 00:00:00.031992
sahat/satellizer,1,,14,7,4,41,55,0 days 00:00:00.105424
ag-grid/ag-grid,2, v,87,62,5,103,190,0 days 00:00:01.563911
symfony/finder,1,v,26,4,20,440,466,0 days 00:00:00.336742
airbnb/epoxy,1,,41,26,5,22,63,0 days 00:00:00.047544
ng-bootstrap/ng-bootstrap,1,,27,12,6,49,76,0 days 00:00:00.216799
arrow-py/arrow,1,,17,3,11,37,54,0 days 00:00:00.093328
smicallef/spiderfoot,1,v,8,1,6,1,9,0 days 00:00:00.242695
adrai/flowchart.js,1,v,17,4,9,31,48,0 days 00:00:00.032396
ChrisRM/material-theme-jetbrains,2, v,83,68,2,163,246,0 days 00:00:00.270472
pypa/pip,1,,36,2,27,73,109,0 days 00:00:00.958501
Pikaday/Pikaday,1,,9,1,7,6,15,0 days 00:00:00.034743
Jguer/yay,1,v,49,33,9,26,75,0 days 00:00:00.321893
grommet/grommet,2, v,41,18,8,76,117,0 days 00:00:00.439617
doitsujin/dxvk,1,v,40,30,5,32,72,0 days 00:00:00.254221
tiangolo/typer,1,,4,1,1,15,19,0 days 00:00:00.026487
mediaelement/mediaelement,1,,32,8,12,117,149,0 days 00:00:00.276392
mjmlio/mjml,3, V v,25,8,11,50,75,0 days 00:00:00.246075
firefly-iii/firefly-iii,1,,41,19,8,201,242,0 days 00:00:01.051418
abpframework/abp,2, v,43,33,3,60,103,0 days 00:00:01.623161
huggingface/datasets,1,,26,21,1,26,52,0 days 00:00:00.190442
wtfutil/wtf,2, v,41,26,1,26,67,0 days 00:00:00.314470
videolan/vlc,1,,9,1,3,50,59,0 days 00:00:04.899730
justauth/JustAuth,3, v. v,14,9,2,25,39,0 days 00:00:00.055383
google/cadvisor,2, v,45,20,15,71,116,0 days 00:00:00.249719
zalmoxisus/redux-devtools-extension,2, v,27,23,2,43,70,0 days 00:00:00.064465
openshift/origin,1,v,14,2,10,25,39,0 days 00:00:02.049901
d2l-ai/d2l-en,1,v,8,1,4,17,25,0 days 00:00:00.353728
automerge/automerge,1,v,13,4,6,20,33,0 days 00:00:00.053031
grpc-ecosystem/grpc-gateway,1,v,28,10,10,43,71,0 days 00:00:00.127442
orhanobut/logger,2, v,13,7,3,1,14,0 days 00:00:00.018283
JustArchiNET/ArchiSteamFarm,1,,167,154,10,431,598,0 days 00:00:01.009861
Tencent/APIJSON,1,,37,21,7,51,88,0 days 00:00:00.157028
android-hacker/VirtualXposed,2, v,12,3,3,55,67,0 days 00:00:00.116815
powerline/powerline,1,,13,3,7,10,23,0 days 00:00:00.179195
keybase/client,2, v,29,21,4,65,94,0 days 00:00:02.113596
verdaccio/verdaccio,1,v,64,34,13,148,212,0 days 00:00:00.425407
liabru/matter-js,1,,10,1,7,8,18,0 days 00:00:00.050591
authelia/authelia,1,v,55,39,5,114,169,0 days 00:00:00.219863
fabric/fabric,1,,26,4,19,97,123,0 days 00:00:00.429900
microsoft/AirSim,2,v. v,3,1,1,15,18,0 days 00:00:00.188137
RaRe-Technologies/gensim,1,,23,6,11,36,59,0 days 00:00:00.246197
microsoft/recommenders,1,,9,3,3,2,11,0 days 00:00:00.484418
ahmetb/kubectx,1,v,9,2,5,11,20,0 days 00:00:00.025959
timescale/timescaledb,1,,28,8,8,33,61,0 days 00:00:00.264762
flipped-aurora/gin-vue-admin,3,V v. v,7,2,2,21,28,0 days 00:00:00.125273
getgrav/grav,1,,13,3,8,170,183,0 days 00:00:00.599277
brix/crypto-js,2, release-,4,2,1,10,14,0 days 00:00:00.021119
modood/Administrative-divisions-of-China,1,,9,1,7,7,16,0 days 00:00:00.019552
txthinking/brook,1,v,43,22,6,0,43,0 days 00:00:00.049921
qutebrowser/qutebrowser,1,v,32,4,16,49,81,0 days 00:00:01.651484
mdx-js/mdx,2, v,26,19,5,140,166,0 days 00:00:00.144203
termux/termux-app,1,v,89,73,7,0,89,0 days 00:00:00.093301
xtaci/kcptun,2, v,106,79,7,0,106,0 days 00:00:00.071686
bcicen/ctop,2, v,5,2,2,11,16,0 days 00:00:00.040228
remotion-dev/remotion,1,v,14,8,1,81,95,0 days 00:00:00.421293
python/mypy,1,v,59,38,8,7,66,0 days 00:00:00.725689
WerWolv/ImHex,1,v,19,14,2,12,31,0 days 00:00:00.074792
selectize/selectize.js,1,v,12,5,2,64,76,0 days 00:00:00.067162
gionkunz/chartist-js,1,v,11,6,4,47,58,0 days 00:00:00.055958
xtermjs/xterm.js,1,,76,52,7,35,111,0 days 00:00:00.469978
http-party/node-http-proxy,2, v,27,11,13,70,97,0 days 00:00:00.086661
redwoodjs/redwood,2, v,57,53,1,71,128,0 days 00:00:00.547615
filp/whoops,1,,18,6,8,50,68,0 days 00:00:00.164946
mockito/mockito,1,v,58,32,10,409,467,0 days 00:00:00.660119
arduino/Arduino,1,,26,5,13,46,72,0 days 00:00:00.478741
DIYgod/DPlayer,2, v,21,12,5,21,42,0 days 00:00:00.072286
you-dont-need/You-Dont-Need-Momentjs,1,v,6,3,2,5,11,0 days 00:00:00.021377
GoogleContainerTools/skaffold,1,v,80,76,1,29,109,0 days 00:00:00.656024
umijs/qiankun,1,v,14,4,7,92,106,0 days 00:00:00.069085
wechaty/wechaty,1,v,15,4,7,8,23,0 days 00:00:00.436145
CachetHQ/Cachet,1,v,7,1,2,30,37,0 days 00:00:00.216057
rwaldron/johnny-five,2, v,14,3,7,73,87,0 days 00:00:00.170502
faressoft/terminalizer,1,v,6,3,1,25,31,0 days 00:00:00.021517
Semantic-Org/Semantic-UI-React,1,v,93,78,5,211,304,0 days 00:00:00.411704
Intervention/image,1,,15,3,8,93,108,0 days 00:00:00.070931
google/gvisor,1,release-,99,94,2,0,99,0 days 00:00:00.404692
charmbracelet/bubbletea,1,v,20,14,4,27,47,0 days 00:00:00.047920
revel/revel,1,v,18,4,10,7,25,0 days 00:00:00.104575
showdownjs/showdown,2, v,14,3,7,42,56,0 days 00:00:00.054118
redux-form/redux-form,1,v,46,30,8,141,187,0 days 00:00:00.166576
onnx/onnx,1,v,13,1,10,9,22,0 days 00:00:00.134301
psf/requests-html,1,v,8,6,1,22,30,0 days 00:00:00.031785
pqina/filepond,1,,52,41,4,143,195,0 days 00:00:00.112951
moment/luxon,1,,37,21,6,69,106,0 days 00:00:00.174605
bvaughn/react-window,1,,4,2,1,16,20,0 days 00:00:00.030683
horovod/horovod,1,v,16,3,10,53,69,0 days 00:00:00.100471
scylladb/scylla,1,scylla-,33,11,10,130,163,0 days 00:00:02.491397
Foundry376/Mailspring,1,,11,1,6,43,54,0 days 00:00:00.520532
thephpleague/flysystem,1,,13,2,6,175,188,0 days 00:00:00.181463
openstf/stf,1,v,12,4,7,16,28,0 days 00:00:00.120970
uuidjs/uuid,1,v,16,6,8,21,37,0 days 00:00:00.037564
surmon-china/vue-awesome-swiper,2, v,14,5,5,36,50,0 days 00:00:00.029097
OptimalBits/bull,2, v,49,26,13,84,133,0 days 00:00:00.241144
pyecharts/pyecharts,1,v,14,4,6,29,43,0 days 00:00:00.153551
danilowoz/react-content-loader,2, v,16,6,8,27,43,0 days 00:00:00.030710
barryvdh/laravel-ide-helper,1,v,25,8,15,61,86,0 days 00:00:00.189553
liriliri/eruda,1,v,15,6,5,40,55,0 days 00:00:00.051999
MaterialDesignInXAML/MaterialDesignInXamlToolkit,2, v,21,5,12,12,33,0 days 00:00:00.160854
josdejong/mathjs,1,v,109,83,4,118,227,0 days 00:00:00.316047
Budibase/budibase,1,v,10,5,3,479,489,0 days 00:00:02.076097
tensorflow/tensor2tensor,3, v. v,15,5,4,61,76,0 days 00:00:00.222821
gaearon/react-hot-loader,2, v,25,13,6,107,132,0 days 00:00:00.137896
rt2zz/redux-persist,1,v,36,27,6,76,112,0 days 00:00:00.067927
wkhtmltopdf/wkhtmltopdf,1,,8,4,3,31,39,0 days 00:00:00.170500
aquasecurity/trivy,1,v,28,19,2,59,87,0 days 00:00:00.079818
visionmedia/supertest,2, v,29,8,13,29,58,0 days 00:00:00.044350
oliver-moran/jimp,2, v,15,8,4,71,86,0 days 00:00:00.070590
systemjs/systemjs,2, v,40,18,10,187,227,0 days 00:00:00.191290
casbin/casbin,1,v,68,52,5,118,186,0 days 00:00:00.116695
lra/mackup,1,,8,4,3,53,61,0 days 00:00:00.119320
11ty/eleventy,1,v,13,2,7,41,54,0 days 00:00:00.294321
tabler/tabler-icons,1,v,69,65,2,15,84,0 days 00:00:00.075801
foambubble/foam,1,v,17,10,3,44,61,0 days 00:00:00.077228
arut/nginx-rtmp-module,1,v,12,5,3,100,112,0 days 00:00:00.077144
Delgan/loguru,1,,6,1,4,12,18,0 days 00:00:00.039783
carloscuesta/gitmoji,1,v,13,5,2,5,18,0 days 00:00:00.046751
webpack-contrib/webpack-bundle-analyzer,1,v,32,19,8,34,66,0 days 00:00:00.051470
freebsd/freebsd-src,1,release/,62,3,58,16,78,0 days 00:00:20.076261
react-dates/react-dates,1,v,78,74,1,81,159,0 days 00:00:00.139522
http-party/http-server,2, v,15,2,10,30,45,0 days 00:00:00.048616
roots/sage,2, v,27,10,12,35,62,0 days 00:00:00.148531
Miserlou/Zappa,2, v,50,42,3,71,121,0 days 00:00:00.206626
jaredreich/pell,1,v,6,4,1,6,12,0 days 00:00:00.014766
mlflow/mlflow,2, v,35,21,1,20,55,0 days 00:00:00.374486
aurelia/framework,1,,23,16,5,32,55,0 days 00:00:00.152205
Tamsiree/RxTool,2, v,15,7,4,177,192,0 days 00:00:00.103529
NodeBB/NodeBB,1,v,30,2,17,93,123,0 days 00:00:01.294487
Tonejs/Tone.js,2, r,12,1,8,4,16,0 days 00:00:00.213842
FaridSafi/react-native-gifted-chat,2, v,16,6,7,46,62,0 days 00:00:00.077976
ramsey/uuid,1,,26,6,14,37,63,0 days 00:00:00.083609
keycloak/keycloak,1,,16,3,7,21,37,0 days 00:00:01.086966
ben-manes/caffeine,2, v,16,4,7,45,61,0 days 00:00:00.092185
emirpasic/gods,1,v,19,14,3,6,25,0 days 00:00:00.039309
karma-runner/karma,2, v,35,14,12,198,233,0 days 00:00:00.327899
segmentio/evergreen,1,v,51,39,2,84,135,0 days 00:00:00.191563
flairNLP/flair,1,v,11,1,6,12,23,0 days 00:00:00.245875
AdguardTeam/AdGuardHome,1,v,19,6,4,31,50,0 days 00:00:00.200482
NetEase/pomelo,2, v,9,1,4,84,93,0 days 00:00:00.081157
PuerkitoBio/goquery,1,v,12,1,8,10,22,0 days 00:00:00.027578
ranger/ranger,1,v,10,1,8,31,41,0 days 00:00:00.235114
LuckSiege/PictureSelector,2,v. v,12,6,5,91,103,0 days 00:00:00.189974
QL-Win/QuickLook,2, v,4,1,1,38,42,0 days 00:00:00.053824
go-chi/chi,1,v,12,1,5,27,39,0 days 00:00:00.048537
apexcharts/apexcharts.js,2, v,32,15,3,54,86,0 days 00:00:00.146712
mikepenz/MaterialDrawer,1,v,35,19,8,166,201,0 days 00:00:00.237577
OpenAPITools/openapi-generator,2, v,16,2,11,38,54,0 days 00:00:01.157528
koekeishiya/yabai,1,v,12,5,1,34,46,0 days 00:00:00.066527
rjsf-team/react-jsonschema-form,1,v,71,56,6,52,123,0 days 00:00:00.105894
microsoft/nni,1,v,27,9,2,16,43,0 days 00:00:00.326961
mifi/lossless-cut,1,v,70,52,9,67,137,0 days 00:00:00.154785
d2-projects/d2-admin,2, v,25,17,4,62,87,0 days 00:00:00.181777
thingsboard/thingsboard,1,v,15,2,7,33,48,0 days 00:00:00.631549
netchx/netch,2, v,6,1,3,47,53,0 days 00:00:00.115272
meolu/walle-web,1,v,13,8,1,6,19,0 days 00:00:00.068385
spicetify/spicetify-cli,2,v. v,23,14,5,52,75,0 days 00:00:00.166100
nock/nock,2, v,125,108,13,181,306,0 days 00:00:00.279004
hotwired/stimulus,1,v,12,5,4,14,26,0 days 00:00:00.064501
sindresorhus/got,1,v,70,49,11,71,141,0 days 00:00:00.223710
nexe/nexe,1,v,5,2,1,14,19,0 days 00:00:00.045620
bettercap/bettercap,1,v,33,23,5,10,43,0 days 00:00:00.138934
apache/druid,1,druid-,18,1,13,366,384,0 days 00:00:00.943044
graphile/postgraphile,1,v,35,20,7,60,95,0 days 00:00:00.144977
java-decompiler/jd-gui,1,v,7,5,1,11,18,0 days 00:00:00.023463
rizinorg/cutter,1,v,14,6,5,16,30,0 days 00:00:00.232571
cloudwu/skynet,1,v,15,7,6,18,33,0 days 00:00:00.118880
slimphp/Slim,1,,40,11,21,55,95,0 days 00:00:00.277574
pagehelper/Mybatis-PageHelper,1,v,18,9,6,42,60,0 days 00:00:00.049269
conventional-changelog/commitlint,1,v,47,28,10,89,136,0 days 00:00:00.167523
wenzhixin/bootstrap-table,1,,18,3,9,39,57,0 days 00:00:00.327544
antvis/G2,2, v,13,2,8,144,157,0 days 00:00:00.267543
searx/searx,2, v,14,1,12,3,17,0 days 00:00:00.307024
single-spa/single-spa,2, v,29,15,10,85,114,0 days 00:00:00.069468
kubernetes/dashboard,1,v,15,1,10,20,35,0 days 00:00:00.247783
PHPOffice/PhpSpreadsheet,1,,24,6,7,10,34,0 days 00:00:00.299240
ccampbell/mousetrap,1,,7,1,5,21,28,0 days 00:00:00.030526
micro/micro,2, v,62,46,2,37,99,0 days 00:00:00.244082
video-dev/hls.js,1,v,16,2,9,185,201,0 days 00:00:00.624385
nightwatchjs/nightwatch,1,v,16,1,9,207,223,0 days 00:00:00.229060
argoproj/argo-workflows,2, v,23,7,9,102,125,0 days 00:00:00.320410
google/brotli,1,v,6,1,4,10,16,0 days 00:00:00.176841
davisking/dlib,1,v,55,14,13,0,55,0 days 00:00:00.408718
mail-in-a-box/mailinabox,1,v,45,16,11,0,45,0 days 00:00:00.138483
RPCS3/rpcs3,1,v,5,1,3,21,26,0 days 00:00:00.772109
ajv-validator/ajv,2, v,71,54,6,89,160,0 days 00:00:00.184230
SFTtech/openage,1,v,5,2,2,4,9,0 days 00:00:00.181845
allenai/allennlp,2, v,24,7,5,23,47,0 days 00:00:00.280495
jquery/jquery-ui,1,,8,1,6,38,46,0 days 00:00:00.501697
FriendsOfPHP/PHP-CS-Fixer,1,v,48,26,14,148,196,0 days 00:00:00.676692
keeweb/keeweb,1,v,25,10,9,103,128,0 days 00:00:00.263752
jonas/tig,1,tig-,27,6,19,22,49,0 days 00:00:00.155180
tomnomnom/gron,2, v,7,2,2,27,34,0 days 00:00:00.023040
baidu/amis,1,,9,5,2,37,46,0 days 00:00:00.481587
nats-io/nats-server,1,v,17,2,12,49,66,0 days 00:00:00.361046
WickyNilliams/headroom.js,1,v,9,1,5,8,17,0 days 00:00:00.025135
stylus/stylus,1,,53,34,11,115,168,0 days 00:00:00.270620
containrrr/watchtower,1,v,8,1,5,24,32,0 days 00:00:00.051742
doctrine/inflector,2, v,6,1,4,10,16,0 days 00:00:00.031737
dgraph-io/badger,1,v,14,6,7,20,34,0 days 00:00:00.109084
mobile-shell/mosh,1,mosh-,4,2,1,10,14,0 days 00:00:00.073532
containerd/containerd,2, v,9,1,7,76,85,0 days 00:00:01.059057
ent/ent,1,v,10,3,4,21,31,0 days 00:00:00.236215
Kotlin/kotlinx.coroutines,1,,24,11,6,38,62,0 days 00:00:00.160188
SpartnerNL/Laravel-Excel,2, v,11,3,6,143,154,0 days 00:00:00.232259
GoogleChrome/workbox,1,v,24,10,7,38,62,0 days 00:00:00.110464
javve/list.js,2, v,11,4,5,10,21,0 days 00:00:00.050053
lokesh/color-thief,2, v,5,1,2,6,11,0 days 00:00:00.019234
wbkd/react-flow,2, v,56,52,2,118,174,0 days 00:00:00.205548
beetbox/beets,1,v,6,1,4,30,36,0 days 00:00:00.687151
browserslist/browserslist,1,,49,24,11,119,168,0 days 00:00:00.122782
summernote/summernote,1,v,8,2,2,52,60,0 days 00:00:00.287273
fengyuanchen/cropperjs,1,v,14,6,4,40,54,0 days 00:00:00.049855
Rapptz/discord.py,1,v,24,15,6,41,65,0 days 00:00:00.176781
casesandberg/react-color,2, v,14,8,5,23,37,0 days 00:00:00.047915
jxnblk/mdx-deck,1,v,21,16,2,91,112,0 days 00:00:00.114245
apache/pulsar,1,v,14,1,10,37,51,0 days 00:00:00.845966
lingochamp/FileDownloader,1,v,11,4,4,56,67,0 days 00:00:00.057390
networkx/networkx,1,networkx-,37,7,25,10,47,0 days 00:00:00.547451
downshift-js/downshift,1,v,49,38,4,179,228,0 days 00:00:00.125074
App-vNext/Polly,2, v,7,3,2,4,11,0 days 00:00:00.055531
polybar/polybar,1,,20,12,7,84,104,0 days 00:00:00.137259
tymondesigns/jwt-auth,1,,6,3,2,29,35,0 days 00:00:00.094219
mholt/PapaParse,1,,19,5,7,55,74,0 days 00:00:00.058686
ionic-team/stencil,1,v,53,40,2,189,242,0 days 00:00:00.401699
go-playground/validator,1,v,94,69,10,59,153,0 days 00:00:00.107234
star7th/showdoc,2, v,18,6,6,124,142,0 days 00:00:00.138888
abseil/abseil-cpp,1,,17,5,9,0,17,0 days 00:00:00.066985
spatie/laravel-permission,1,,87,61,11,71,158,0 days 00:00:00.226575
restify/node-restify,2, v,44,27,13,96,140,0 days 00:00:00.171228
PatrickJS/angular-starter,2, v,6,4,1,5,11,0 days 00:00:00.085871
swaywm/sway,1,,22,7,8,7,29,0 days 00:00:00.563389
rqlite/rqlite,1,v,56,37,8,39,95,0 days 00:00:00.274790
akiran/react-slick,2, v,13,3,8,27,40,0 days 00:00:00.071485
VSCodeVim/Vim,2, v,38,19,6,187,225,0 days 00:00:00.502803
GoogleContainerTools/kaniko,1,v,33,19,4,4,37,0 days 00:00:00.201091
peers/peerjs,2, v,6,1,4,30,36,0 days 00:00:00.062099
thanos-io/thanos,1,v,26,7,2,17,43,0 days 00:00:00.205447
aws/aws-cli,1,,46,24,17,1642,1688,0 days 00:00:04.215775
dangrossman/daterangepicker,2, v,5,1,3,58,63,0 days 00:00:00.061163
dbcli/mycli,1,v,26,8,10,20,46,0 days 00:00:00.103185
dbcli/pgcli,2, v,39,16,10,47,86,0 days 00:00:00.289461
dotnet/AspNetCore.Docs,1,,40,33,1,0,40,0 days 00:00:00.764542
luin/ioredis,2, v,54,33,11,132,186,0 days 00:00:00.155911
TypeStrong/ts-node,1,v,52,29,9,83,135,0 days 00:00:00.090675
tidwall/gjson,1,v,15,5,6,42,57,0 days 00:00:00.032809
imakewebthings/waypoints,2, v,6,1,4,17,23,0 days 00:00:00.023201
golangci/golangci-lint,1,v,47,31,1,63,110,0 days 00:00:00.145297
jina-ai/clip-as-service,1,v,15,11,2,92,107,0 days 00:00:00.120707
redis/redis-py,2, v,15,2,9,49,64,0 days 00:00:00.124608
avwo/whistle,1,v,31,12,10,342,373,0 days 00:00:00.878928
styleguidist/react-styleguidist,2, v,47,30,7,215,262,0 days 00:00:00.235705
okonet/lint-staged,2, v,44,23,7,145,189,0 days 00:00:00.127708
reactstrap/reactstrap,2, v,61,45,7,54,115,0 days 00:00:00.103597
shipshapecode/shepherd,1,v,46,28,9,73,119,0 days 00:00:00.156731
PrismJS/prism,2, v,29,8,11,11,40,0 days 00:00:00.228856
netbox-community/netbox,2, v,24,6,13,173,197,0 days 00:00:00.605967
snabbdom/snabbdom,1,v,14,3,6,33,47,0 days 00:00:00.172580
lucidrains/vit-pytorch,1,,32,27,1,105,137,0 days 00:00:00.054162
debug-js/debug,1,,22,7,8,47,69,0 days 00:00:00.052094
pagekit/vue-resource,1,,12,5,4,41,53,0 days 00:00:00.040058
AppIntro/AppIntro,2, v,10,1,8,8,18,0 days 00:00:00.063114
jantimon/html-webpack-plugin,2, v,47,34,10,36,83,0 days 00:00:00.069668
plouc/nivo,1,v,67,56,7,45,112,0 days 00:00:00.125037
mailhog/MailHog,2, v,10,7,2,16,26,0 days 00:00:00.025738
vercel/micro,2, v,21,13,5,34,55,0 days 00:00:00.048136
cyclejs/cyclejs,1,v,32,27,1,50,82,0 days 00:00:00.057319
milvus-io/milvus,1,v,9,3,3,15,24,0 days 00:00:00.965141
ant-design/ant-design-mobile,2, v,28,19,4,107,135,0 days 00:00:00.502801
SpacehuhnTech/esp8266_deauther,3, v. v,10,5,3,3,13,0 days 00:00:00.048552
aspnetboilerplate/aspnetboilerplate,3, v. v,91,57,7,125,216,0 days 00:00:00.639640
serbanghita/Mobile-Detect,1,,6,2,3,64,70,0 days 00:00:00.061763
clauderic/react-sortable-hoc,1,v,20,14,3,52,72,0 days 00:00:00.045411
react-static/react-static,1,v,28,20,5,162,190,0 days 00:00:00.198512
git-lfs/git-lfs,2, v,29,3,19,60,89,0 days 00:00:00.680467
haltu/muuri,1,,9,1,5,14,23,0 days 00:00:00.035971
samuelcolvin/pydantic,2,V v,42,30,6,37,79,0 days 00:00:00.095791
apple/darwin-xnu,1,xnu-,19,16,2,104,123,0 days 00:00:00.048756
spencermountain/compromise,2, v,70,45,12,148,218,0 days 00:00:00.458976
atomiks/tippyjs,2, v,27,20,5,65,92,0 days 00:00:00.095596
jacomyal/sigma.js,1,v,7,1,3,8,15,0 days 00:00:00.091342
nhn/tui.calendar,1,v,21,13,3,42,63,0 days 00:00:00.112286
qrohlf/trianglify,1,v,12,1,8,8,20,0 days 00:00:00.023736
typesense/typesense,2, v,16,5,5,8,24,0 days 00:00:00.086832
h2o/h2o,1,v,12,3,2,32,44,0 days 00:00:00.239515
tinygo-org/tinygo,1,v,23,9,3,4,27,0 days 00:00:00.263177
FredrikNoren/ungit,2, v,16,9,6,126,142,0 days 00:00:00.230601
spotify/annoy,3, v. v,9,1,4,15,24,0 days 00:00:00.169418
Ciphey/Ciphey,2, v,18,15,1,8,26,0 days 00:00:00.122141
zricethezav/gitleaks,1,v,60,47,5,62,122,0 days 00:00:00.086894
kubernetes-sigs/kind,2, v,14,2,6,10,24,0 days 00:00:00.206132
bitwarden/server,2, v,49,31,4,58,107,0 days 00:00:00.339941
NaturalNode/natural,2, v,6,2,3,44,50,0 days 00:00:00.092049
w7corp/easywechat,1,,47,25,16,241,288,0 days 00:00:00.264602
coryhouse/react-slingshot,2, v,8,3,2,7,15,0 days 00:00:00.040713
HandBrake/HandBrake,1,,8,1,6,35,43,0 days 00:00:00.786983
immerjs/immer,2, v,35,23,5,94,129,0 days 00:00:00.076437
socketio/socket.io-client,1,,28,2,16,97,125,0 days 00:00:00.153259
squidfunk/mkdocs-material,1,,52,34,6,192,244,0 days 00:00:00.404284
visgl/deck.gl,2, v,32,8,11,250,282,0 days 00:00:00.517769
jesseduffield/lazydocker,1,v,18,11,5,27,45,0 days 00:00:00.046382
frappe/erpnext,2, v,153,136,7,763,916,0 days 00:00:03.764910
tj/commander.js,2, v,50,19,18,38,88,0 days 00:00:00.111055
dask/dask,1,,97,59,9,141,238,0 days 00:00:00.760655
doczjs/docz,1,v,19,13,5,66,85,0 days 00:00:00.104553
labstack/echo,2, v,20,3,10,75,95,0 days 00:00:00.108799
frida/frida,1,,54,30,10,579,633,0 days 00:00:00.670078
alibaba/nacos,2, v,16,9,6,15,31,0 days 00:00:00.224312
vega/vega,1,v,45,20,15,73,118,0 days 00:00:00.429464
halo-dev/halo,1,v,10,2,5,42,52,0 days 00:00:00.140562
dmlc/xgboost,2, v,21,1,14,12,33,0 days 00:00:00.335658
vuejs/devtools,1,v,10,4,4,36,46,0 days 00:00:00.116155
dromara/hutool,1,,11,1,6,102,113,0 days 00:00:00.396588
pure-css/pure,1,v,9,1,7,14,23,0 days 00:00:00.048864
ansible/awx,1,,36,18,3,20,56,0 days 00:00:03.753033
lovell/sharp,1,v,30,4,16,88,118,0 days 00:00:00.110586
react-native-elements/react-native-elements,2, v,30,18,5,52,82,0 days 00:00:00.241110
reduxjs/react-redux,1,v,26,17,6,59,85,0 days 00:00:00.086222
t4t5/sweetalert,2, v,9,2,3,23,32,0 days 00:00:00.033145
files-community/Files,1,v,23,18,4,38,61,0 days 00:00:00.222972
seata/seata,3, V v,15,6,3,18,33,0 days 00:00:00.181729
python-pillow/Pillow,1,,39,1,35,35,74,0 days 00:00:00.957043
ovity/octotree,1,v,5,1,3,26,31,0 days 00:00:00.044418
dimsemenov/PhotoSwipe,1,v,5,1,2,43,48,0 days 00:00:00.042654
redux-saga/redux-saga,2, v,18,9,5,40,58,0 days 00:00:00.216597
sampotts/plyr,1,v,16,6,7,195,211,0 days 00:00:00.194705
inconshreveable/ngrok,1,,20,18,1,1,21,0 days 00:00:00.026676
ramda/ramda,2, v,28,13,9,26,54,0 days 00:00:00.182681
facebook/draft-js,2, v,11,7,3,16,27,0 days 00:00:00.074406
github/hub,1,v,29,14,10,59,88,0 days 00:00:00.204721
feathericons/feather,1,v,39,28,3,12,51,0 days 00:00:00.049634
fabricjs/fabric.js,2, v,34,10,14,69,103,0 days 00:00:00.298238
angular/components,1,,31,13,7,128,159,0 days 00:00:00.842767
swagger-api/swagger-ui,3, v/ v,69,51,10,189,258,0 days 00:00:00.384141
guzzle/guzzle,2, v,37,16,14,96,133,0 days 00:00:00.393505
ehang-io/nps,3,V v. v,19,14,1,44,63,0 days 00:00:00.061452
bevacqua/dragula,2, v,18,14,1,49,67,0 days 00:00:00.052801
usablica/intro.js,2, v,29,5,13,12,41,0 days 00:00:00.082397
appwrite/appwrite,1,,13,1,3,30,43,0 days 00:00:00.732469
vercel/pkg,1,,15,7,5,42,57,0 days 00:00:00.071352
bilibili/flv.js,1,v,7,1,4,8,15,0 days 00:00:00.032907
conwnet/github1s,1,v,7,4,1,19,26,0 days 00:00:00.029020
rook/rook,1,v,19,1,16,103,122,0 days 00:00:00.914664
paularmstrong/normalizr,2, v,16,7,5,18,34,0 days 00:00:00.040985
openfaas/faas,2, v,18,9,7,110,128,0 days 00:00:00.241603
httpie/httpie,1,,19,2,12,28,47,0 days 00:00:00.324111
chenglou/react-motion,1,v,5,1,2,19,24,0 days 00:00:00.045844
qishibo/AnotherRedisDesktopManager,2, v,6,1,3,34,40,0 days 00:00:00.043248
jlmakes/scrollreveal,1,v,10,3,5,36,46,0 days 00:00:00.059352
mochajs/mocha,2, v,65,28,15,110,175,0 days 00:00:00.369766
sirupsen/logrus,2, v,20,6,8,35,55,0 days 00:00:00.082338
slidevjs/slidev,1,v,31,27,1,143,174,0 days 00:00:00.113888
helm/helm,2, v,32,8,12,68,100,0 days 00:00:00.640211
yeasy/docker_practice,1,v,13,1,9,0,13,0 days 00:00:00.069913
michalsnik/aos,2, v,11,4,4,24,35,0 days 00:00:00.023916
docsifyjs/docsify,1,v,44,35,6,147,191,0 days 00:00:00.248628
localForage/localForage,1,,19,10,7,43,62,0 days 00:00:00.078787
react-bootstrap/react-bootstrap,2, v,44,24,10,108,152,0 days 00:00:00.288865
microsoft/cascadia-code,1,v,18,8,3,0,18,0 days 00:00:00.025358
vuejs/vuepress,1,v,24,14,5,50,74,0 days 00:00:00.121957
uglide/RedisDesktopManager,1,,33,19,4,38,71,0 days 00:00:00.139519
StevenBlack/hosts,2, v,24,10,7,405,429,0 days 00:00:00.410027
homebridge/homebridge,2, v,6,1,4,51,57,0 days 00:00:00.092499
postcss/autoprefixer,1,,53,27,14,133,186,0 days 00:00:00.193534
DrKLO/Telegram,1,release-,47,40,1,37,84,0 days 00:00:00.050583
nicolargo/glances,1,v,22,2,15,70,92,0 days 00:00:00.348752
petkaantonov/bluebird,1,v,24,11,7,115,139,0 days 00:00:00.158277
python-poetry/poetry,1,,14,10,3,63,77,0 days 00:00:00.134892
avajs/ava,1,v,54,37,4,23,77,0 days 00:00:00.132970
necolas/react-native-web,1,,17,6,7,242,259,0 days 00:00:00.201071
rollup/rollup,1,v,169,157,3,411,580,0 days 00:00:00.771936
electron-react-boilerplate/electron-react-boilerplate,1,v,32,13,10,31,63,0 days 00:00:00.086344
Seldaek/monolog,1,,36,9,21,26,62,0 days 00:00:00.188358
open-mmlab/mmdetection,1,v,29,26,1,6,35,0 days 00:00:00.241625
validatorjs/validator.js,2, v,107,79,8,43,150,0 days 00:00:00.172310
eslint/eslint,1,v,164,153,3,103,267,0 days 00:00:00.620700
js-cookie/js-cookie,1,v,10,1,7,13,23,0 days 00:00:00.053124
mozilla/DeepSpeech,1,v,9,1,6,13,22,0 days 00:00:00.216621
schollz/croc,1,v,31,15,6,106,137,0 days 00:00:00.151717
zyedidia/micro,1,v,6,1,3,22,28,0 days 00:00:00.160962
ShareX/ShareX,1,v,50,24,11,22,72,0 days 00:00:00.439944
spf13/viper,1,v,13,2,8,13,26,0 days 00:00:00.186142
benweet/stackedit,1,v,23,17,4,104,127,0 days 00:00:00.108371
parse-community/parse-server,1,,34,15,12,111,145,0 days 00:00:00.358302
felixrieseberg/windows95,1,v,11,4,5,3,14,0 days 00:00:00.021741
signalapp/Signal-Android,3, v. v,180,163,8,860,1040,0 days 00:00:01.914125
alibaba/Sentinel,2, v,8,2,3,16,24,0 days 00:00:00.063545
afollestad/material-dialogs,3, v. v,20,12,3,98,118,0 days 00:00:00.127709
apache/skywalking,1,v,20,4,6,11,31,0 days 00:00:00.484634
segmentio/nightmare,1,,21,9,4,67,88,0 days 00:00:00.093118
codex-team/editor.js,2, v,11,3,5,16,27,0 days 00:00:00.066349
eligrey/FileSaver.js,2, v,3,1,1,12,15,0 days 00:00:00.025608
streamlit/streamlit,2, v,83,79,1,46,129,0 days 00:00:00.542245
youzan/vant,1,v,33,13,6,377,410,0 days 00:00:00.756760
TeamNewPipe/NewPipe,2, v,17,3,10,100,117,0 days 00:00:00.566996
winstonjs/winston,2, v,24,6,13,62,86,0 days 00:00:00.103798
marmelab/react-admin,1,v,46,32,4,168,214,0 days 00:00:00.932840
emberjs/ember.js,1,v,68,20,4,184,252,0 days 00:00:01.958168
locustio/locust,2, v,27,9,10,56,83,0 days 00:00:00.298148
vuejs/vue-router,1,v,19,9,5,59,78,0 days 00:00:00.115163
zhongyang219/TrafficMonitor,1,V,18,8,6,4,22,0 days 00:00:00.046624
celery/celery,2, v,22,3,17,143,165,0 days 00:00:00.884339
Popmotion/popmotion,2, v,21,14,5,131,152,0 days 00:00:00.210099
taichi-dev/taichi,2, v,7,1,3,96,103,0 days 00:00:00.518671
osquery/osquery,2, v,39,13,12,80,119,0 days 00:00:00.432019
python-telegram-bot/python-telegram-bot,3, V v,49,27,8,39,88,0 days 00:00:00.155178
reduxjs/reselect,1,v,11,6,4,14,25,0 days 00:00:00.050334
chalk/chalk,1,v,16,3,8,16,32,0 days 00:00:00.033807
vadimdemedes/ink,1,v,16,6,6,23,39,0 days 00:00:00.042918
google/ExoPlayer,1,r,20,1,14,84,104,0 days 00:00:00.854893
graphql/graphql-js,2, v,34,12,13,88,122,0 days 00:00:00.329088
solidjs/solid,1,v,27,16,2,137,164,0 days 00:00:00.128730
pbatard/rufus,1,v,42,11,15,28,70,0 days 00:00:00.121867
mingrammer/diagrams,1,v,20,14,3,16,36,0 days 00:00:00.040195
sideway/joi,2, v,92,63,11,135,227,0 days 00:00:00.301211
recharts/recharts,1,v,26,13,6,93,119,0 days 00:00:00.159784
urfave/cli,1,v,33,20,8,34,67,0 days 00:00:00.234401
Baseflow/PhotoView,2, v,8,2,4,12,20,0 days 00:00:00.036214
OpenZeppelin/openzeppelin-contracts,1,v,30,10,5,22,52,0 days 00:00:00.180156
wenyan-lang/wenyan,1,v,3,1,1,12,15,0 days 00:00:00.051491
vnpy/vnpy,2, v,22,6,7,28,50,0 days 00:00:00.320597
PyTorchLightning/pytorch-lightning,1,,16,3,4,98,114,0 days 00:00:00.477817
jumpserver/jumpserver,2, v,31,24,5,103,134,0 days 00:00:00.544683
iawia002/lux,2, v,15,7,5,59,74,0 days 00:00:00.155200
websockets/ws,2, v,40,13,11,114,154,0 days 00:00:00.268421
lensapp/lens,1,v,19,6,6,56,75,0 days 00:00:00.224090
dapr/dapr,1,v,19,9,1,23,42,0 days 00:00:00.295709
eggjs/egg,1,,70,51,10,43,113,0 days 00:00:00.095169
go-kratos/kratos,1,v,11,2,7,21,32,0 days 00:00:00.090632
valyala/fasthttp,1,v,43,27,4,3,46,0 days 00:00:00.092341
telegramdesktop/tdesktop,1,v,34,11,15,542,576,0 days 00:00:01.116314
philc/vimium,2, v,11,2,5,17,28,0 days 00:00:00.258983
quii/learn-go-with-tests,2, v,22,13,5,27,49,0 days 00:00:00.072060
magenta/magenta,2, v,7,1,3,42,49,0 days 00:00:00.081395
svg/svgo,2, v,20,8,11,66,86,0 days 00:00:00.174543
typicode/lowdb,1,v,21,8,9,36,57,0 days 00:00:00.044318
appsmithorg/appsmith,3, v. v,13,7,3,129,142,0 days 00:00:00.642197
dgraph-io/dgraph,1,v,13,1,9,60,73,0 days 00:00:00.537912
NickeManarin/ScreenToGif,1,,37,16,7,43,80,0 days 00:00:00.086430
react-dnd/react-dnd,2, v,45,25,10,100,145,0 days 00:00:00.244425
flameshot-org/flameshot,1,v,11,3,6,30,41,0 days 00:00:00.124006
SortableJS/Vue.Draggable,2,v. v,24,13,6,25,49,0 days 00:00:00.049037
Redocly/redoc,1,v,39,33,1,56,95,0 days 00:00:00.110382
facebook/flux,1,,4,1,2,9,13,0 days 00:00:00.036117
aseprite/aseprite,2, v,9,1,7,84,93,0 days 00:00:00.454415
nosir/cleave.js,1,v,9,2,5,57,66,0 days 00:00:00.128287
TanStack/table,1,v,36,24,6,86,122,0 days 00:00:00.127662
pubkey/rxdb,1,,58,43,2,55,113,0 days 00:00:00.497317
jsdom/jsdom,2, v,98,67,9,144,242,0 days 00:00:00.316586
mysqljs/mysql,1,v,28,10,9,26,54,0 days 00:00:00.104308
jquense/yup,1,v,27,12,8,67,94,0 days 00:00:00.063077
alibaba/ice,3, V v,23,17,1,57,80,0 days 00:00:00.120658
pmndrs/zustand,1,v,13,4,6,56,69,0 days 00:00:00.062733
mybatis/mybatis-3,1,mybatis-,5,1,3,32,37,0 days 00:00:00.257074
linlinjava/litemall,1,v,19,10,2,3,22,0 days 00:00:00.070936
Molunerfinn/PicGo,1,v,11,4,5,21,32,0 days 00:00:00.035990
ai/nanoid,1,,12,5,4,73,85,0 days 00:00:00.065714
facebookresearch/fairseq,1,v,8,1,4,6,14,0 days 00:00:00.105385
wekan/wekan,2, v,610,607,2,27,637,0 days 00:00:01.068934
oldj/SwitchHosts,1,v,9,2,5,36,45,0 days 00:00:00.130433
arendst/Tasmota,1,v,35,14,7,58,93,0 days 00:00:00.979465
bazelbuild/bazel,1,,47,30,8,56,103,0 days 00:00:01.901725
cookiecutter/cookiecutter,1,,14,3,7,15,29,0 days 00:00:00.154858
nostra13/Android-Universal-Image-Loader,1,v,3,1,1,12,15,0 days 00:00:00.053708
freqtrade/freqtrade,1,,44,35,3,14,58,0 days 00:00:00.997619
badges/shields,1,,8,3,4,3,11,0 days 00:00:00.403868
defunkt/jquery-pjax,2, v,12,6,3,15,27,0 days 00:00:00.038891
facebook/fresco,1,v,35,14,13,12,47,0 days 00:00:00.258459
brettwooldridge/HikariCP,1,HikariCP-,17,2,10,82,99,0 days 00:00:00.152750
remix-run/remix,1,v,27,22,1,61,88,0 days 00:00:00.305240
jhipster/generator-jhipster,1,v,110,89,5,114,224,0 days 00:00:02.706697
less/less.js,1,v,26,8,13,42,68,0 days 00:00:00.272828
gorilla/mux,1,v,8,1,5,6,14,0 days 00:00:00.025119
fingerprintjs/fingerprintjs,2, v,23,11,7,50,73,0 days 00:00:00.067673
restic/restic,1,v,13,2,7,18,31,0 days 00:00:00.446035
handlebars-lang/handlebars.js,2, v,14,5,6,56,70,0 days 00:00:00.134091
eclipse-theia/theia,2, v,43,36,2,33,76,0 days 00:00:00.567025
monicahq/monica,1,v,47,32,4,39,86,0 days 00:00:00.224400
zloirock/core-js,2, v,41,26,7,156,197,0 days 00:00:00.271392
dropzone/dropzone,1,v,32,15,12,83,115,0 days 00:00:00.103912
testing-library/react-testing-library,1,v,57,43,2,110,167,0 days 00:00:00.083504
twitter/typeahead.js,1,v,4,1,2,11,15,0 days 00:00:00.036080
GoogleChromeLabs/squoosh,1,v,10,4,5,17,27,0 days 00:00:00.066430
grafana/k6,1,v,36,12,6,36,72,0 days 00:00:00.293866
plotly/dash,1,v,42,29,3,33,75,0 days 00:00:00.399602
derailed/k9s,2, v,25,17,2,155,180,0 days 00:00:00.205899
jamiebuilds/react-loadable,1,v,13,8,3,16,29,0 days 00:00:00.022109
responsively-org/responsively-app,1,v,18,14,3,10,28,0 days 00:00:00.211365
nfl/react-helmet,1,,15,5,4,18,33,0 days 00:00:00.031110
Tencent/tinker,1,v,7,3,2,46,53,0 days 00:00:00.063091
joewalnes/websocketd,1,v,11,3,2,15,26,0 days 00:00:00.029293
handsontable/handsontable,2, v,62,27,14,117,179,0 days 00:00:00.567604
framework7io/framework7,1,v,43,19,11,172,215,0 days 00:00:00.601006
aFarkas/lazysizes,1,,21,10,7,45,66,0 days 00:00:00.061745
hubotio/hubot,1,v,26,7,12,68,94,0 days 00:00:00.162078
sanic-org/sanic,2, v,21,2,13,49,70,0 days 00:00:00.166341
gchq/CyberChef,1,v,119,106,4,273,392,0 days 00:00:00.447786
ionic-team/ionicons,2, v,21,9,10,51,72,0 days 00:00:00.054553
nondanee/UnblockNeteaseMusic,1,v,23,17,1,34,57,0 days 00:00:00.037422
matryer/xbar,2, v,9,5,2,5,14,0 days 00:00:00.183609
zadam/trilium,2, v,14,11,1,134,148,0 days 00:00:00.378801
mpv-player/mpv,1,v,34,10,8,46,80,0 days 00:00:03.098125
nginx/nginx,1,release-,32,10,20,516,548,0 days 00:00:00.715163
visionmedia/superagent,2, v,50,23,13,84,134,0 days 00:00:00.139839
trojan-gfw/trojan,1,v,24,15,4,19,43,0 days 00:00:00.038797
grafana/loki,1,v,17,4,4,8,25,0 days 00:00:00.221603
notepad-plus-plus/notepad-plus-plus,2, v,42,8,11,159,201,0 days 00:00:00.349784
uber-go/zap,1,v,22,11,8,6,28,0 days 00:00:00.042677
EastWorld/wechat-app-mall,2, v,14,6,4,8,22,0 days 00:00:00.038460
filebrowser/filebrowser,1,v,34,23,6,62,96,0 days 00:00:00.143656
youzan/vant-weapp,1,v,16,7,4,91,107,0 days 00:00:00.254383
jaegertracing/jaeger,1,v,40,24,3,13,53,0 days 00:00:00.118179
knex/knex,2, v,25,2,17,146,171,0 days 00:00:00.207630
bokeh/bokeh,1,,23,1,14,50,73,0 days 00:00:01.113215
v2fly/v2ray-core,1,v,185,168,4,217,402,0 days 00:00:00.658061
wagerfield/parallax,1,v,6,2,2,5,11,0 days 00:00:00.017646
oblador/react-native-vector-icons,1,v,37,14,10,42,79,0 days 00:00:00.055612
react-grid-layout/react-grid-layout,2, v,22,9,8,86,108,0 days 00:00:00.165902
briannesbitt/Carbon,1,,99,80,7,79,178,0 days 00:00:00.286391
buger/goreplay,2, v,18,5,10,23,41,0 days 00:00:00.081225
simdjson/simdjson,1,v,12,1,5,26,38,0 days 00:00:00.148719
ustbhuangyi/better-scroll,3, v. v,17,6,4,41,58,0 days 00:00:00.116120
spotify/luigi,2, v,13,4,7,46,59,0 days 00:00:00.230572
motdotla/dotenv,1,v,33,17,11,26,59,0 days 00:00:00.044979
nikic/PHP-Parser,1,v,24,7,12,41,65,0 days 00:00:00.083595
semantic-release/semantic-release,2, v,62,48,9,206,268,0 days 00:00:00.252275
JedWatson/classnames,1,v,4,1,2,16,20,0 days 00:00:00.023984
BabylonJS/Babylon.js,2, v,36,16,14,36,72,0 days 00:00:02.641920
jhao104/proxy_pool,1,,10,1,6,2,12,0 days 00:00:00.043611
janl/mustache.js,2, v,20,6,12,23,43,0 days 00:00:00.059000
jasmine/jasmine,1,v,28,5,17,29,57,0 days 00:00:00.144674
outline/outline,2, v,64,54,1,39,103,0 days 00:00:00.359808
wulkano/Kap,1,v,13,2,5,14,27,0 days 00:00:00.071107
auth0/node-jsonwebtoken,1,v,29,13,9,42,71,0 days 00:00:00.044803
radareorg/radare2,2, release-,42,22,6,43,85,0 days 00:00:01.651328
tailwindlabs/heroicons,1,v,4,1,2,15,19,0 days 00:00:00.015685
huiyadanli/RevokeMsgPatcher,1,,15,6,3,0,15,0 days 00:00:00.020875
facebook/yoga,2, v,19,6,8,23,42,0 days 00:00:00.123303
KaTeX/KaTeX,1,v,15,3,10,41,56,0 days 00:00:00.222054
airbnb/visx,1,v,29,25,1,200,229,0 days 00:00:00.248881
infernojs/inferno,2, v,38,29,6,160,198,0 days 00:00:00.449855
cool-RR/PySnooper,1,,7,1,5,10,17,0 days 00:00:00.027436
lottie-react-native/lottie-react-native,1,v,16,2,9,37,53,0 days 00:00:00.049539
teambit/bit,1,v,18,7,5,121,139,0 days 00:00:00.340899
designmodo/Flat-UI,1,,5,1,3,5,10,0 days 00:00:00.022059
catchorg/Catch2,3,V v. v,24,7,7,62,86,0 days 00:00:00.272415
DapperLib/Dapper,1,,31,22,6,13,44,0 days 00:00:00.110458
bower/bower,2, v,18,8,4,83,101,0 days 00:00:00.262662
airbnb/react-sketchapp,2, v,20,11,5,27,47,0 days 00:00:00.067385
2dust/v2rayNG,1,,8,1,5,111,119,0 days 00:00:00.047782
LMAX-Exchange/disruptor,1,,9,1,4,22,31,0 days 00:00:00.057133
qbittorrent/qBittorrent,1,release-,24,5,16,145,169,0 days 00:00:01.055414
flatpickr/flatpickr,2, v,23,10,4,121,144,0 days 00:00:00.219529
icsharpcode/ILSpy,2, v,16,2,11,9,25,0 days 00:00:00.378230
cloudreve/Cloudreve,1,,7,1,5,14,21,0 days 00:00:00.062177
ChainSafe/web3.js,2, v,25,16,7,54,79,0 days 00:00:00.256639
pouchdb/pouchdb,2, v,24,7,8,47,71,0 days 00:00:00.348458
matomo-org/matomo,1,,64,20,21,130,194,0 days 00:00:02.114983
nodemailer/nodemailer,1,v,47,20,15,170,217,0 days 00:00:00.132922
fullcalendar/fullcalendar,1,v,44,16,18,72,116,0 days 00:00:00.505115
Tencent/ncnn,1,,32,9,3,0,32,0 days 00:00:00.138048
gabime/spdlog,1,v,19,4,10,15,34,0 days 00:00:00.216003
you-dont-need/You-Dont-Need-Lodash-Underscore,1,v,14,5,6,6,20,0 days 00:00:00.038848
riot/riot,1,v,44,16,10,155,199,0 days 00:00:00.417868
pyg-team/pytorch_geometric,1,,9,1,5,22,31,0 days 00:00:00.433122
Tencent/vConsole,2, v,24,13,7,34,58,0 days 00:00:00.062412
magic-wormhole/magic-wormhole,1,,12,2,6,22,34,0 days 00:00:00.087263
kovidgoyal/kitty,1,v,25,8,9,58,83,0 days 00:00:00.758781
pqrs-org/Karabiner-Elements,1,v,28,11,5,0,28,0 days 00:00:00.349960
browsh-org/browsh,1,v,5,2,2,45,50,0 days 00:00:00.039535
antonmedv/fx,1,,27,18,4,34,61,0 days 00:00:00.038199
frappe/charts,2, v,5,1,3,13,18,0 days 00:00:00.034513
framer/motion,1,v,60,51,3,243,303,0 days 00:00:00.341057
iovisor/bcc,1,v,24,1,6,9,33,0 days 00:00:00.246020
Anuken/Mindustry,1,v,136,129,4,0,136,0 days 00:00:00.854303
mkdocs/mkdocs,1,,20,9,9,27,47,0 days 00:00:00.107746
hdodenhof/CircleImageView,1,v,9,1,7,6,15,0 days 00:00:00.017925
jellyfin/jellyfin,1,v,8,2,4,30,38,0 days 00:00:01.176344
node-red/node-red,2, v,26,3,18,99,125,0 days 00:00:00.455594
checkly/headless-recorder,1,v,8,4,3,10,18,0 days 00:00:00.026967
erusev/parsedown,2, v,17,10,5,51,68,0 days 00:00:00.051614
localtunnel/localtunnel,1,v,13,3,6,20,33,0 days 00:00:00.021689
InstaPy/InstaPy,2, v,6,2,1,37,43,0 days 00:00:00.186099
fmtlib/fmt,2, v,23,2,14,16,39,0 days 00:00:00.379013
krisk/Fuse,2, v,25,12,10,50,75,0 days 00:00:00.063068
greensock/GSAP,1,,26,5,17,72,98,0 days 00:00:00.050713
cocos2d/cocos2d-x,1,cocos2d-x-,20,2,8,17,37,0 days 00:00:02.882955
hashcat/hashcat,1,v,17,4,9,8,25,0 days 00:00:00.581804
barryvdh/laravel-debugbar,2,V v,24,11,10,99,123,0 days 00:00:00.081032
iBotPeaches/Apktool,1,v,12,3,8,23,35,0 days 00:00:00.128267
chrislusf/seaweedfs,2, v,218,211,2,0,218,0 days 00:00:00.589601
Kr328/ClashForAndroid,2, v,18,10,1,94,112,0 days 00:00:00.089820
joke2k/faker,1,v,95,84,9,138,233,0 days 00:00:00.346316
jarun/nnn,1,v,34,11,4,2,36,0 days 00:00:00.255968
FormidableLabs/webpack-dashboard,2, v,12,3,8,31,43,0 days 00:00:00.030237
browserify/browserify,2, v,149,129,7,264,413,0 days 00:00:00.332801
sweetalert2/sweetalert2,1,v,129,115,3,544,673,0 days 00:00:00.895040
google/filament,1,v,23,13,5,70,93,0 days 00:00:00.352787
be5invis/Iosevka,1,v,59,45,8,163,222,0 days 00:00:00.244572
alibaba/ARouter,1,,4,1,2,16,20,0 days 00:00:00.029075
medcl/elasticsearch-analysis-ik,1,v,42,5,11,130,172,0 days 00:00:00.069110
infinitered/ignite,2, v,52,42,6,94,146,0 days 00:00:00.281187
janpaepke/ScrollMagic,1,v,5,2,2,21,26,0 days 00:00:00.042487
microsoft/LightGBM,1,v,9,1,6,19,28,0 days 00:00:00.169569
marcuswestin/store.js,1,v,4,1,2,31,35,0 days 00:00:00.031991
uNetworking/uWebSockets,1,v,66,52,5,26,92,0 days 00:00:00.125561
CopyTranslator/CopyTranslator,2, v,6,1,3,14,20,0 days 00:00:00.066130
desktop/desktop,1,release-,22,6,8,136,158,0 days 00:00:01.997884
koel/koel,1,v,18,6,6,38,56,0 days 00:00:00.127485
plotly/plotly.js,1,v,72,54,3,133,205,0 days 00:00:01.699291
bootstrap-vue/bootstrap-vue,2, v,47,38,2,66,113,0 days 00:00:00.442138
micropython/micropython,1,v,19,4,10,31,50,0 days 00:00:00.830810
docker-slim/docker-slim,1,,38,21,10,17,55,0 days 00:00:00.057552
wting/autojump,1,release-v,31,14,8,22,53,0 days 00:00:00.060492
kamranahmedse/driver.js,2, v,8,3,1,27,35,0 days 00:00:00.036496
commitizen/cz-cli,2, v,16,6,7,58,74,0 days 00:00:00.044305
gpujs/gpu.js,1,,21,15,3,55,76,0 days 00:00:00.324708
foreversd/forever,2, v,17,2,10,51,68,0 days 00:00:00.054637
thomaspark/bootswatch,1,v,15,1,11,34,49,0 days 00:00:00.136185
markdown-it/markdown-it,1,,29,13,10,47,76,0 days 00:00:00.088815
infinitered/reactotron,1,v,46,36,3,40,86,0 days 00:00:00.109678
Qv2ray/Qv2ray,1,v,15,11,2,32,47,0 days 00:00:00.277709
hapijs/hapi,2, v,129,106,11,194,323,0 days 00:00:00.536180
dogecoin/dogecoin,2, v,17,3,10,64,81,0 days 00:00:01.164652
vuejs/vue,2, v,15,4,7,145,160,0 days 00:00:00.414157
axios/axios,2, v,27,10,10,30,57,0 days 00:00:00.081285
d3/d3,1,v,91,58,12,197,288,0 days 00:00:00.346475
containers/podman,1,v,21,5,4,95,116,0 days 00:00:01.412135
hashicorp/packer,2, v,21,5,15,82,103,0 days 00:00:01.298486
facebook/react,2, v,36,8,14,58,94,0 days 00:00:01.316913
vercel/next.js,2, v,33,11,8,122,155,0 days 00:00:00.870121
puppeteer/puppeteer,1,v,61,49,1,33,94,0 days 00:00:00.175660
twbs/bootstrap,1,v,23,3,15,36,59,0 days 00:00:01.425423
nvbn/thefuck,1,,79,64,8,4,83,0 days 00:00:00.111030
iluwatar/java-design-patterns,1,,19,3,13,0,19,0 days 00:00:00.223336
FortAwesome/Font-Awesome,2, v,30,6,15,40,70,0 days 00:00:00.226667
facebook/react-native,2, v,67,52,8,144,211,0 days 00:00:01.855721
Genymobile/scrcpy,1,v,25,9,5,2,27,0 days 00:00:00.138021
RasaHQ/rasa,1,,33,15,7,233,266,0 days 00:00:02.462699
microsoft/PowerToys,2, v,28,19,3,31,59,0 days 00:00:00.496823
elastic/kibana,1,v,55,17,12,190,245,0 days 00:00:07.135378
tensorflow/models,2,v. v,19,3,9,6,25,0 days 00:00:00.669304
typicode/json-server,2, v,17,4,10,106,123,0 days 00:00:00.071338
laravel/laravel,1,v,40,19,17,134,174,0 days 00:00:00.537039
hakimel/reveal.js,1,,27,3,18,11,38,0 days 00:00:00.169646
huggingface/transformers,2, v,46,41,1,49,95,0 days 00:00:00.697036
gin-gonic/gin,1,v,13,3,8,13,26,0 days 00:00:00.085586
ant-design/ant-design,1,,79,66,4,329,408,0 days 00:00:01.622742
electron/electron,1,v,113,74,19,595,708,0 days 00:00:02.686004
mrdoob/three.js,1,r,132,107,6,0,132,0 days 00:00:02.669175
reduxjs/redux,1,v,26,16,6,42,68,0 days 00:00:00.181490
pallets/flask,1,,16,5,10,25,41,0 days 00:00:00.279000
microsoft/TypeScript,1,v,12,2,2,120,132,0 days 00:00:02.181011
fatedier/frp,1,v,42,23,11,30,72,0 days 00:00:00.077294
gohugoio/hugo,1,v,93,72,10,101,194,0 days 00:00:00.564965
tailwindlabs/tailwindcss,1,v,21,9,8,127,148,0 days 00:00:00.303351
chartjs/Chart.js,2, v,21,7,10,31,52,0 days 00:00:00.246477
521xueweihan/HelloGitHub,1,vol.,19,16,1,0,19,0 days 00:00:00.017844
adam-p/markdown-here,1,v,15,8,6,34,49,0 days 00:00:00.055648
socketio/socket.io,1,,30,5,15,118,148,0 days 00:00:00.167192
expressjs/express,1,,61,40,12,185,246,0 days 00:00:00.365481
shadowsocks/shadowsocks-windows,1,,13,4,7,49,62,0 days 00:00:00.096089
webpack/webpack,1,v,152,134,8,224,376,0 days 00:00:01.198079
jquery/jquery,1,,23,1,21,63,86,0 days 00:00:00.426242
sveltejs/svelte,1,v,134,119,2,244,378,0 days 00:00:00.703774
h5bp/html5-boilerplate,2, v,19,2,13,10,29,0 days 00:00:00.222381
coder/code-server,2, v,20,9,4,22,42,0 days 00:00:00.448847
lodash/lodash,1,,48,39,4,59,107,0 days 00:00:00.558937
azl397985856/leetcode,2, v,35,25,3,5,40,0 days 00:00:00.088321
apache/echarts,1,,29,5,14,64,93,0 days 00:00:00.448257
protocolbuffers/protobuf,1,v,29,6,14,46,75,0 days 00:00:00.911983
psf/requests,2, v,43,11,22,101,144,0 days 00:00:00.436075
remix-run/react-router,1,v,39,22,11,76,115,0 days 00:00:00.414982
django/django,1,,19,1,14,248,267,0 days 00:00:02.977966
bitcoin/bitcoin,1,v,25,3,20,82,107,0 days 00:00:03.160084
moment/moment,1,,40,15,12,46,86,0 days 00:00:00.432150
tiangolo/fastapi,2, v,77,68,3,52,129,0 days 00:00:00.152472
storybookjs/storybook,1,v,107,90,13,323,430,0 days 00:00:03.581318
nestjs/nest,2, v,33,18,5,167,200,0 days 00:00:00.798737
3b1b/manim,2, v,8,1,1,10,18,0 days 00:00:00.243311
ionic-team/ionic-framework,2, v,43,27,10,140,183,0 days 00:00:01.206900
junegunn/fzf,1,,27,8,13,76,103,0 days 00:00:00.144316
tesseract-ocr/tesseract,1,,15,1,10,8,23,0 days 00:00:00.369458
juliangarnier/anime,2, v,8,2,5,6,14,0 days 00:00:00.038975
soimort/you-get,1,v,3,1,1,143,146,0 days 00:00:00.372278
ColorlibHQ/AdminLTE,2, v,13,4,6,47,60,0 days 00:00:00.176848
atom/atom,2, v,271,256,2,104,375,0 days 00:00:02.805631
prettier/prettier,2, v,39,20,8,71,110,0 days 00:00:00.556317
scrapy/scrapy,1,,32,7,17,58,90,0 days 00:00:00.571683
caddyserver/caddy,1,v,14,2,10,49,63,0 days 00:00:00.232582
yarnpkg/yarn,2, v,50,38,1,114,164,0 days 00:00:00.237172
prometheus/prometheus,2, v,67,35,6,79,146,0 days 00:00:00.769277
nuxt/nuxt.js,1,v,30,17,7,112,142,0 days 00:00:00.452271
iamkun/dayjs,1,v,11,5,4,99,110,0 days 00:00:00.112353
gogs/gogs,1,v,11,4,6,51,62,0 days 00:00:00.459607
strapi/strapi,1,v,16,7,3,79,95,0 days 00:00:01.588172
v2ray/v2ray-core,1,v,168,154,3,182,350,0 days 00:00:00.601242
Dogfalo/materialize,2, v,17,10,4,20,37,0 days 00:00:00.206131
vercel/hyper,2, v,18,9,6,43,61,0 days 00:00:00.189662
impress/impress.js,1,,8,4,3,4,12,0 days 00:00:00.034773
FiloSottile/mkcert,1,v,6,3,2,8,14,0 days 00:00:00.020741
PhilJay/MPAndroidChart,1,v,8,2,4,33,41,0 days 00:00:00.129211
facebook/jest,2, v,68,45,10,143,211,0 days 00:00:00.510076
commaai/openpilot,1,v,8,1,6,62,70,0 days 00:00:00.076348
ocornut/imgui,1,v,72,44,5,2,74,0 days 00:00:00.407546
grafana/grafana,2, v,46,7,9,181,227,0 days 00:00:02.733112
hexojs/hexo,1,,38,15,12,101,139,0 days 00:00:00.216174
babel/babel,1,v,90,67,9,606,696,0 days 00:00:01.585779
obsproject/obs-studio,1,,30,1,13,89,119,0 days 00:00:00.762590
TryGhost/Ghost,2, v,170,154,8,318,488,0 days 00:00:01.423468
dcloudio/uni-app,2, v,8,2,1,8,16,0 days 00:00:00.638374
shadowsocks/shadowsocks,1,,4,1,2,14,18,0 days 00:00:00.042912
Leaflet/Leaflet,1,v,16,1,13,27,43,0 days 00:00:00.514465
facebook/docusaurus,1,v,14,8,1,37,51,0 days 00:00:00.233447
sahat/hackathon-starter,1,,8,2,4,6,14,0 days 00:00:00.130283
airbnb/lottie-android,2,v. v,21,8,9,42,63,0 days 00:00:00.193157
lerna/lerna,1,v,39,26,6,70,109,0 days 00:00:00.174801
ansible/ansible,2, v,26,4,13,174,200,0 days 00:00:04.234618
quilljs/quill,1,v,23,12,5,99,122,0 days 00:00:00.283672
videojs/video.js,2, v,70,38,15,220,290,0 days 00:00:00.438656
koajs/koa,1,,43,23,13,44,87,0 days 00:00:00.087269
d2l-ai/d2l-zh,1,v,9,5,3,0,9,0 days 00:00:00.151182
rclone/rclone,1,v,69,36,11,21,90,0 days 00:00:00.372929
zenorocha/clipboard.js,1,v,9,5,3,33,42,0 days 00:00:00.032126
gulpjs/gulp,2, v,6,2,3,13,19,0 days 00:00:00.071106
wg/wrk,1,,10,1,6,11,21,0 days 00:00:00.014376
bumptech/glide,1,v,21,6,11,15,36,0 days 00:00:00.157832
wagoodman/dive,1,v,10,5,2,15,25,0 days 00:00:00.035951
vuetifyjs/vuetify,1,v,23,7,8,284,307,0 days 00:00:00.958614
ant-design/ant-design-pro,2, v,18,6,6,12,30,0 days 00:00:00.124650
immutable-js/immutable-js,2, v,16,11,3,39,55,0 days 00:00:00.105831
google/zx,1,,23,21,1,19,42,0 days 00:00:00.029778
marktext/marktext,1,v,7,2,4,20,27,0 days 00:00:00.200818
shadowsocks/shadowsocks-android,1,v,24,8,11,156,180,0 days 00:00:00.363560
evanw/esbuild,1,v,12,5,2,284,296,0 days 00:00:00.271548
Blankj/AndroidUtilCode,1,,27,12,7,89,116,0 days 00:00:00.096340
XX-net/XX-Net,1,,51,36,5,285,336,0 days 00:00:00.265142
nolimits4web/swiper,1,v,49,14,12,139,188,0 days 00:00:00.260518
nativefier/nativefier,2, v,56,42,9,90,146,0 days 00:00:00.109478
carbon-app/carbon,1,,24,14,4,194,218,0 days 00:00:00.170437
nlohmann/json,2, v,15,2,8,36,51,0 days 00:00:00.382949
photonstorm/phaser,2, v,39,20,11,59,98,0 days 00:00:00.913658
microsoft/monaco-editor,2, v,28,11,10,36,64,0 days 00:00:00.177360
google/leveldb,2, v,21,7,7,0,21,0 days 00:00:00.032248
NervJS/taro,1,v,12,2,5,272,284,0 days 00:00:00.850032
pandas-dev/pandas,2, v,28,1,22,56,84,0 days 00:00:01.965656
2dust/v2rayN,1,,117,111,1,2,119,0 days 00:00:00.066672
fxsjy/jieba,1,v,23,17,5,5,28,0 days 00:00:00.044558
date-fns/date-fns,2,v. v,77,62,7,42,119,0 days 00:00:00.145445
react-boilerplate/react-boilerplate,1,v,17,6,6,13,30,0 days 00:00:00.110136
streamich/react-use,1,v,134,130,3,117,251,0 days 00:00:00.352024
jashkenas/backbone,2, v,10,2,7,22,32,0 days 00:00:00.182361
tastejs/todomvc,2, v,7,1,3,6,13,0 days 00:00:00.182483
beego/beego,1,v,16,3,10,24,40,0 days 00:00:00.248408
nocodb/nocodb,2, v,9,5,2,86,95,0 days 00:00:00.275307
openai/gym,2, v,15,7,6,34,49,0 days 00:00:00.242199
RocketChat/Rocket.Chat,1,,103,94,1,245,348,0 days 00:00:01.793997
certbot/certbot,1,v,68,54,2,31,99,0 days 00:00:00.742982
vuejs/vuex,1,v,21,7,7,24,45,0 days 00:00:00.082376
Dreamacro/clash,1,v,28,10,3,14,42,0 days 00:00:00.051650
istio/istio,1,,22,3,12,143,165,0 days 00:00:01.512472
kenwheeler/slick,2, v,8,3,3,43,51,0 days 00:00:00.059843
square/leakcanary,1,v,14,4,9,10,24,0 days 00:00:00.124182
markedjs/marked,2, v,16,2,11,94,110,0 days 00:00:00.201694
caolan/async,2, v,25,13,10,52,77,0 days 00:00:00.226660
atlassian/react-beautiful-dnd,2, v,24,15,4,46,70,0 days 00:00:00.066194
jesseduffield/lazygit,2, v,33,21,5,151,184,0 days 00:00:00.214678
hashicorp/terraform,2, v,18,2,12,158,176,0 days 00:00:02.193533
naptha/tesseract.js,2, v,4,1,2,28,32,0 days 00:00:00.043966
mitmproxy/mitmproxy,2, v,30,4,17,35,65,0 days 00:00:00.624437
typicode/husky,1,v,34,16,11,88,122,0 days 00:00:00.083755
standard/standard,1,v,66,55,8,87,153,0 days 00:00:00.180515
airbnb/lottie-web,2,v. v,24,9,9,144,168,0 days 00:00:00.169807
ReactiveX/rxjs,1,,19,7,6,45,64,0 days 00:00:00.318865
tannerlinsley/react-query,1,v,77,73,2,294,371,0 days 00:00:00.383633
apolloconfig/apollo,2, v,19,2,9,16,35,0 days 00:00:00.285015
jashkenas/underscore,1,,20,5,13,54,74,0 days 00:00:00.174440
denysdovhan/wtfjs,1,v,23,13,6,16,39,0 days 00:00:00.041449
layui/layui,2, v,7,1,4,41,48,0 days 00:00:00.032378
niklasvh/html2canvas,2, v,7,3,3,17,24,0 days 00:00:00.063216
hankcs/HanLP,1,v,9,2,5,44,53,0 days 00:00:00.074276
aria2/aria2,1,release-,53,22,18,87,140,0 days 00:00:00.389380
postcss/postcss,1,,20,4,10,207,227,0 days 00:00:00.267027
github/fetch,1,v,21,10,9,19,40,0 days 00:00:00.045821
kubernetes/kubernetes,1,v,45,20,19,329,374,0 days 00:00:09.426847
webtorrent/webtorrent,1,v,125,112,9,284,409,0 days 00:00:00.467523
request/request,1,v,73,55,6,71,144,0 days 00:00:00.164096
cheeriojs/cheerio,2, v,22,7,7,30,52,0 days 00:00:00.072915
select2/select2,1,,9,2,5,27,36,0 days 00:00:00.158924
SortableJS/Sortable,1,,17,3,10,18,35,0 days 00:00:00.068021
Modernizr/Modernizr,1,v,20,4,12,23,43,0 days 00:00:00.158798
harness/drone,1,v,31,17,9,44,75,0 days 00:00:00.233601
GitbookIO/gitbook,1,,22,17,2,68,90,0 days 00:00:00.138015
parallax/jsPDF,3, v. v,9,1,7,26,35,0 days 00:00:00.129099
docker/compose,2, v,41,12,15,67,108,0 days 00:00:00.748519
composer/composer,1,,15,1,11,110,125,0 days 00:00:00.939910
lenve/vhr,1,v,12,9,1,0,12,0 days 00:00:00.014810
GoogleChrome/lighthouse,2, v,56,40,4,42,98,0 days 00:00:00.308269
remy/nodemon,1,v,20,7,9,101,121,0 days 00:00:00.113917
Binaryify/NeteaseCloudMusicApi,2, v,52,36,7,102,154,0 days 00:00:00.226722
tmux/tmux,1,,25,1,19,0,25,0 days 00:00:00.566673
bvaughn/react-virtualized,2, v,71,65,3,129,200,0 days 00:00:00.172940
YMFE/yapi,2, v,9,2,3,68,77,0 days 00:00:00.394707
ggreer/the_silver_searcher,1,,37,17,8,12,49,0 days 00:00:00.112198
akveo/ngx-admin,1,v,19,2,9,8,27,0 days 00:00:00.081734
CodeHubApp/CodeHub,1,,15,10,3,13,28,0 days 00:00:00.038884
sequelize/sequelize,2, v,137,107,19,334,471,0 days 00:00:01.023357
getsentry/sentry,2, v,102,90,9,294,396,0 days 00:00:03.114464
pmndrs/react-spring,1,v,22,15,3,150,172,0 days 00:00:00.251266
fastify/fastify,1,v,104,96,1,90,194,0 days 00:00:00.292118
encode/django-rest-framework,1,,22,1,17,106,128,0 days 00:00:00.477998
elastic/elasticsearch,1,v,67,22,16,231,298,0 days 00:00:08.639184
explosion/spaCy,2, v,28,14,11,72,100,0 days 00:00:00.714758
Automattic/mongoose,2, v,58,15,20,646,704,0 days 00:00:01.708795
kubernetes/minikube,1,v,61,43,1,45,106,0 days 00:00:01.853868
laravel/framework,2, v,163,148,13,630,793,0 days 00:00:03.040616
influxdata/influxdb,2, v,26,6,14,133,159,0 days 00:00:01.713388
