project,prefixes,prefixes_names,main_releases,rapid_releases,trad_releases,patches,releases,time
1adrianb/face-alignment,1,v,5,1,2,5,10,0 days 00:00:00.032055
bytedance/IconPark,1,v,4,1,1,32,36,0 days 00:00:00.037121
FaisalUmair/udemy-downloader-gui,1,v,9,4,2,12,21,0 days 00:00:00.037162
robinvdvleuten/vuex-persistedstate,1,v,21,9,7,14,35,0 days 00:00:00.039544
stevenjoezhang/live2d-widget,1,v,8,5,2,9,17,0 days 00:00:00.017904
mindoc-org/mindoc,1,v,14,10,3,17,31,0 days 00:00:00.060036
expressjs/session,1,v,17,7,6,45,62,0 days 00:00:00.070893
Yelp/dumb-init,1,v,8,4,3,14,22,0 days 00:00:00.032309
jquense/react-big-calendar,1,v,37,18,12,77,114,0 days 00:00:00.087051
kalcaddle/KodExplorer,2, v,31,15,10,3,34,0 days 00:00:00.030614
listen1/listen1_desktop,1,v,26,18,5,40,66,0 days 00:00:00.036381
vuejs/apollo,2, v,5,1,2,8,13,0 days 00:00:00.053519
botman/botman,2, v,17,9,6,44,61,0 days 00:00:00.072552
bblanchon/ArduinoJson,1,v,42,20,11,56,98,0 days 00:00:00.108501
googleapis/google-api-python-client,1,v,60,50,6,52,112,0 days 00:00:00.152173
telegraf/telegraf,2, v,68,48,5,112,180,0 days 00:00:00.157075
go-yaml/yaml,1,v,6,2,3,10,16,0 days 00:00:00.034761
projectdiscovery/subfinder,2, v,10,5,4,24,34,0 days 00:00:00.072533
VirusTotal/yara,1,v,17,1,12,16,33,0 days 00:00:00.201283
ecrmnn/collect.js,1,,35,24,5,154,189,0 days 00:00:00.116009
bchavez/Bogus,1,v,7,5,1,97,104,0 days 00:00:00.072359
substack/tape,1,v,50,23,16,85,135,0 days 00:00:00.101185
matthewmueller/x-ray,1,,5,2,2,13,18,0 days 00:00:00.026513
encode/apistar,1,,6,2,3,88,94,0 days 00:00:00.073090
joeyespo/grip,1,v,15,3,10,9,24,0 days 00:00:00.043162
maaslalani/slides,1,v,8,4,1,8,16,0 days 00:00:00.026450
eternnoir/pyTelegramBotAPI,1,,15,3,7,37,52,0 days 00:00:00.116968
lightbend/config,1,v,9,1,4,19,28,0 days 00:00:00.069317
graphql-editor/graphql-editor,2, v,19,15,1,127,146,0 days 00:00:00.080355
Dman95/SASM,1,v,15,4,9,11,26,0 days 00:00:00.031069
neutralinojs/neutralinojs,1,v,26,18,4,4,30,0 days 00:00:00.190833
kickstarter/android-oss,1,v,36,18,5,36,72,0 days 00:00:00.383745
assaf/zombie,2, v,21,12,7,111,132,0 days 00:00:00.227543
Xhofe/alist,1,v,9,5,2,33,42,0 days 00:00:00.145771
thephpleague/omnipay,2, v,12,4,5,18,30,0 days 00:00:00.045890
capstone-engine/capstone,1,,5,2,2,9,14,0 days 00:00:00.305594
tijsverkoyen/CssToInlineStyles,1,,9,2,5,20,29,0 days 00:00:00.027006
ml5js/ml5-library,3, v V,9,3,3,45,54,0 days 00:00:00.264256
MikeMcl/bignumber.js,2, v,20,3,11,27,47,0 days 00:00:00.028335
roots/bedrock,1,,21,3,12,82,103,0 days 00:00:00.075644
golden-layout/golden-layout,2, v,7,1,3,25,32,0 days 00:00:00.051921
datreeio/datree,1,,14,11,2,93,107,0 days 00:00:00.112308
kyleconroy/sqlc,2, v,15,6,3,1,16,0 days 00:00:00.059083
OpenNMT/OpenNMT-py,2, v,15,6,8,14,29,0 days 00:00:00.259892
docker/docker-py,1,,40,7,11,63,103,0 days 00:00:00.315840
shaka-project/shaka-player,1,v,18,2,10,119,137,0 days 00:00:00.550145
lebab/lebab,1,v,14,8,2,28,42,0 days 00:00:00.065964
modulz/stitches,1,v,5,2,1,22,27,0 days 00:00:00.068209
nodeca/js-yaml,1,,23,2,18,51,74,0 days 00:00:00.082288
Respect/Validation,1,,11,1,8,108,119,0 days 00:00:00.182698
haifengl/smile,1,v,12,3,6,10,22,0 days 00:00:00.140137
documentationjs/documentation,1,v,36,23,7,49,85,0 days 00:00:00.122255
vuejs/vetur,2, v,23,12,6,47,70,0 days 00:00:00.240233
google/ios-webkit-debug-proxy,2, v,9,2,5,9,18,0 days 00:00:00.023944
graphql-java/graphql-java,2, v,40,13,14,2,42,0 days 00:00:00.191579
sockeqwe/mosby,1,,7,3,2,8,15,0 days 00:00:00.041123
antonioru/beautiful-react-hooks,1,,5,2,1,6,11,0 days 00:00:00.034095
Lexikos/AutoHotkey_L,2,L v,56,48,2,146,202,0 days 00:00:00.187658
tilt-dev/tilt,1,v,30,18,4,172,202,0 days 00:00:00.343656
gzu-liyujiang/AndroidPicker,1,,11,3,5,45,56,0 days 00:00:00.048582
benbusby/whoogle-search,2, v,7,1,2,15,22,0 days 00:00:00.050847
dinerojs/dinero.js,2, v,13,8,3,17,30,0 days 00:00:00.039669
dotnetcore/CAP,1,v,22,5,11,30,52,0 days 00:00:00.113936
nl8590687/ASRT_SpeechRecognition,1,v,10,4,4,4,14,0 days 00:00:00.024107
express-validator/express-validator,1,v,55,29,15,60,115,0 days 00:00:00.093098
doctrine/common,2, v,18,1,16,31,49,0 days 00:00:00.353562
pagekit/pagekit,1,,4,1,2,31,35,0 days 00:00:00.340935
tensorflow/serving,2, r,25,6,10,27,52,0 days 00:00:00.466032
expressjs/cors,1,v,11,3,5,23,34,0 days 00:00:00.025558
hashicorp/serf,1,v,9,3,3,22,31,0 days 00:00:00.195495
jackc/pgx,1,v,36,11,14,18,54,0 days 00:00:00.227281
mikaelbr/node-notifier,1,v,24,4,13,45,69,0 days 00:00:00.068174
bfenetworks/bfe,1,v,18,10,3,0,18,0 days 00:00:00.068376
missive/emoji-mart,1,v,20,8,7,40,60,0 days 00:00:00.073887
MinecraftForge/MinecraftForge,2, v,59,33,13,10,69,0 days 00:00:00.682433
jbaysolutions/vue-grid-layout,1,,5,1,1,29,34,0 days 00:00:00.028561
jrnl-org/jrnl,2, v,13,2,5,24,37,0 days 00:00:00.105026
johnkerl/miller,2, v,29,15,8,23,52,0 days 00:00:00.487190
evernote/android-job,1,v,4,1,2,36,40,0 days 00:00:00.047310
serilog/serilog,1,v,19,3,7,13,32,0 days 00:00:00.104815
lutris/lutris,2, v,3,1,1,63,66,0 days 00:00:00.364217
jaywcjlove/hotkeys,1,v,12,4,7,62,74,0 days 00:00:00.062264
weaveworks/scope,2, v,31,17,5,30,61,0 days 00:00:00.336370
angular-ui/ui-grid,1,v,24,10,11,86,110,0 days 00:00:00.279046
SixLabors/ImageSharp,1,v,3,1,1,6,9,0 days 00:00:01.261286
jonls/redshift,2, v,17,6,7,2,19,0 days 00:00:00.045987
NVIDIA/TensorRT,2, v,27,17,2,6,33,0 days 00:00:00.044971
valor-software/ngx-bootstrap,2, v,31,15,9,81,112,0 days 00:00:00.161713
gcanti/io-ts,1,,20,10,3,84,104,0 days 00:00:00.062051
anishathalye/dotbot,1,v,20,6,11,28,48,0 days 00:00:00.030893
nathancahill/split,2, v,10,5,3,38,48,0 days 00:00:00.030511
algolia/places,1,v,34,26,4,69,103,0 days 00:00:00.093495
jonschlinkert/remarkable,2, v,9,6,2,13,22,0 days 00:00:00.037330
ppoffice/hexo-theme-icarus,2, v,22,9,9,9,31,0 days 00:00:00.043551
fatih/color,1,v,16,4,10,1,17,0 days 00:00:00.021898
ly525/luban-h5,1,v,18,12,3,14,32,0 days 00:00:00.046078
chyroc/WechatSogou,1,v,8,1,3,15,23,0 days 00:00:00.028085
mwouts/jupytext,3, v v.,20,10,7,75,95,0 days 00:00:00.134285
log4js-node/log4js-node,1,v,32,19,9,90,122,0 days 00:00:00.143347
mixn/carbon-now-cli,2, v,5,2,1,7,12,0 days 00:00:00.021565
arachnys/cabot,1,,6,4,1,33,39,0 days 00:00:00.063865
go-flutter-desktop/go-flutter,1,v,39,33,3,15,54,0 days 00:00:00.038119
kaorun343/vue-property-decorator,1,v,24,8,5,16,40,0 days 00:00:00.128873
open-cli-tools/concurrently,2, v,27,7,14,18,45,0 days 00:00:00.034138
agentejo/cockpit,1,,8,1,5,27,35,0 days 00:00:00.153093
gorakhargosh/watchdog,1,v,12,2,6,35,47,0 days 00:00:00.104273
alan-turing-institute/sktime,1,v,10,1,4,14,24,0 days 00:00:00.257632
barryvdh/laravel-dompdf,1,v,10,1,8,24,34,0 days 00:00:00.025134
go-acme/lego,1,v,34,15,7,17,51,0 days 00:00:00.184238
bytedance/xgplayer,1,v,4,1,2,44,48,0 days 00:00:00.141135
devicons/devicon,1,v,17,6,5,4,21,0 days 00:00:00.072248
PyGithub/PyGithub,2, v,62,40,9,23,85,0 days 00:00:00.149159
django/channels,1,,20,9,8,44,64,0 days 00:00:00.081257
oauth2-proxy/oauth2-proxy,1,v,18,1,10,9,27,0 days 00:00:00.230579
containers/buildah,3,V  v,42,22,3,70,112,0 days 00:00:00.426983
ExactTarget/fuelux,1,,25,10,6,59,84,0 days 00:00:00.287412
i-tu/Hasklig,2, v,12,5,4,0,12,0 days 00:00:00.068841
tjanczuk/edge,1,v,11,5,5,23,34,0 days 00:00:00.048203
encode/uvicorn,1,,17,4,4,119,136,0 days 00:00:00.091953
domlysz/BlenderGIS,2, v,3,1,1,0,3,0 days 00:00:00.033880
berty/berty,1,v,390,387,1,579,969,0 days 00:00:01.673475
leongersen/noUiSlider,1,,45,19,16,58,103,0 days 00:00:00.084522
tzapu/WiFiManager,2, v,16,10,3,0,16,0 days 00:00:00.026125
alibaba/transmittable-thread-local,2, v,18,6,8,31,49,0 days 00:00:00.058373
arturbien/React95,1,v,13,7,3,6,19,0 days 00:00:00.046288
h6ah4i/android-advancedrecyclerview,1,,8,1,6,22,30,0 days 00:00:00.047639
crowdsecurity/crowdsec,1,v,7,1,3,39,46,0 days 00:00:00.064493
mher/flower,1,v,9,1,6,15,24,0 days 00:00:00.076504
substack/minimist,1,,6,2,2,20,26,0 days 00:00:00.017380
wasabeef/Blurry,1,,6,1,4,7,13,0 days 00:00:00.016498
graphql-dotnet/graphql-dotnet,2, v,42,24,7,45,87,0 days 00:00:00.135177
kartik-v/bootstrap-fileinput,1,v,26,18,7,61,87,0 days 00:00:00.082145
go-task/task,1,v,26,9,7,26,52,0 days 00:00:00.071813
nodegit/nodegit,1,v,27,9,10,67,94,0 days 00:00:00.205710
naver/billboard.js,1,,21,1,13,54,75,0 days 00:00:00.207751
release-it/release-it,1,,84,66,12,176,260,0 days 00:00:00.222022
crossplane/crossplane,1,v,23,11,3,34,57,0 days 00:00:00.356208
sachinchoolur/lightGallery,2, v,16,4,8,66,82,0 days 00:00:00.072807
phan/phan,1,,33,13,10,127,160,0 days 00:00:00.415079
nhn/tui.image-editor,2, v,21,7,12,17,38,0 days 00:00:00.058640
bestiejs/benchmark.js,1,,5,2,2,19,24,0 days 00:00:00.074900
wangyu-/udp2raw,1,,38,31,2,0,38,0 days 00:00:00.062757
chainer/chainer,1,v,60,47,3,18,78,0 days 00:00:02.274215
snorkel-team/snorkel,1,v,4,1,2,11,15,0 days 00:00:00.152701
vrana/adminer,1,v,17,4,11,35,52,0 days 00:00:00.256492
GoogleChrome/lighthouse-ci,1,v,9,1,5,24,33,0 days 00:00:00.057623
windicss/windicss,1,v,13,8,1,81,94,0 days 00:00:00.075490
onionshare/onionshare,2, v,18,5,11,9,27,0 days 00:00:00.395589
arkime/arkime,1,v,32,2,17,70,102,0 days 00:00:00.361462
hiroppy/fusuma,1,v,37,32,3,59,96,0 days 00:00:00.210354
ai/size-limit,1,,45,29,7,101,146,0 days 00:00:00.098424
share/sharedb,1,v,23,7,9,111,134,0 days 00:00:00.261907
lancedikson/bowser,2, v,26,11,8,33,59,0 days 00:00:00.066805
rmax/scrapy-redis,2, v,6,1,3,12,18,0 days 00:00:00.022417
vuejs/v2.vuejs.org,1,v,8,4,3,9,17,0 days 00:00:00.035583
timolins/react-hot-toast,1,v,7,3,2,5,12,0 days 00:00:00.025448
rectorphp/rector,2, v,13,1,9,351,364,0 days 00:00:01.094597
reactchartjs/react-chartjs-2,3, v v.,24,9,9,51,75,0 days 00:00:00.050878
standard-things/esm,1,,29,27,1,160,189,0 days 00:00:00.382223
msiemens/tinydb,2, v,34,10,16,26,60,0 days 00:00:00.053836
laravel/socialite,1,v,18,2,9,62,80,0 days 00:00:00.075499
nhn/tui.chart,2, v,38,21,8,60,98,0 days 00:00:00.156344
reviewdog/reviewdog,2, v,6,1,4,21,27,0 days 00:00:00.271937
reek/anti-adblock-killer,1,v,31,29,1,0,31,0 days 00:00:00.040231
microsoft/Windows-driver-samples,1,,609,57,1,0,609,0 days 00:00:00.679144
luraproject/lura,2, v,15,2,10,12,27,0 days 00:00:00.050753
expressjs/body-parser,1,,21,9,8,47,68,0 days 00:00:00.053328
jvm-profiling-tools/async-profiler,1,v,14,2,9,9,23,0 days 00:00:00.043299
openpgpjs/openpgpjs,1,v,40,18,13,109,149,0 days 00:00:00.180820
TommyLemon/Android-ZBLibrary,1,,21,13,4,4,25,0 days 00:00:00.041527
btraceio/btrace,3,release-  v,5,1,2,34,39,0 days 00:00:00.076166
jarun/buku,2, v,36,18,6,3,39,0 days 00:00:00.127406
healthchecks/healthchecks,2, v,28,10,1,8,36,0 days 00:00:00.143967
pypa/pipx,1,,15,7,5,36,51,0 days 00:00:00.053247
journeyapps/zxing-android-embedded,1,v,15,4,9,7,22,0 days 00:00:00.075701
minbrowser/min,2, v,26,4,8,31,57,0 days 00:00:00.151399
spectreconsole/spectre.console,1,,44,38,1,3,47,0 days 00:00:00.044425
Snapchat/KeyDB,1,v,6,1,2,16,22,0 days 00:00:01.543280
laravel-mix/laravel-mix,1,v,27,19,3,105,132,0 days 00:00:00.139355
Mailtrain-org/mailtrain,1,v,25,20,2,10,35,0 days 00:00:00.091024
uber/prototool,1,v,18,13,3,2,20,0 days 00:00:00.031829
lukeed/polka,1,v,5,2,2,9,14,0 days 00:00:00.023241
istanbuljs/nyc,1,v,58,43,4,56,114,0 days 00:00:00.084964
zhaojun1998/zfile,1,,32,26,3,11,43,0 days 00:00:00.036557
ZipArchive/ZipArchive,2, v,17,4,9,80,97,0 days 00:00:00.075628
json5/json5,1,v,10,1,7,8,18,0 days 00:00:00.034643
wiremock/wiremock,2, release-,55,28,16,28,83,0 days 00:00:00.164870
uNetworking/uWebSockets.js,1,v,59,51,3,6,65,0 days 00:00:00.071832
kedacore/keda,1,v,14,3,4,3,17,0 days 00:00:00.107047
aws/aws-sdk-php,1,,234,217,7,1228,1462,0 days 00:00:02.690334
panjf2000/gnet,1,v,8,2,5,35,43,0 days 00:00:00.063042
johannesjo/super-productivity,1,v,58,48,3,296,354,0 days 00:00:00.712409
timber/timber,2, v,32,10,14,96,128,0 days 00:00:00.386088
rauchg/slackin,1,,14,8,3,26,40,0 days 00:00:00.031306
material-shell/material-shell,2, v,11,7,2,0,11,0 days 00:00:00.147164
pedroslopez/whatsapp-web.js,1,v,18,8,3,39,57,0 days 00:00:00.045247
google/benchmark,1,v,8,2,5,9,17,0 days 00:00:00.086726
kubeedge/kubeedge,1,v,14,1,10,11,25,0 days 00:00:00.282585
Angel-ML/angel,2,Release- v,14,2,6,4,18,0 days 00:00:00.177537
reactjs/react-rails,2, v,24,9,9,31,55,0 days 00:00:00.087103
fengyuanchen/viewerjs,1,v,21,6,10,28,49,0 days 00:00:00.041605
docker/machine,2, v,16,2,8,16,32,0 days 00:00:00.240170
roadrunner-server/roadrunner,2, v,22,7,7,81,103,0 days 00:00:00.198979
vitalets/x-editable,1,,6,4,1,9,15,0 days 00:00:00.033039
LonamiWebs/Telethon,1,v,44,26,4,91,135,0 days 00:00:00.268783
SigmaHQ/sigma,1,,19,6,6,10,29,0 days 00:00:00.768950
ponylang/ponyc,2, release-,51,31,9,56,107,0 days 00:00:00.534531
hajimehoshi/ebiten,1,v,17,2,13,66,83,0 days 00:00:00.395638
go-admin-team/go-admin,1,v,6,1,3,27,33,0 days 00:00:00.071615
sghall/react-move,1,v,28,19,7,21,49,0 days 00:00:00.043102
espnet/espnet,1,v.,11,1,6,32,43,0 days 00:00:00.882822
glidejs/glide,1,v,8,1,5,25,33,0 days 00:00:00.043673
meetecho/janus-gateway,1,v,11,1,7,53,64,0 days 00:00:00.416305
hotoo/pinyin,1,,13,1,10,28,41,0 days 00:00:00.034334
ServiceStack/ServiceStack,1,v,17,2,12,41,58,0 days 00:00:00.751716
mobxjs/mobx-state-tree,2, v,38,28,7,64,102,0 days 00:00:00.147665
electronicarts/EASTL,1,,14,1,8,31,45,0 days 00:00:00.036855
0x7c13/Notepads,1,v,14,9,2,42,56,0 days 00:00:00.070560
boto/boto,2, v,50,28,10,29,79,0 days 00:00:00.434841
wilsonpage/fastdom,2, v,8,5,2,23,31,0 days 00:00:00.026131
ocrmypdf/OCRmyPDF,1,v,63,40,7,115,178,0 days 00:00:00.238866
mbdavid/LiteDB,2,v v.,8,1,3,27,35,0 days 00:00:00.123229
mRemoteNG/mRemoteNG,2, v,17,9,7,23,40,0 days 00:00:00.239398
electerm/electerm,2, v,35,23,5,292,327,0 days 00:00:00.311160
sebastianbergmann/exporter,1,,7,2,4,12,19,0 days 00:00:00.039560
baconjs/bacon.js,1,,9,3,3,200,209,0 days 00:00:00.320157
zo0r/react-native-push-notification,2, v,16,10,2,19,35,0 days 00:00:00.059269
zendesk/android-floating-action-button,1,,11,9,1,4,15,0 days 00:00:00.018315
houtianze/bypy,1,,5,1,2,69,74,0 days 00:00:00.048322
rs/zerolog,1,v,27,9,8,16,43,0 days 00:00:00.030841
kelektiv/node.bcrypt.js,2, v,11,1,9,39,50,0 days 00:00:00.130401
appleboy/gorush,2, v,16,6,8,15,31,0 days 00:00:00.059528
opencart/opencart,1,,11,4,5,24,35,0 days 00:00:00.851124
mautic/mautic,1,,30,6,13,59,89,0 days 00:00:01.641275
doctrine/annotations,2, v,14,1,9,20,34,0 days 00:00:00.372731
sebastianbergmann/environment,1,,11,1,6,27,38,0 days 00:00:00.042451
rancher/os,1,v,15,4,6,43,58,0 days 00:00:00.168748
optuna/optuna,1,v,36,27,2,4,40,0 days 00:00:00.704591
kpdecker/jsdiff,1,v,15,3,9,24,39,0 days 00:00:00.037585
linkedin/css-blocks,2, v,17,9,4,22,39,0 days 00:00:00.101603
the-benchmarker/web-frameworks,2, v,3,1,1,13,16,0 days 00:00:00.058073
conventional-changelog/standard-version,1,v,24,8,13,13,37,0 days 00:00:00.035334
Squirrel/Squirrel.Windows,1,,17,5,7,48,65,0 days 00:00:00.096677
ramboxapp/community-edition,1,,7,3,3,36,43,0 days 00:00:00.078942
sindresorhus/caprine,2, v,70,49,3,43,113,0 days 00:00:00.195849
dylanaraps/pywal,1,,17,10,2,65,82,0 days 00:00:00.085591
simeji/jid,2, v,7,4,1,14,21,0 days 00:00:00.019888
graphql/express-graphql,1,v,12,3,7,31,43,0 days 00:00:00.057096
gocd/gocd,1,,69,48,4,2,71,0 days 00:00:01.022918
Uberi/speech_recognition,1,,16,6,6,29,45,0 days 00:00:00.038557
isomorphic-git/isomorphic-git,1,v,96,86,3,238,334,0 days 00:00:00.220047
yugabyte/yugabyte-db,2, v,18,1,12,73,91,0 days 00:00:01.141227
vmware-tanzu/velero,1,v,17,2,8,43,60,0 days 00:00:00.211990
automl/auto-sklearn,3, v v.,12,2,6,21,33,0 days 00:00:00.143144
Cyan4973/xxHash,2,r v,12,4,4,11,23,0 days 00:00:00.081632
baldurk/renderdoc,1,v,39,6,11,0,39,0 days 00:00:00.873200
FreeRDP/FreeRDP,1,,9,2,4,8,17,0 days 00:00:00.983781
arc298/instagram-scraper,2, v,11,3,4,68,79,0 days 00:00:00.041810
katspaugh/wavesurfer.js,2, v,26,5,10,105,131,0 days 00:00:00.214055
symfony/translation,1,v,26,4,21,462,488,0 days 00:00:00.433724
invoiceninja/invoiceninja,1,v,41,21,5,387,428,0 days 00:00:01.574548
node-formidable/formidable,2, v,12,8,3,33,45,0 days 00:00:00.053240
feross/simple-peer,1,v,50,34,10,71,121,0 days 00:00:00.099745
PHPOffice/PHPWord,1,,12,3,7,8,20,0 days 00:00:00.127115
maxogden/menubar,1,v,18,4,8,47,65,0 days 00:00:00.040356
elasticsearch-dump/elasticsearch-dump,2, v,113,92,6,137,250,0 days 00:00:00.186950
albertlauncher/albert,1,v,17,9,5,64,81,0 days 00:00:00.091462
apache/storm,2, v,11,1,9,26,37,0 days 00:00:00.910011
doccano/doccano,1,v,8,2,3,19,27,0 days 00:00:00.179307
Radarr/Radarr,2, v,99,64,14,13,112,0 days 00:00:00.877094
99designs/aws-vault,1,v,34,17,9,32,66,0 days 00:00:00.217651
amoffat/sh,1,,34,26,5,17,51,0 days 00:00:00.082196
dtm-labs/dtm,1,v,21,18,1,35,56,0 days 00:00:00.171695
react-native-video/react-native-video,2, v,24,13,7,49,73,0 days 00:00:00.088952
jackocnr/intl-tel-input,2, v,62,41,10,262,324,0 days 00:00:00.277753
StackExchange/blackbox,1,v,18,6,8,0,18,0 days 00:00:00.048023
Zizaco/entrust,1,,10,2,7,8,18,0 days 00:00:00.035697
gitalk/gitalk,1,v,5,1,3,16,21,0 days 00:00:00.023517
i18next/i18next,2, v,91,66,9,222,313,0 days 00:00:00.243915
RichardKnop/machinery,1,v,11,1,7,86,97,0 days 00:00:00.081341
go-resty/resty,1,v,34,14,10,7,41,0 days 00:00:00.041907
medialize/URI.js,2,v v.,20,7,11,54,74,0 days 00:00:00.075607
JetBrains/Exposed,1,,8,3,3,78,86,0 days 00:00:00.212502
yagop/node-telegram-bot-api,1,v,26,14,6,13,39,0 days 00:00:00.051635
DIYgod/APlayer,2, v,6,3,2,15,21,0 days 00:00:00.030181
shentao/vue-multiselect,2, v,5,2,1,20,25,0 days 00:00:00.032429
yocontra/react-responsive,1,v,8,2,4,28,36,0 days 00:00:00.143742
jiaaro/pydub,1,v,17,3,9,19,36,0 days 00:00:00.054070
NixOS/nix,1,,37,5,23,53,90,0 days 00:00:00.875074
maxence-charriere/go-app,2, v,37,24,6,69,106,0 days 00:00:00.106861
dataarts/dat.gui,2, v,6,1,2,18,24,0 days 00:00:00.042103
baskerville/bspwm,1,,9,5,1,15,24,0 days 00:00:00.081399
swaggo/swag,2,v v.,9,1,5,23,32,0 days 00:00:00.052653
redux-offline/redux-offline,2, v,7,1,4,9,16,0 days 00:00:00.033638
software-mansion/react-native-reanimated,1,,23,10,2,19,42,0 days 00:00:00.106490
securego/gosec,2, v,16,3,8,8,24,0 days 00:00:00.057211
thephpleague/oauth2-server,1,,25,3,11,72,97,0 days 00:00:00.171721
simonw/datasette,1,,55,43,6,39,94,0 days 00:00:00.139290
ArthurHub/Android-Image-Cropper,1,,9,2,6,23,32,0 days 00:00:00.042084
fruitcake/laravel-cors,2,V v,16,5,10,33,49,0 days 00:00:00.038866
faker-js/faker,1,v,22,10,9,26,48,0 days 00:00:00.158460
bpmn-io/bpmn-js,2, v,75,46,7,155,230,0 days 00:00:00.263010
electerious/Lychee,2, v,11,1,6,31,42,0 days 00:00:00.088567
garris/BackstopJS,2, v,25,9,8,106,131,0 days 00:00:00.113847
dylang/npm-check,2, v,12,4,6,33,45,0 days 00:00:00.030778
gruntwork-io/terratest,1,v,39,21,9,296,335,0 days 00:00:00.419236
belluzj/fantasque-sans,2, v,5,1,2,10,15,0 days 00:00:00.022731
centrifugal/centrifugo,1,v,24,5,9,57,81,0 days 00:00:00.112087
marshmallow-code/marshmallow,1,,48,22,11,77,125,0 days 00:00:00.214612
pahen/madge,2, v,30,13,11,29,59,0 days 00:00:00.048650
react-native-svg/react-native-svg,2, v,45,30,7,164,209,0 days 00:00:00.163601
chrismaltby/gb-studio,2, v,6,3,2,6,12,0 days 00:00:00.315443
PaddlePaddle/Paddle-Lite,3, release/ v,15,4,7,6,21,0 days 00:00:00.467186
snipe/snipe-it,3, v V,30,12,13,130,160,0 days 00:00:00.719642
gsoft-inc/craco,1,v,32,24,2,27,59,0 days 00:00:00.047832
uber/cadence,1,v,22,9,7,55,77,0 days 00:00:00.330795
tindy2013/subconverter,1,v,7,3,2,28,35,0 days 00:00:00.047900
chancejs/chancejs,2, v,9,3,5,47,56,0 days 00:00:00.067129
jenssegers/laravel-mongodb,2, v,19,3,12,91,110,0 days 00:00:00.186931
thedevs-network/kutt,1,v,10,5,2,51,61,0 days 00:00:00.050703
aws/aws-sam-cli,1,v,96,89,1,36,132,0 days 00:00:00.151476
crater-invoice/crater,1,,11,4,4,19,30,0 days 00:00:00.082133
filhodanuvem/gitql,2, v,10,2,6,8,18,0 days 00:00:00.026123
mcollina/autocannon,1,v,52,36,9,43,95,0 days 00:00:00.061334
concourse/concourse,1,v,134,117,4,81,215,0 days 00:00:01.901712
supertokens/supertokens-core,1,v,22,15,2,17,39,0 days 00:00:00.049277
SocketCluster/socketcluster,3, v v.,17,13,3,26,43,0 days 00:00:00.068583
flot/flot,2, v,16,6,7,35,51,0 days 00:00:00.075675
hashicorp/raft,1,v,5,1,3,15,20,0 days 00:00:00.062754
wojtekmaj/react-pdf,1,v,27,13,6,36,63,0 days 00:00:00.081850
xonsh/xonsh,1,,12,1,10,100,112,0 days 00:00:00.622697
onsi/ginkgo,1,v,19,3,11,21,40,0 days 00:00:00.062429
reactiveui/refit,2, v,13,3,6,39,52,0 days 00:00:00.135370
fabiospampinato/cash,1,,16,8,5,36,52,0 days 00:00:00.055575
burnash/gspread,2, v,19,9,8,21,40,0 days 00:00:00.071250
plantuml/plantuml,1,v,9,2,4,78,87,0 days 00:00:00.080471
google/error-prone,1,v,15,3,5,34,49,0 days 00:00:00.345227
OJ/gobuster,1,v,11,1,7,4,15,0 days 00:00:00.034365
sindresorhus/query-string,2, v,34,12,12,38,72,0 days 00:00:00.115289
karatelabs/karate,1,v,11,1,6,27,38,0 days 00:00:00.205698
bytedeco/javacv,1,,17,1,14,14,31,0 days 00:00:00.042777
jazzband/pip-tools,1,,45,22,12,49,94,0 days 00:00:00.227422
ractivejs/ractive,1,v,10,1,6,88,98,0 days 00:00:00.181391
trpc/trpc,2, v,57,54,1,48,105,0 days 00:00:00.145884
platformio/platformio-core,3, v v.,43,22,13,72,115,0 days 00:00:00.408665
rest-assured/rest-assured,1,rest-assured-,32,6,15,40,72,0 days 00:00:00.131230
Graylog2/graylog2-server,1,,25,1,20,124,149,0 days 00:00:01.619266
spulec/moto,2, v,14,2,8,152,166,0 days 00:00:00.411224
heroiclabs/nakama,1,v,38,17,5,29,67,0 days 00:00:00.238646
ianstormtaylor/superstruct,1,v,14,7,4,55,69,0 days 00:00:00.071167
webslides/WebSlides,1,,7,4,1,7,14,0 days 00:00:00.037796
File-New-Project/EarTrumpet,1,,9,2,6,29,38,0 days 00:00:00.089639
perkeep/perkeep,1,,11,5,5,0,11,0 days 00:00:00.535602
moroshko/react-autosuggest,1,v,41,30,6,54,95,0 days 00:00:00.067778
gruntwork-io/terragrunt,1,v,37,18,12,337,374,0 days 00:00:00.390885
geerlingguy/ansible-for-devops,1,,32,16,9,1,33,0 days 00:00:00.044662
Unleash/unleash,2, v,34,19,7,132,166,0 days 00:00:00.327616
kulshekhar/ts-jest,2, v,30,14,8,88,118,0 days 00:00:00.340422
twitchtv/twirp,1,v,18,8,8,10,28,0 days 00:00:00.048051
sparklemotion/nokogiri,2,v REL_,15,2,10,89,104,0 days 00:00:00.493009
Shougo/deoplete.nvim,1,,14,1,11,0,14,0 days 00:00:00.136404
airbnb/hypernova,1,v,9,1,4,8,17,0 days 00:00:00.023414
neuecc/UniRx,1,,18,8,5,7,25,0 days 00:00:00.061958
cupy/cupy,1,v,56,48,1,6,62,0 days 00:00:01.896343
mahmoud/boltons,1,,24,9,9,21,45,0 days 00:00:00.089374
yuliskov/SmartTubeNext,1,,73,54,1,0,73,0 days 00:00:00.294213
davidjbradshaw/iframe-resizer,2, v,26,16,7,96,122,0 days 00:00:00.104017
mitchellh/mapstructure,1,v,6,2,3,11,17,0 days 00:00:00.028051
postmanlabs/newman,3, v v.,26,8,8,80,106,0 days 00:00:00.377291
weibocom/motan,1,,5,1,3,17,22,0 days 00:00:00.047499
ethereum-mining/ethminer,1,v,10,1,5,3,13,0 days 00:00:00.990892
TypeStrong/typedoc,2, v,22,3,13,127,149,0 days 00:00:00.177573
travist/jsencrypt,2, v,7,2,3,3,10,0 days 00:00:00.023820
react-native-device-info/react-native-device-info,1,v,57,43,7,114,171,0 days 00:00:00.127363
vmware-tanzu/octant,1,v,25,16,3,15,40,0 days 00:00:00.403606
Jrohy/multi-v2ray,1,v,18,10,4,79,97,0 days 00:00:00.133671
voidcosmos/npkill,1,v,8,5,2,19,27,0 days 00:00:00.042414
Financial-Times/polyfill-service,2, v,87,65,5,87,174,0 days 00:00:00.265503
python-visualization/folium,1,v,11,1,7,10,21,0 days 00:00:00.097682
gevent/gevent,2, v,19,4,12,35,54,0 days 00:00:00.451324
pentaho/pentaho-kettle,1,,31,10,16,37,68,0 days 00:00:01.037545
HMBSbige/ShadowsocksR-Windows,1,,28,12,13,127,155,0 days 00:00:00.188243
vuejs/vue-class-component,1,v,10,2,5,15,25,0 days 00:00:00.023512
mattn/go-sqlite3,1,v,16,4,7,19,35,0 days 00:00:00.070146
plasma-umass/scalene,2, v,3,1,1,22,25,0 days 00:00:00.121902
redux-observable/redux-observable,2, v,23,13,7,8,31,0 days 00:00:00.051290
deepmipt/DeepPavlov,1,,17,6,4,28,45,0 days 00:00:00.272973
taigaio/taiga-back,1,,24,7,9,74,98,0 days 00:00:00.249373
kelseyhightower/confd,1,v,15,3,8,7,22,0 days 00:00:00.060004
vercel/serve,2, v,49,34,7,96,145,0 days 00:00:00.088695
PrestaShop/PrestaShop,1,,30,14,3,83,113,0 days 00:00:04.637232
UKPLab/sentence-transformers,1,v,10,3,5,20,30,0 days 00:00:00.060435
jsx-eslint/eslint-plugin-react,1,v,81,55,6,88,169,0 days 00:00:00.380376
carla-simulator/carla,1,,9,4,3,38,47,0 days 00:00:00.275134
brython-dev/brython,1,,12,1,9,46,58,0 days 00:00:00.441505
mozilla/nunjucks,3, v v.,14,1,7,37,51,0 days 00:00:00.090449
adnanh/webhook,1,,9,5,3,21,30,0 days 00:00:00.039123
gcanti/fp-ts,1,,38,23,8,115,153,0 days 00:00:00.184483
metalsmith/metalsmith,2, v,24,15,3,60,84,0 days 00:00:00.048923
ffmpegwasm/ffmpeg.wasm,1,v,10,6,2,18,28,0 days 00:00:00.023388
hoffstadt/DearPyGui,1,v,8,4,1,10,18,0 days 00:00:00.337502
sindresorhus/type-fest,1,v,40,29,3,34,74,0 days 00:00:00.041002
remix-run/history,1,v,38,24,7,40,78,0 days 00:00:00.103018
cortexlabs/cortex,1,v,42,36,1,20,62,0 days 00:00:00.188200
hybridgroup/gobot,3, v v.,29,10,11,16,45,0 days 00:00:00.250695
alibaba/formily,1,v,9,1,4,85,94,0 days 00:00:00.177770
BeyondDimension/SteamTools,1,,10,6,3,28,38,0 days 00:00:00.177955
colinhacks/zod,2, v,20,15,2,23,43,0 days 00:00:00.113121
rebassjs/rebass,1,v,11,3,5,42,53,0 days 00:00:00.099116
mvt-project/mvt,1,v,4,2,1,36,40,0 days 00:00:00.039229
beautify-web/js-beautify,1,v,13,3,7,74,87,0 days 00:00:00.217612
prompt-toolkit/python-prompt-toolkit,1,,5,1,1,51,56,0 days 00:00:00.147140
yjs/yjs,1,v,19,9,8,151,170,0 days 00:00:00.139118
sindresorhus/ora,1,v,24,9,9,13,37,0 days 00:00:00.021533
nodegui/nodegui,1,v,48,42,1,45,93,0 days 00:00:00.101412
probot/probot,2, v,71,58,3,124,195,0 days 00:00:00.283507
tailscale/tailscale,1,v,19,8,2,54,73,0 days 00:00:00.316699
chromedp/chromedp,1,v,8,1,5,33,41,0 days 00:00:00.049288
mrdoob/stats.js,1,r,16,6,8,0,16,0 days 00:00:00.349539
yiminghe/async-validator,2, v,18,4,11,59,77,0 days 00:00:00.037171
signalapp/Signal-Server,1,v,215,206,2,18,233,0 days 00:00:00.215169
paramiko/paramiko,3, v release-,23,3,13,152,175,0 days 00:00:00.363243
go-swagger/go-swagger,2, v,29,8,11,26,55,0 days 00:00:00.192473
kubernetes/kompose,1,v,34,22,6,3,37,0 days 00:00:00.098591
sindresorhus/ky,1,v,29,15,2,18,47,0 days 00:00:00.030216
ckeditor/ckeditor5,2, v,48,30,3,6,54,0 days 00:00:03.240796
theonedev/onedev,2, v,26,17,2,131,157,0 days 00:00:00.400631
developit/mitt,2, v,6,1,3,5,11,0 days 00:00:00.020788
99designs/gqlgen,2, v,16,7,6,35,51,0 days 00:00:00.153575
react-native-image-picker/react-native-image-picker,2, v,37,22,8,86,123,0 days 00:00:00.078003
react-grid-layout/react-draggable,1,v,24,9,7,57,81,0 days 00:00:00.055168
konvajs/konva,1,,41,18,8,131,172,0 days 00:00:00.271472
swagger-api/swagger-editor,3, v v/,27,11,11,364,391,0 days 00:00:00.470565
chaijs/chai,2, v,30,11,9,48,78,0 days 00:00:00.110354
QuantConnect/Lean,2, v,1917,1077,4,10,1927,0 days 00:00:05.051187
akveo/nebular,1,v,23,9,4,23,46,0 days 00:00:00.141582
retejs/rete,2, v,12,4,3,35,47,0 days 00:00:00.048474
symfony/http-kernel,1,v,26,4,21,489,515,0 days 00:00:00.764390
go-vgo/robotgo,2, v,21,4,9,24,45,0 days 00:00:00.088390
NginxProxyManager/nginx-proxy-manager,2, v,10,4,2,48,58,0 days 00:00:00.071646
dropwizard/metrics,1,v,10,1,8,77,87,0 days 00:00:00.339563
isaacs/node-glob,2, v,18,5,10,102,120,0 days 00:00:00.173113
streamlink/streamlink,1,,30,9,7,17,47,0 days 00:00:00.234407
visionmedia/page.js,2, v,10,3,4,29,39,0 days 00:00:00.048594
HangfireIO/Hangfire,2,v v.,13,4,4,92,105,0 days 00:00:00.249753
xupefei/Locale-Emulator,2, v,13,7,5,14,27,0 days 00:00:00.031407
secdev/scapy,1,v,80,71,8,432,512,0 days 00:00:00.886244
prometheus/node_exporter,2, v,17,2,12,11,28,0 days 00:00:00.129150
DaveGamble/cJSON,1,v,9,5,1,36,45,0 days 00:00:00.064819
guzzle/psr7,1,,12,1,9,17,29,0 days 00:00:00.054916
metricsgraphics/metrics-graphics,3,V v v.,25,12,5,10,35,0 days 00:00:00.095548
trustedsec/social-engineer-toolkit,1,,17,4,9,87,104,0 days 00:00:00.968152
twigphp/Twig,1,v,66,29,23,139,205,0 days 00:00:00.563448
doctrine/cache,2, v,17,4,9,27,44,0 days 00:00:00.064145
symfony/polyfill-mbstring,1,v,25,2,13,9,34,0 days 00:00:00.019955
InsertKoinIO/koin,1,,13,5,6,33,46,0 days 00:00:00.133879
FormidableLabs/radium,1,v,17,6,6,46,63,0 days 00:00:00.077425
react-cosmos/react-cosmos,2, v,33,18,8,41,74,0 days 00:00:00.159699
ionic-team/capacitor,2, v,18,6,3,138,156,0 days 00:00:00.272920
webdriverio/webdriverio,1,v,91,65,12,415,506,0 days 00:00:00.986266
openspug/spug,2,V v,8,3,3,34,42,0 days 00:00:00.074783
wix/react-native-calendars,2, v,1248,229,2,59,1307,0 days 00:00:02.073040
altair-viz/altair,2, v,13,3,7,8,21,0 days 00:00:00.351520
gogf/gf,1,v,14,2,4,106,120,0 days 00:00:00.341465
kelektiv/node-cron,2, v,12,2,8,23,35,0 days 00:00:00.036032
cryptomator/cryptomator,1,,18,7,6,73,91,0 days 00:00:00.252934
gotify/server,1,v,5,1,3,41,46,0 days 00:00:00.043778
oclif/oclif,1,v,59,50,5,261,320,0 days 00:00:00.281601
krallin/tini,1,v,19,6,6,14,33,0 days 00:00:00.027884
webpack/webpack-dev-server,1,v,42,25,9,70,112,0 days 00:00:00.161129
lanpa/tensorboardX,1,v,15,2,9,1,16,0 days 00:00:00.037407
facebook/jscodeshift,2, v,11,1,8,45,56,0 days 00:00:00.041563
LeetCode-OpenSource/vscode-leetcode,1,v,17,9,4,26,43,0 days 00:00:00.031382
lib/pq,1,v,11,3,5,10,21,0 days 00:00:00.056730
sosedoff/pgweb,1,v,11,6,3,31,42,0 days 00:00:00.069409
Supervisor/supervisor,1,,8,1,6,22,30,0 days 00:00:00.149305
sandboxie-plus/Sandboxie,2, v,11,3,4,58,69,0 days 00:00:00.104892
mopidy/mopidy,1,v,29,6,16,38,67,0 days 00:00:00.567043
cerebroapp/cerebro,2, v,5,1,3,16,21,0 days 00:00:00.047589
Sonarr/Sonarr,1,v,44,27,6,8,52,0 days 00:00:00.607990
numba/numba,2, v,54,9,8,51,105,0 days 00:00:01.823855
JeffreySu/WeiXinMPSDK,2, v,4,1,2,40,44,0 days 00:00:00.560971
winsw/winsw,1,v,21,6,12,10,31,0 days 00:00:00.055609
mamedev/mame,1,mame,124,89,11,0,124,0 days 00:00:05.367523
fideloper/TrustedProxy,1,,13,1,11,11,24,0 days 00:00:00.024110
davemorrissey/subsampling-scale-image-view,1,v,13,7,5,8,21,0 days 00:00:00.029155
facebook/litho,1,v,41,25,3,157,198,0 days 00:00:00.876335
i18next/react-i18next,2, v,84,68,6,164,248,0 days 00:00:00.209848
symfony/debug,1,v,16,2,13,354,370,0 days 00:00:00.398361
AlessandroZ/LaZagne,2, v,14,6,5,6,20,0 days 00:00:00.175003
FluentValidation/FluentValidation,1,,49,14,24,60,109,0 days 00:00:00.150045
be5invis/Sarasa-Gothic,1,v,25,12,8,93,118,0 days 00:00:00.061982
AppImage/AppImageKit,1,,13,4,8,0,13,0 days 00:00:00.121069
rocksdanister/lively,1,v,18,15,2,29,47,0 days 00:00:00.033688
xo/usql,1,v,10,4,5,22,32,0 days 00:00:00.043325
PointCloudLibrary/pcl,1,pcl-,13,2,8,12,25,0 days 00:00:01.004441
terkelg/prompts,1,v,9,2,4,24,33,0 days 00:00:00.026846
sebastianbergmann/php-timer,1,,7,1,3,19,26,0 days 00:00:00.031773
evilsocket/opensnitch,1,v,4,1,2,7,11,0 days 00:00:00.073319
qemu/qemu,2,v release_,48,2,42,86,134,0 days 00:00:08.055543
MichalLytek/type-graphql,1,v,19,13,1,18,37,0 days 00:00:00.052615
cjbassi/gotop,1,,9,5,1,24,33,0 days 00:00:00.037108
pennersr/django-allauth,1,,42,13,18,13,55,0 days 00:00:00.167697
smartystreets/goconvey,2, v,7,3,3,20,27,0 days 00:00:00.067190
styled-components/polished,2,v v.,22,12,6,56,78,0 days 00:00:00.074691
fancyapps/fancybox,3,V  v,5,1,3,30,35,0 days 00:00:00.034376
ngrx/platform,2, v,35,19,5,25,60,0 days 00:00:00.108135
pytube/pytube,2, v,31,18,9,78,109,0 days 00:00:00.102465
inorganik/countUp.js,2, v,13,3,8,26,39,0 days 00:00:00.038817
chrisvfritz/prerender-spa-plugin,2, v,10,4,3,1,11,0 days 00:00:00.018345
barteksc/AndroidPdfViewer,1,,14,8,2,8,22,0 days 00:00:00.016714
graphql-python/graphene,2,v v.,16,7,5,29,45,0 days 00:00:00.099859
sveltejs/sapper,1,v,29,23,4,149,178,0 days 00:00:00.160689
angular/angularfire,2, v,11,2,5,28,39,0 days 00:00:00.072945
jpillora/chisel,2, v,8,2,4,21,29,0 days 00:00:00.024944
OWASP/Amass,2, v,37,25,6,123,160,0 days 00:00:00.150099
java-native-access/jna,2, v,26,3,18,32,58,0 days 00:00:00.357720
lz4/lz4,2,r v,18,11,2,11,29,0 days 00:00:00.141186
symfony/routing,1,v,26,4,21,441,467,0 days 00:00:00.710684
leeoniya/uPlot,1,,7,3,1,44,51,0 days 00:00:00.075881
es-shims/es5-shim,1,v,19,8,7,77,96,0 days 00:00:00.078916
kekingcn/kkFileView,2, v,5,1,2,5,10,0 days 00:00:00.027573
nopSolutions/nopCommerce,1,release-,29,20,8,6,35,0 days 00:00:00.914128
apache/cassandra,1,cassandra-,23,8,13,183,206,0 days 00:00:01.816064
sebastianbergmann/diff,1,,7,1,5,11,18,0 days 00:00:00.024823
pillarjs/path-to-regexp,2, v,24,9,11,28,52,0 days 00:00:00.035334
surmon-china/vue-quill-editor,1,v,6,2,2,21,27,0 days 00:00:00.018333
marionettejs/backbone.marionette,1,v,32,15,10,93,125,0 days 00:00:00.230870
metafizzy/flickity,1,v,10,3,6,24,34,0 days 00:00:00.041532
vercel/styled-jsx,2, v,15,5,8,78,93,0 days 00:00:00.050144
hrydgard/ppsspp,1,v,20,3,14,46,66,0 days 00:00:02.013436
laravel/tinker,1,v,9,3,4,17,26,0 days 00:00:00.025020
ljharb/qs,1,v,25,11,10,49,74,0 days 00:00:00.064164
AmruthPillai/Reactive-Resume,1,v,7,4,2,24,31,0 days 00:00:00.172546
google/android-classyshark,1,,15,9,3,0,15,0 days 00:00:00.039598
boto/boto3,1,,24,8,11,1045,1069,0 days 00:00:02.153571
yhirose/cpp-httplib,1,v,9,3,5,75,84,0 days 00:00:00.221413
jazzband/django-debug-toolbar,2, v,25,4,15,24,49,0 days 00:00:00.149034
Zettlr/Zettlr,3, v v.,28,14,6,49,77,0 days 00:00:00.423966
jemalloc/jemalloc,1,,22,4,14,24,46,0 days 00:00:00.181427
sebastianbergmann/php-file-iterator,1,,7,1,5,27,34,0 days 00:00:00.026979
phpmyadmin/phpmyadmin,2, RELEASE_,37,9,15,300,337,0 days 00:00:08.059893
symfony/css-selector,1,v,26,4,20,434,460,0 days 00:00:00.295908
gitkraken/vscode-gitlens,2, v,45,33,4,91,136,0 days 00:00:00.448787
raineorshine/npm-check-updates,2, v,56,34,11,194,250,0 days 00:00:00.195603
encode/starlette,1,,19,8,5,94,113,0 days 00:00:00.087885
mqttjs/MQTT.js,2, v,42,22,7,109,151,0 days 00:00:00.124840
symfony/process,1,v,26,4,21,450,476,0 days 00:00:00.424533
ThreeMammals/Ocelot,1,,31,19,6,110,141,0 days 00:00:00.129536
developit/microbundle,2, v,15,7,6,24,39,0 days 00:00:00.062621
deepstreamIO/deepstream.io,2, v,25,7,8,98,123,0 days 00:00:00.172577
DevinVinson/WordPress-Plugin-Boilerplate,1,,9,5,2,5,14,0 days 00:00:00.041115
TrinityCore/TrinityCore,1,TDB,74,41,22,6,80,0 days 00:00:03.145679
xmrig/xmrig,1,v,46,34,7,73,119,0 days 00:00:00.200418
FullHuman/purgecss,2, v,23,11,7,20,43,0 days 00:00:00.079513
wallabag/wallabag,1,,20,6,10,40,60,0 days 00:00:00.444144
reach/router,1,v,5,2,2,13,18,0 days 00:00:00.028830
final-form/react-final-form,2,v v.,23,16,3,47,70,0 days 00:00:00.057862
projectstorm/react-diagrams,2, v,16,6,6,23,39,0 days 00:00:00.060477
Turfjs/turf,2, v,23,15,5,65,88,0 days 00:00:00.425872
matthew-andrews/isomorphic-fetch,1,v,12,7,3,14,26,0 days 00:00:00.017822
reactjs/react-modal,1,v,19,7,6,91,110,0 days 00:00:00.062357
ffuf/ffuf,1,v,18,8,5,6,24,0 days 00:00:00.029257
readthedocs/readthedocs.org,1,,76,55,5,152,228,0 days 00:00:01.351178
symfony/var-dumper,1,v,20,4,15,355,375,0 days 00:00:00.286106
abel533/Mapper,1,,18,8,5,33,51,0 days 00:00:00.054054
cython/cython,1,,19,2,10,71,90,0 days 00:00:01.011357
trentm/node-bunyan,1,,33,18,7,81,114,0 days 00:00:00.073507
cosmtrek/air,1,v,5,1,2,18,23,0 days 00:00:00.023274
kennethreitz/records,1,v,5,3,1,6,11,0 days 00:00:00.029985
musescore/MuseScore,1,v,11,1,9,24,35,0 days 00:00:01.437787
verlok/vanilla-lazyload,2, v,81,56,15,77,158,0 days 00:00:00.132133
rr-debugger/rr,1,,28,9,14,6,34,0 days 00:00:00.524753
monero-project/monero,1,v,19,7,7,34,53,0 days 00:00:00.851291
taskflow/taskflow,1,v,13,3,8,1,14,0 days 00:00:00.103945
bigskysoftware/htmx,2, v,12,6,1,18,30,0 days 00:00:00.098460
Humanizr/Humanizer,3,V  v,16,8,5,49,65,0 days 00:00:00.183228
jsplumb/jsplumb,1,,28,5,18,188,216,0 days 00:00:00.889440
guess-js/guess,2, v,4,1,2,42,46,0 days 00:00:00.045386
brunch/brunch,1,,24,11,8,107,131,0 days 00:00:00.261901
microsoft/DeepSpeed,1,v,6,1,3,36,42,0 days 00:00:00.071259
reactiveui/ReactiveUI,2, v,41,24,6,181,222,0 days 00:00:00.812353
hashicorp/terraform-provider-aws,1,v,226,223,1,33,259,0 days 00:00:03.928623
olivere/elastic,1,v,8,1,6,317,325,0 days 00:00:00.349901
barry-ran/QtScrcpy,1,v,9,3,3,15,24,0 days 00:00:00.046503
monkeytypegame/monkeytype,1,v,16,6,1,111,127,0 days 00:00:00.566466
gobuffalo/buffalo,2, v,15,3,9,107,122,0 days 00:00:00.237234
filamentgroup/loadCSS,2, v,9,2,6,14,23,0 days 00:00:00.029345
transmission/transmission,1,,99,69,12,1,100,0 days 00:00:00.885945
ds300/patch-package,1,v,17,9,3,40,57,0 days 00:00:00.046487
DylanVann/react-native-fast-image,1,v,20,8,7,90,110,0 days 00:00:00.063126
ssssssss-team/spider-flow,1,v,5,3,1,6,11,0 days 00:00:00.031601
vercel/ncc,1,,31,21,4,46,77,0 days 00:00:00.054626
needim/noty,1,v,10,2,5,37,47,0 days 00:00:00.032289
ajenti/ajenti,2, v,5,2,2,123,128,0 days 00:00:00.237881
cssinjs/jss,2, v,60,41,8,86,146,0 days 00:00:00.144402
mongodb/mongo-go-driver,2, v,13,4,7,60,73,0 days 00:00:00.131644
Nuitka/Nuitka,1,,13,8,4,238,251,0 days 00:00:00.669529
twpayne/chezmoi,1,v,27,16,4,106,133,0 days 00:00:00.237694
microsoft/azuredatastudio,2, v,40,28,2,89,129,0 days 00:00:00.864856
alibaba/MNN,1,,13,9,3,36,49,0 days 00:00:00.087227
SigNoz/signoz,2, v,7,1,2,28,35,0 days 00:00:00.072546
cockpit-project/cockpit,2, v,314,303,8,1,315,0 days 00:00:01.419391
NLPchina/elasticsearch-sql,1,,46,21,13,144,190,0 days 00:00:00.118543
tgalal/yowsup,1,v,8,3,4,20,28,0 days 00:00:00.282936
SirVer/ultisnips,1,,11,2,7,0,11,0 days 00:00:00.090173
ActivityWatch/activitywatch,1,v,8,4,3,11,19,0 days 00:00:00.046369
Vincit/objection.js,1,,19,3,10,101,120,0 days 00:00:00.145296
kazupon/vue-i18n,1,v,64,37,7,83,147,0 days 00:00:00.242296
infracost/infracost,2, v,10,6,3,62,72,0 days 00:00:00.230145
lucas-clemente/quic-go,2,v v.,24,5,10,33,57,0 days 00:00:00.365055
jupyterhub/jupyterhub,1,,19,2,11,20,39,0 days 00:00:00.515890
juice-shop/juice-shop,2, v,91,67,8,101,192,0 days 00:00:01.161524
sindresorhus/fkill-cli,2, v,23,9,10,3,26,0 days 00:00:00.018734
kanboard/kanboard,1,v,3,1,1,71,74,0 days 00:00:00.230262
aheckmann/gm,2, v,31,13,12,35,66,0 days 00:00:00.058475
BoyceLig/Clash_Chinese_Patch,1,,7,1,3,57,64,0 days 00:00:00.028385
ElemeFE/v-charts,1,v,14,9,2,72,86,0 days 00:00:00.048900
schollz/howmanypeoplearearound,1,v,4,2,1,11,15,0 days 00:00:00.018058
sindresorhus/np,1,v,42,24,10,34,76,0 days 00:00:00.048761
Rob--W/cors-anywhere,2, v,3,1,1,18,21,0 days 00:00:00.018953
aws/aws-sdk-js,1,v,1089,1078,5,301,1390,0 days 00:00:02.564741
open-policy-agent/opa,1,v,40,22,6,80,120,0 days 00:00:00.352235
grpc/grpc-web,1,,7,4,2,9,16,0 days 00:00:00.066664
lcobucci/jwt,1,,11,3,6,34,45,0 days 00:00:00.203041
gregberge/loadable-components,1,v,30,19,6,35,65,0 days 00:00:00.049800
xojs/xo,1,v,43,24,8,43,86,0 days 00:00:00.059121
Laravel-Lang/lang,1,,20,12,6,174,194,0 days 00:00:00.393759
enquirer/enquirer,1,,6,2,3,27,33,0 days 00:00:00.041412
hugapi/hug,1,,18,11,5,44,62,0 days 00:00:00.145034
visgl/react-map-gl,2, v,22,10,9,143,165,0 days 00:00:00.131621
electron/fiddle,2, v,29,14,3,22,51,0 days 00:00:00.112810
jaredpalmer/tsdx,1,v,13,6,3,40,53,0 days 00:00:00.051967
wailsapp/wails,1,v,19,10,2,44,63,0 days 00:00:00.150144
Hacker0x01/react-datepicker,2, v,107,85,2,73,180,0 days 00:00:00.270296
wasabeef/glide-transformations,1,,9,3,5,10,19,0 days 00:00:00.021960
migueldeicaza/gui.cs,1,v,13,6,4,9,22,0 days 00:00:00.272142
flyway/flyway,1,flyway-,40,20,13,101,141,0 days 00:00:00.341149
Sylius/Sylius,1,v,30,4,16,151,181,0 days 00:00:02.020218
eclipse/che,1,,100,95,2,126,226,0 days 00:00:00.857688
josdejong/jsoneditor,1,v,71,48,11,125,196,0 days 00:00:00.151963
grpc/grpc-java,1,v,52,22,4,58,110,0 days 00:00:00.407698
QUANTAXIS/QUANTAXIS,2, V,15,4,5,44,59,0 days 00:00:00.488682
svgdotjs/svg.js,1,,50,38,8,48,98,0 days 00:00:00.111216
react-native-camera/react-native-camera,1,v,84,69,5,96,180,0 days 00:00:00.157552
snapappointments/bootstrap-select,2, v,13,3,7,52,65,0 days 00:00:00.113067
stylelint/stylelint,2, v,97,78,4,88,185,0 days 00:00:00.467084
mdbootstrap/material-design-for-bootstrap,1,,18,11,5,46,64,0 days 00:00:00.030974
addyosmani/critical,2, v,17,4,9,44,61,0 days 00:00:00.057602
sindresorhus/pageres,2, v,24,8,7,23,47,0 days 00:00:00.038829
TranslucentTB/TranslucentTB,1,,14,7,6,0,14,0 days 00:00:00.186680
meliorence/react-native-snap-carousel,2,V v,22,15,2,29,51,0 days 00:00:00.047884
iterative/dvc,1,,92,83,3,258,350,0 days 00:00:00.781053
pockethub/PocketHub,2, v,11,5,3,9,20,0 days 00:00:00.176290
lvgl/lvgl,2, v,26,10,7,20,46,0 days 00:00:00.442203
TarsCloud/Tars,2, v,15,7,4,32,47,0 days 00:00:00.082518
senchalabs/connect,1,,52,27,11,174,226,0 days 00:00:00.248203
FormidableLabs/victory,1,v,65,43,8,156,221,0 days 00:00:00.631238
jhen0409/react-native-debugger,1,v,12,3,7,74,86,0 days 00:00:00.181417
apidoc/apidoc,1,,27,7,10,19,46,0 days 00:00:00.058792
charmbracelet/glow,1,v,7,4,1,10,17,0 days 00:00:00.045027
Automattic/kue,2, v,10,2,7,47,57,0 days 00:00:00.084654
mswjs/msw,2, v,38,31,1,90,128,0 days 00:00:00.202331
BookStackApp/BookStack,3, v v.,36,10,9,113,149,0 days 00:00:00.396389
argoproj/argo-cd,1,v,25,9,4,115,140,0 days 00:00:00.330245
deepmind/sonnet,1,v,35,24,1,0,35,0 days 00:00:00.058142
vnotex/vnote,2, v,47,34,4,13,60,0 days 00:00:00.102219
botpress/botpress,2, v,88,76,4,234,322,0 days 00:00:01.008102
pinojs/pino,2, v,90,69,7,150,240,0 days 00:00:00.207723
catboost/catboost,3, v v.,25,7,3,57,82,0 days 00:00:01.367112
future-architect/vuls,1,v,19,4,6,64,83,0 days 00:00:00.089946
dingo/api,2, v,16,9,5,41,57,0 days 00:00:00.095968
Atmosphere-NX/Atmosphere,1,,18,7,6,48,66,0 days 00:00:00.208389
uncss/uncss,1,,9,2,5,9,18,0 days 00:00:00.042427
squizlabs/PHP_CodeSniffer,1,,19,5,12,51,70,0 days 00:00:00.413208
upx/upx,1,v,31,7,18,0,31,0 days 00:00:00.264814
FormidableLabs/spectacle,2, v,35,12,11,77,112,0 days 00:00:00.098811
reactjs/react-transition-group,1,v,19,9,7,19,38,0 days 00:00:00.041214
oblador/react-native-animatable,1,v,10,4,4,13,23,0 days 00:00:00.022912
r-spacex/SpaceX-API,2, v,15,9,3,8,23,0 days 00:00:00.126534
mongodb/node-mongodb-native,3,V v v.,25,4,18,387,412,0 days 00:00:00.806766
arasatasaygin/is.js,1,v,8,5,2,13,21,0 days 00:00:00.031055
acaudwell/Gource,1,gource-,20,5,11,0,20,0 days 00:00:00.060284
bulletphysics/bullet3,1,,18,5,9,6,24,0 days 00:00:00.525536
cheat/cheat,1,,18,10,4,67,85,0 days 00:00:00.103019
hackware1993/MagicIndicator,1,,8,4,2,5,13,0 days 00:00:00.022973
callstack/react-native-paper,2, v,53,40,5,61,114,0 days 00:00:00.127166
deployphp/deployer,1,v,20,6,9,47,67,0 days 00:00:00.225728
docmirror/dev-sidecar,2, v,7,3,2,16,23,0 days 00:00:00.123955
chimurai/http-proxy-middleware,1,v,26,19,6,30,56,0 days 00:00:00.038995
exceljs/exceljs,2, v,41,28,7,180,221,0 days 00:00:00.301293
crimx/ext-saladict,3,V  v,59,47,6,139,198,0 days 00:00:00.229960
direnv/direnv,2, v,33,8,16,42,75,0 days 00:00:00.075586
coredns/coredns,1,v,20,7,7,42,62,0 days 00:00:00.342891
phpDocumentor/ReflectionDocBlock,1,,14,4,8,24,38,0 days 00:00:00.068618
coleifer/peewee,1,,35,12,13,139,174,0 days 00:00:00.253745
javascript-obfuscator/javascript-obfuscator,1,,63,47,4,122,185,0 days 00:00:00.179493
rough-stuff/wired-elements,1,v,9,2,4,26,35,0 days 00:00:00.034993
boardgameio/boardgame.io,1,v,39,28,4,111,150,0 days 00:00:00.275071
ydataai/pandas-profiling,2,v v.,20,10,7,14,34,0 days 00:00:00.067086
aksonov/react-native-router-flux,2, v,13,3,6,34,47,0 days 00:00:00.090424
Gallopsled/pwntools,1,,26,5,8,35,61,0 days 00:00:00.248703
cure53/DOMPurify,2, v,12,3,8,68,80,0 days 00:00:00.189369
pyinstaller/pyinstaller,2, v,28,5,19,6,34,0 days 00:00:00.567207
didi/cube-ui,2, v,13,10,1,69,82,0 days 00:00:00.128574
react-dropzone/react-dropzone,2, v,55,34,12,120,175,0 days 00:00:00.096090
sinonjs/sinon,2, v,57,27,18,121,178,0 days 00:00:00.260919
ginuerzh/gost,2, v,21,11,7,11,32,0 days 00:00:00.044762
symfony/console,1,v,26,4,21,466,492,0 days 00:00:00.519443
helmetjs/helmet,1,v,51,23,8,34,85,0 days 00:00:00.073534
thumbor/thumbor,1,,61,33,14,178,239,0 days 00:00:00.205119
inversify/InversifyJS,2, v,25,15,7,22,47,0 days 00:00:00.097490
callstack/linaria,1,v,14,9,4,24,38,0 days 00:00:00.054639
mayswind/AriaNg,1,,9,1,6,14,23,0 days 00:00:00.040404
capnproto/capnproto,1,v,9,1,6,12,21,0 days 00:00:00.252750
paulmillr/chokidar,1,,28,10,14,70,98,0 days 00:00:00.200778
marmelab/gremlins.js,2, v,5,1,3,2,7,0 days 00:00:00.027700
dromara/Sa-Token,1,v,23,18,2,1,24,0 days 00:00:00.059257
didi/chameleon,2, v,4,1,1,19,23,0 days 00:00:00.075372
sonic-pi-net/sonic-pi,1,v,16,5,7,9,25,0 days 00:00:00.663209
phpDocumentor/TypeResolver,1,,14,2,9,18,32,0 days 00:00:00.034492
aws/chalice,1,,38,17,8,43,81,0 days 00:00:00.149643
fkhadra/react-toastify,1,v,33,16,8,60,93,0 days 00:00:00.096627
OWASP/owasp-mstg,2, v,5,1,3,7,12,0 days 00:00:00.549661
gka/chroma.js,2, v,9,3,5,26,35,0 days 00:00:00.158658
TuSimple/naive-ui,2, v,26,23,1,70,96,0 days 00:00:00.385683
PrefectHQ/prefect,1,,17,5,6,102,119,0 days 00:00:00.942332
antvis/G6,1,,9,2,3,64,73,0 days 00:00:00.277992
crawlab-team/crawlab,1,v,6,1,3,21,27,0 days 00:00:00.220859
webtorrent/webtorrent-desktop,1,v,25,18,5,13,38,0 days 00:00:00.143059
react-page/react-page,2, v,58,45,6,214,272,0 days 00:00:00.233716
heartexlabs/label-studio,2,v v.,14,4,2,24,38,0 days 00:00:00.197140
tinode/chat,1,v,6,1,4,45,51,0 days 00:00:00.174170
facebook/chisel,1,,10,1,6,3,13,0 days 00:00:00.034587
facebookresearch/ParlAI,2, v,10,5,2,10,20,0 days 00:00:00.227799
remarkjs/react-markdown,2, v,22,7,11,46,68,0 days 00:00:00.048356
encode/httpx,1,,23,10,4,47,70,0 days 00:00:00.088364
golang-migrate/migrate,1,v,24,7,7,25,49,0 days 00:00:00.163375
OpenRefine/OpenRefine,2, v,13,1,10,9,22,0 days 00:00:00.377045
tweepy/tweepy,2, v,40,17,15,4,44,0 days 00:00:00.199430
zerotier/ZeroTierOne,1,,15,4,6,68,83,0 days 00:00:00.348569
cert-manager/cert-manager,1,v,25,3,3,49,74,0 days 00:00:00.554447
GoogleChromeLabs/comlink,1,v,15,8,4,23,38,0 days 00:00:00.071645
Aircoookie/WLED,1,v,8,1,6,15,23,0 days 00:00:00.214495
coursera-dl/coursera-dl,1,,8,1,5,12,20,0 days 00:00:00.067905
mementum/backtrader,1,,7,2,1,132,139,0 days 00:00:00.154260
desandro/imagesloaded,1,v,11,3,5,27,38,0 days 00:00:00.034443
gregberge/svgr,1,v,36,29,4,19,55,0 days 00:00:00.057836
ultralytics/yolov3,1,v,12,6,4,0,12,0 days 00:00:00.133554
libretro/RetroArch,2, v,15,3,7,77,92,0 days 00:00:03.327439
mapeditor/tiled,1,v,27,3,20,56,83,0 days 00:00:00.369831
caprover/caprover,2,V v,12,6,5,17,29,0 days 00:00:00.083261
pyodide/pyodide,2, v,20,11,6,25,45,0 days 00:00:00.128635
cefsharp/CefSharp,1,v,27,5,11,70,97,0 days 00:00:00.417506
piskelapp/piskel,1,v,14,2,9,16,30,0 days 00:00:00.103412
microsoft/Windows-universal-samples,2, v,438,13,9,171,609,0 days 00:00:00.533214
cyrus-and/gdb-dashboard,1,v,15,6,8,15,30,0 days 00:00:00.033186
openframeworks/openFrameworks,1,,10,1,6,16,26,0 days 00:00:01.110608
questdb/questdb,2, v,12,1,8,39,51,0 days 00:00:00.314787
tweenjs/tween.js,3,r  v,30,12,12,23,53,0 days 00:00:00.062697
spotDL/spotify-downloader,1,v,14,4,4,38,52,0 days 00:00:00.088145
mailpile/Mailpile,1,,5,1,2,6,11,0 days 00:00:00.353440
EpistasisLab/tpot,2, v,9,1,5,15,24,0 days 00:00:00.131205
Automattic/node-canvas,2, v,30,11,13,88,118,0 days 00:00:00.139032
aws/serverless-application-model,2, v,42,25,6,9,51,0 days 00:00:00.075612
claudiodangelis/qrcp,1,,6,2,3,17,23,0 days 00:00:00.025847
doctrine/dbal,2, v,18,2,14,79,97,0 days 00:00:00.774288
XTLS/Xray-core,1,v,6,3,1,21,27,0 days 00:00:00.032821
google/go-github,1,v,59,43,6,35,94,0 days 00:00:00.129731
muesli/duf,1,v,8,5,2,4,12,0 days 00:00:00.020253
Justson/AgentWeb,2, v,4,1,1,13,17,0 days 00:00:00.047058
pytest-dev/pytest,1,,42,10,17,122,164,0 days 00:00:01.076552
pmndrs/jotai,1,v,24,17,1,88,112,0 days 00:00:00.080843
nextapps-de/flexsearch,1,,4,2,1,13,17,0 days 00:00:00.023375
jprichardson/node-fs-extra,2, v,43,18,12,42,85,0 days 00:00:00.083174
Shopify/sarama,1,v,34,10,15,18,52,0 days 00:00:00.180918
shipshapecode/tether,1,v,13,6,4,60,73,0 days 00:00:00.084677
welldone-software/why-did-you-render,2,v v.,19,8,6,67,86,0 days 00:00:00.046931
listen1/listen1_chrome_extension,1,v,32,22,7,36,68,0 days 00:00:00.048193
MarshallOfSound/Google-Play-Music-Desktop-Player-UNOFFICIAL-,2, v,26,17,3,32,58,0 days 00:00:00.098358
wkentaro/labelme,1,v,50,38,9,125,175,0 days 00:00:00.142774
gskinner/regexr,1,,5,2,1,6,11,0 days 00:00:00.026599
tsayen/dom-to-image,1,,13,7,3,23,36,0 days 00:00:00.030604
blevesearch/bleve,1,v,14,3,7,27,41,0 days 00:00:00.165659
restsharp/RestSharp,2, v,30,14,11,29,59,0 days 00:00:00.227421
chakra-core/ChakraCore,1,v,9,1,3,52,61,0 days 00:00:00.972127
nilaoda/N_m3u8DL-CLI,1,,18,9,3,65,83,0 days 00:00:00.042574
James-Yu/LaTeX-Workshop,1,v,89,74,1,126,215,0 days 00:00:00.330300
OnsenUI/OnsenUI,1,,20,6,8,68,88,0 days 00:00:00.714762
cesanta/mongoose,1,,43,12,22,1,44,0 days 00:00:00.194037
node-schedule/node-schedule,2, v,10,3,5,36,46,0 days 00:00:00.039476
jwtk/jjwt,1,,11,4,6,15,26,0 days 00:00:00.048859
nodejs/node-gyp,2, v,37,7,18,98,135,0 days 00:00:00.225462
giampaolo/psutil,1,release-,32,8,17,52,84,0 days 00:00:00.438563
KurtBestor/Hitomi-Downloader,1,v,17,3,8,0,17,0 days 00:00:00.018808
rq/rq,2, v,24,2,15,44,68,0 days 00:00:00.107485
projectdiscovery/nuclei,2,v v.,10,2,6,43,53,0 days 00:00:00.186578
junit-team/junit4,1,r,8,1,6,5,13,0 days 00:00:00.153086
cytoscape/cytoscape.js,1,v,29,10,13,198,227,0 days 00:00:00.551156
HabitRPG/habitica,2, v,351,348,2,612,963,0 days 00:00:02.677757
MonoGame/MonoGame,2, v,12,1,9,4,16,0 days 00:00:00.874844
panjf2000/ants,1,v,9,4,4,15,24,0 days 00:00:00.041702
Nozbe/WatermelonDB,1,v,19,5,6,17,36,0 days 00:00:00.228110
sebastianbergmann/php-code-coverage,1,,23,4,13,138,161,0 days 00:00:00.173245
chocolatey/choco,1,,5,1,2,38,43,0 days 00:00:00.192777
myclabs/DeepCopy,1,,12,1,10,18,30,0 days 00:00:00.023144
uber/react-vis,2, v,22,14,3,77,99,0 days 00:00:00.090256
borgbackup/borg,1,,22,13,5,36,58,0 days 00:00:00.478105
dat-ecosystem-archive/dat,1,v,43,31,8,64,107,0 days 00:00:00.145665
agenda/agenda,2, v,20,5,11,65,85,0 days 00:00:00.162916
libgit2/libgit2,1,v,29,7,16,48,77,0 days 00:00:01.118497
benoitc/gunicorn,1,,31,12,14,51,82,0 days 00:00:00.254842
protobufjs/protobuf.js,2, v,23,11,6,55,78,0 days 00:00:00.086155
coil-kt/coil,1,,15,5,6,12,27,0 days 00:00:00.074203
square/moshi,1,moshi-parent-,15,1,12,4,19,0 days 00:00:00.175538
stanfordnlp/CoreNLP,1,v,11,5,3,12,23,0 days 00:00:00.979851
MahApps/MahApps.Metro,1,,21,5,11,33,54,0 days 00:00:00.432760
vector-im/element-web,1,v,27,9,9,172,199,0 days 00:00:00.779733
jopohl/urh,1,v,17,8,7,74,91,0 days 00:00:00.175389
pre-commit/pre-commit,1,v,60,32,9,111,171,0 days 00:00:00.185924
NG-ZORRO/ng-zorro-antd,1,,41,30,5,65,106,0 days 00:00:00.154882
devhubapp/devhub,2, v,55,47,3,61,116,0 days 00:00:00.204224
bloomrpc/bloomrpc,2, v,6,2,3,9,15,0 days 00:00:00.018196
tidwall/tile38,1,,27,6,7,59,86,0 days 00:00:00.094684
lima-vm/lima,1,v,11,6,1,16,27,0 days 00:00:00.079070
googleapis/google-api-php-client,2, v,13,2,8,32,45,0 days 00:00:00.097992
hediet/vscode-drawio,1,v,10,6,2,13,23,0 days 00:00:00.030994
ninja-build/ninja,2,release- v,14,1,10,12,26,0 days 00:00:00.184989
OpenFeign/feign,3,release-  v,72,48,10,54,126,0 days 00:00:00.114449
olivernn/lunr.js,1,v,12,1,6,46,58,0 days 00:00:00.046844
knadh/listmonk,1,v,4,1,2,0,4,0 days 00:00:00.061088
resilience4j/resilience4j,3, v v.,22,5,9,15,37,0 days 00:00:00.087566
symfony/event-dispatcher,1,v,26,4,21,436,462,0 days 00:00:00.317093
google/or-tools,1,v,32,7,8,3,35,0 days 00:00:00.593244
paragonie/random_compat,2, v,7,3,1,54,61,0 days 00:00:00.040059
dropwizard/dropwizard,1,v,15,1,11,119,134,0 days 00:00:00.612842
happyfish100/fastdfs,1,V,16,7,5,0,16,0 days 00:00:00.023265
apache/tvm,1,v,7,1,5,1,8,0 days 00:00:00.521244
electron/electron-packager,1,v,53,30,10,42,95,0 days 00:00:00.089544
symfony/http-foundation,1,v,26,4,21,464,490,0 days 00:00:00.731074
rofl0r/proxychains-ng,1,v,16,3,10,1,17,0 days 00:00:00.029765
PaddlePaddle/PaddleHub,2, v,12,3,1,10,22,0 days 00:00:00.227040
OpenIMSDK/Open-IM-Server,1,v,3,1,1,15,18,0 days 00:00:00.106015
shwenzhang/AndResGuard,1,,3,1,1,35,38,0 days 00:00:00.041011
Koenkk/zigbee2mqtt,1,,28,16,5,33,61,0 days 00:00:00.319856
VulcanJS/Vulcan,2, v,22,11,6,45,67,0 days 00:00:00.516264
sockjs/sockjs-client,1,v,11,1,7,20,31,0 days 00:00:00.062681
Stuk/jszip,1,v,19,5,11,14,33,0 days 00:00:00.053936
dotnet/machinelearning,1,v,18,12,4,5,23,0 days 00:00:00.186372
szimek/signature_pad,1,v,11,3,4,19,30,0 days 00:00:00.031190
sahat/satellizer,1,,14,7,4,41,55,0 days 00:00:00.120312
symfony/finder,1,v,26,4,20,440,466,0 days 00:00:00.333139
ag-grid/ag-grid,2, v,87,62,5,103,190,0 days 00:00:01.735695
ng-bootstrap/ng-bootstrap,1,,27,12,6,49,76,0 days 00:00:00.247413
airbnb/epoxy,1,,41,26,5,22,63,0 days 00:00:00.045632
smicallef/spiderfoot,1,v,8,1,6,1,9,0 days 00:00:00.234102
arrow-py/arrow,1,,17,3,11,37,54,0 days 00:00:00.100686
adrai/flowchart.js,1,v,17,4,9,31,48,0 days 00:00:00.027987
Jguer/yay,1,v,49,33,9,26,75,0 days 00:00:00.134266
pypa/pip,1,,36,2,27,73,109,0 days 00:00:00.960606
Pikaday/Pikaday,1,,9,1,7,6,15,0 days 00:00:00.035653
ChrisRM/material-theme-jetbrains,2, v,83,68,2,163,246,0 days 00:00:00.427175
grommet/grommet,2, v,41,18,8,76,117,0 days 00:00:00.442250
doitsujin/dxvk,1,v,40,30,5,32,72,0 days 00:00:00.265931
tiangolo/typer,1,,4,1,1,15,19,0 days 00:00:00.028700
mediaelement/mediaelement,1,,32,8,12,117,149,0 days 00:00:00.280305
mjmlio/mjml,3, v V,25,8,11,50,75,0 days 00:00:00.274451
firefly-iii/firefly-iii,1,,41,19,8,201,242,0 days 00:00:01.087509
abpframework/abp,2, v,43,33,3,60,103,0 days 00:00:01.619870
wtfutil/wtf,2, v,41,26,1,26,67,0 days 00:00:00.176723
huggingface/datasets,1,,26,21,1,26,52,0 days 00:00:00.196150
videolan/vlc,1,,9,1,3,50,59,0 days 00:00:04.869548
justauth/JustAuth,3, v v.,14,9,2,25,39,0 days 00:00:00.050106
zalmoxisus/redux-devtools-extension,2, v,27,23,2,43,70,0 days 00:00:00.081090
d2l-ai/d2l-en,1,v,8,1,4,17,25,0 days 00:00:00.258844
grpc-ecosystem/grpc-gateway,1,v,28,10,10,43,71,0 days 00:00:00.128176
automerge/automerge,1,v,13,4,6,20,33,0 days 00:00:00.053768
google/cadvisor,2, v,45,20,15,71,116,0 days 00:00:00.243907
Tencent/APIJSON,1,,37,21,7,51,88,0 days 00:00:00.171620
JustArchiNET/ArchiSteamFarm,1,,167,154,10,431,598,0 days 00:00:01.063034
orhanobut/logger,2, v,13,7,3,1,14,0 days 00:00:00.018660
verdaccio/verdaccio,1,v,64,34,13,148,212,0 days 00:00:00.370596
openshift/origin,1,v,14,2,10,25,39,0 days 00:00:02.416366
powerline/powerline,1,,13,3,7,10,23,0 days 00:00:00.297501
android-hacker/VirtualXposed,2, v,12,3,3,55,67,0 days 00:00:00.139900
fabric/fabric,1,,26,4,19,97,123,0 days 00:00:00.393943
liabru/matter-js,1,,10,1,7,8,18,0 days 00:00:00.051225
keybase/client,2, v,29,21,4,65,94,0 days 00:00:02.258388
authelia/authelia,1,v,55,39,5,114,169,0 days 00:00:00.231350
microsoft/AirSim,2,v v.,3,1,1,15,18,0 days 00:00:00.099910
RaRe-Technologies/gensim,1,,23,6,11,36,59,0 days 00:00:00.272550
microsoft/recommenders,1,,9,3,3,2,11,0 days 00:00:00.535197
qutebrowser/qutebrowser,1,v,32,4,16,49,81,0 days 00:00:01.644245
getgrav/grav,1,,13,3,8,170,183,0 days 00:00:00.667166
ahmetb/kubectx,1,v,9,2,5,11,20,0 days 00:00:00.027309
flipped-aurora/gin-vue-admin,3,V v v.,7,2,2,21,28,0 days 00:00:00.286152
brix/crypto-js,2, release-,4,2,1,10,14,0 days 00:00:00.023311
modood/Administrative-divisions-of-China,1,,9,1,7,7,16,0 days 00:00:00.018268
txthinking/brook,1,v,43,22,6,0,43,0 days 00:00:00.057784
mdx-js/mdx,2, v,26,19,5,140,166,0 days 00:00:00.184914
remotion-dev/remotion,1,v,14,8,1,81,95,0 days 00:00:00.418622
python/mypy,1,v,59,38,8,7,66,0 days 00:00:00.679047
timescale/timescaledb,1,,28,8,8,33,61,0 days 00:00:00.550073
bcicen/ctop,2, v,5,2,2,11,16,0 days 00:00:00.039705
xtaci/kcptun,2, v,106,79,7,0,106,0 days 00:00:00.073831
termux/termux-app,1,v,89,73,7,0,89,0 days 00:00:00.110401
WerWolv/ImHex,1,v,19,14,2,12,31,0 days 00:00:00.081436
selectize/selectize.js,1,v,12,5,2,64,76,0 days 00:00:00.081017
gionkunz/chartist-js,1,v,11,6,4,47,58,0 days 00:00:00.057465
http-party/node-http-proxy,2, v,27,11,13,70,97,0 days 00:00:00.089346
xtermjs/xterm.js,1,,76,52,7,35,111,0 days 00:00:00.533828
filp/whoops,1,,18,6,8,50,68,0 days 00:00:00.074258
redwoodjs/redwood,2, v,57,53,1,71,128,0 days 00:00:00.528619
mockito/mockito,1,v,58,32,10,409,467,0 days 00:00:00.599152
arduino/Arduino,1,,26,5,13,46,72,0 days 00:00:00.379134
DIYgod/DPlayer,2, v,21,12,5,21,42,0 days 00:00:00.071521
you-dont-need/You-Dont-Need-Momentjs,1,v,6,3,2,5,11,0 days 00:00:00.021698
GoogleContainerTools/skaffold,1,v,80,76,1,29,109,0 days 00:00:00.617242
wechaty/wechaty,1,v,15,4,7,8,23,0 days 00:00:00.471600
rwaldron/johnny-five,2, v,14,3,7,73,87,0 days 00:00:00.168579
faressoft/terminalizer,1,v,6,3,1,25,31,0 days 00:00:00.021702
umijs/qiankun,1,v,14,4,7,92,106,0 days 00:00:00.069198
Intervention/image,1,,15,3,8,93,108,0 days 00:00:00.069695
CachetHQ/Cachet,1,v,7,1,2,30,37,0 days 00:00:00.365726
redux-form/redux-form,1,v,46,30,8,141,187,0 days 00:00:00.157952
Semantic-Org/Semantic-UI-React,1,v,93,78,5,211,304,0 days 00:00:00.528181
charmbracelet/bubbletea,1,v,20,14,4,27,47,0 days 00:00:00.048256
google/gvisor,1,release-,99,94,2,0,99,0 days 00:00:00.544264
onnx/onnx,1,v,13,1,10,9,22,0 days 00:00:00.126041
Budibase/budibase,1,v,10,5,3,479,489,0 days 00:00:01.666616
revel/revel,1,v,18,4,10,7,25,0 days 00:00:00.199471
psf/requests-html,1,v,8,6,1,22,30,0 days 00:00:00.033893
moment/luxon,1,,37,21,6,69,106,0 days 00:00:00.084132
pqina/filepond,1,,52,41,4,143,195,0 days 00:00:00.103311
showdownjs/showdown,2, v,14,3,7,42,56,0 days 00:00:00.141984
scylladb/scylla,1,scylla-,33,11,10,130,163,0 days 00:00:02.555437
horovod/horovod,1,v,16,3,10,53,69,0 days 00:00:00.099705
bvaughn/react-window,1,,4,2,1,16,20,0 days 00:00:00.033224
Foundry376/Mailspring,1,,11,1,6,43,54,0 days 00:00:00.657858
openstf/stf,1,v,12,4,7,16,28,0 days 00:00:00.124265
thephpleague/flysystem,1,,13,2,6,175,188,0 days 00:00:00.183277
OptimalBits/bull,2, v,49,26,13,84,133,0 days 00:00:00.160187
surmon-china/vue-awesome-swiper,2, v,14,5,5,36,50,0 days 00:00:00.033874
uuidjs/uuid,1,v,16,6,8,21,37,0 days 00:00:00.042178
barryvdh/laravel-ide-helper,1,v,25,8,15,61,86,0 days 00:00:00.071087
danilowoz/react-content-loader,2, v,16,6,8,27,43,0 days 00:00:00.033127
pyecharts/pyecharts,1,v,14,4,6,29,43,0 days 00:00:00.157182
liriliri/eruda,1,v,15,6,5,40,55,0 days 00:00:00.053420
MaterialDesignInXAML/MaterialDesignInXamlToolkit,2, v,21,5,12,12,33,0 days 00:00:00.148078
wkhtmltopdf/wkhtmltopdf,1,,8,4,3,31,39,0 days 00:00:00.068053
gaearon/react-hot-loader,2, v,25,13,6,107,132,0 days 00:00:00.144291
11ty/eleventy,1,v,13,2,7,41,54,0 days 00:00:00.115982
aquasecurity/trivy,1,v,28,19,2,59,87,0 days 00:00:00.081674
josdejong/mathjs,1,v,109,83,4,118,227,0 days 00:00:00.364477
visionmedia/supertest,2, v,29,8,13,29,58,0 days 00:00:00.045077
tensorflow/tensor2tensor,3, v v.,15,5,4,61,76,0 days 00:00:00.319595
oliver-moran/jimp,2, v,15,8,4,71,86,0 days 00:00:00.071376
lra/mackup,1,,8,4,3,53,61,0 days 00:00:00.126432
systemjs/systemjs,2, v,40,18,10,187,227,0 days 00:00:00.282211
tabler/tabler-icons,1,v,69,65,2,15,84,0 days 00:00:00.087867
rt2zz/redux-persist,1,v,36,27,6,76,112,0 days 00:00:00.231095
foambubble/foam,1,v,17,10,3,44,61,0 days 00:00:00.067400
casbin/casbin,1,v,68,52,5,118,186,0 days 00:00:00.201658
Delgan/loguru,1,,6,1,4,12,18,0 days 00:00:00.039663
arut/nginx-rtmp-module,1,v,12,5,3,100,112,0 days 00:00:00.095448
carloscuesta/gitmoji,1,v,13,5,2,5,18,0 days 00:00:00.047329
react-dates/react-dates,1,v,78,74,1,81,159,0 days 00:00:00.122659
webpack-contrib/webpack-bundle-analyzer,1,v,32,19,8,34,66,0 days 00:00:00.053091
Miserlou/Zappa,2, v,50,42,3,71,121,0 days 00:00:00.198541
http-party/http-server,2, v,15,2,10,30,45,0 days 00:00:00.053251
mlflow/mlflow,2, v,35,21,1,20,55,0 days 00:00:00.299213
jaredreich/pell,1,v,6,4,1,6,12,0 days 00:00:00.016002
roots/sage,2, v,27,10,12,35,62,0 days 00:00:00.161274
aurelia/framework,1,,23,16,5,32,55,0 days 00:00:00.063356
FaridSafi/react-native-gifted-chat,2, v,16,6,7,46,62,0 days 00:00:00.081616
Tamsiree/RxTool,2, v,15,7,4,177,192,0 days 00:00:00.134313
NodeBB/NodeBB,1,v,30,2,17,93,123,0 days 00:00:01.398699
ramsey/uuid,1,,26,6,14,37,63,0 days 00:00:00.079844
Tonejs/Tone.js,2, r,12,1,8,4,16,0 days 00:00:00.232538
karma-runner/karma,2, v,35,14,12,198,233,0 days 00:00:00.227637
keycloak/keycloak,1,,16,3,7,21,37,0 days 00:00:01.102561
ben-manes/caffeine,2, v,16,4,7,45,61,0 days 00:00:00.093710
segmentio/evergreen,1,v,51,39,2,84,135,0 days 00:00:00.108071
emirpasic/gods,1,v,19,14,3,6,25,0 days 00:00:00.120917
flairNLP/flair,1,v,11,1,6,12,23,0 days 00:00:00.247624
freebsd/freebsd-src,1,release/,62,3,58,16,78,0 days 00:00:20.933278
ranger/ranger,1,v,10,1,8,31,41,0 days 00:00:00.241824
AdguardTeam/AdGuardHome,1,v,19,6,4,31,50,0 days 00:00:00.297170
PuerkitoBio/goquery,1,v,12,1,8,10,22,0 days 00:00:00.028124
OpenAPITools/openapi-generator,2, v,16,2,11,38,54,0 days 00:00:01.241992
mikepenz/MaterialDrawer,1,v,35,19,8,166,201,0 days 00:00:00.305805
LuckSiege/PictureSelector,2,v v.,12,6,5,91,103,0 days 00:00:00.195837
QL-Win/QuickLook,2, v,4,1,1,38,42,0 days 00:00:00.053816
NetEase/pomelo,2, v,9,1,4,84,93,0 days 00:00:00.207685
go-chi/chi,1,v,12,1,5,27,39,0 days 00:00:00.050995
microsoft/nni,1,v,27,9,2,16,43,0 days 00:00:00.208290
apexcharts/apexcharts.js,2, v,32,15,3,54,86,0 days 00:00:00.142153
koekeishiya/yabai,1,v,12,5,1,34,46,0 days 00:00:00.069500
rjsf-team/react-jsonschema-form,1,v,71,56,6,52,123,0 days 00:00:00.109054
thingsboard/thingsboard,1,v,15,2,7,33,48,0 days 00:00:00.617967
sindresorhus/got,1,v,70,49,11,71,141,0 days 00:00:00.125214
mifi/lossless-cut,1,v,70,52,9,67,137,0 days 00:00:00.132891
meolu/walle-web,1,v,13,8,1,6,19,0 days 00:00:00.070050
netchx/netch,2, v,6,1,3,47,53,0 days 00:00:00.119417
spicetify/spicetify-cli,2,v v.,23,14,5,52,75,0 days 00:00:00.159610
d2-projects/d2-admin,2, v,25,17,4,62,87,0 days 00:00:00.203361
apache/druid,1,druid-,18,1,13,366,384,0 days 00:00:00.935320
hotwired/stimulus,1,v,12,5,4,14,26,0 days 00:00:00.067195
rizinorg/cutter,1,v,14,6,5,16,30,0 days 00:00:00.135673
nock/nock,2, v,125,108,13,181,306,0 days 00:00:00.288787
nexe/nexe,1,v,5,2,1,14,19,0 days 00:00:00.047693
bettercap/bettercap,1,v,33,23,5,10,43,0 days 00:00:00.125710
java-decompiler/jd-gui,1,v,7,5,1,11,18,0 days 00:00:00.023989
graphile/postgraphile,1,v,35,20,7,60,95,0 days 00:00:00.164764
cloudwu/skynet,1,v,15,7,6,18,33,0 days 00:00:00.133852
wenzhixin/bootstrap-table,1,,18,3,9,39,57,0 days 00:00:00.240186
conventional-changelog/commitlint,1,v,47,28,10,89,136,0 days 00:00:00.169720
searx/searx,2, v,14,1,12,3,17,0 days 00:00:00.241830
slimphp/Slim,1,,40,11,21,55,95,0 days 00:00:00.297765
pagehelper/Mybatis-PageHelper,1,v,18,9,6,42,60,0 days 00:00:00.047581
antvis/G2,2, v,13,2,8,144,157,0 days 00:00:00.261426
single-spa/single-spa,2, v,29,15,10,85,114,0 days 00:00:00.074826
PHPOffice/PhpSpreadsheet,1,,24,6,7,10,34,0 days 00:00:00.225513
kubernetes/dashboard,1,v,15,1,10,20,35,0 days 00:00:00.341756
ccampbell/mousetrap,1,,7,1,5,21,28,0 days 00:00:00.032458
video-dev/hls.js,1,v,16,2,9,185,201,0 days 00:00:00.610900
google/brotli,1,v,6,1,4,10,16,0 days 00:00:00.066523
micro/micro,2, v,62,46,2,37,99,0 days 00:00:00.381536
nightwatchjs/nightwatch,1,v,16,1,9,207,223,0 days 00:00:00.304043
argoproj/argo-workflows,2, v,23,7,9,102,125,0 days 00:00:00.432602
mail-in-a-box/mailinabox,1,v,45,16,11,0,45,0 days 00:00:00.122174
davisking/dlib,1,v,55,14,13,0,55,0 days 00:00:00.502120
RPCS3/rpcs3,1,v,5,1,3,21,26,0 days 00:00:00.779240
ajv-validator/ajv,2, v,71,54,6,89,160,0 days 00:00:00.191497
SFTtech/openage,1,v,5,2,2,4,9,0 days 00:00:00.194764
allenai/allennlp,2, v,24,7,5,23,47,0 days 00:00:00.182067
FriendsOfPHP/PHP-CS-Fixer,1,v,48,26,14,148,196,0 days 00:00:00.692428
jquery/jquery-ui,1,,8,1,6,38,46,0 days 00:00:00.467666
keeweb/keeweb,1,v,25,10,9,103,128,0 days 00:00:00.327123
baidu/amis,1,,9,5,2,37,46,0 days 00:00:00.402079
tomnomnom/gron,2, v,7,2,2,27,34,0 days 00:00:00.020693
stylus/stylus,1,,53,34,11,115,168,0 days 00:00:00.271160
WickyNilliams/headroom.js,1,v,9,1,5,8,17,0 days 00:00:00.023368
jonas/tig,1,tig-,27,6,19,22,49,0 days 00:00:00.157036
ent/ent,1,v,10,3,4,21,31,0 days 00:00:00.109624
containrrr/watchtower,1,v,8,1,5,24,32,0 days 00:00:00.161916
nats-io/nats-server,1,v,17,2,12,49,66,0 days 00:00:00.489808
doctrine/inflector,2, v,6,1,4,10,16,0 days 00:00:00.037286
dgraph-io/badger,1,v,14,6,7,20,34,0 days 00:00:00.234819
mobile-shell/mosh,1,mosh-,4,2,1,10,14,0 days 00:00:00.072424
containerd/containerd,2, v,9,1,7,76,85,0 days 00:00:01.162583
SpartnerNL/Laravel-Excel,2, v,11,3,6,143,154,0 days 00:00:00.132257
GoogleChrome/workbox,1,v,24,10,7,38,62,0 days 00:00:00.105102
Kotlin/kotlinx.coroutines,1,,24,11,6,38,62,0 days 00:00:00.162386
lokesh/color-thief,2, v,5,1,2,6,11,0 days 00:00:00.020988
javve/list.js,2, v,11,4,5,10,21,0 days 00:00:00.050570
beetbox/beets,1,v,6,1,4,30,36,0 days 00:00:00.634612
summernote/summernote,1,v,8,2,2,52,60,0 days 00:00:00.183621
browserslist/browserslist,1,,49,24,11,119,168,0 days 00:00:00.116342
wbkd/react-flow,2, v,56,52,2,118,174,0 days 00:00:00.315795
fengyuanchen/cropperjs,1,v,14,6,4,40,54,0 days 00:00:00.051183
apache/pulsar,1,v,14,1,10,37,51,0 days 00:00:00.736652
jxnblk/mdx-deck,1,v,21,16,2,91,112,0 days 00:00:00.114740
casesandberg/react-color,2, v,14,8,5,23,37,0 days 00:00:00.064139
Rapptz/discord.py,1,v,24,15,6,41,65,0 days 00:00:00.179167
lingochamp/FileDownloader,1,v,11,4,4,56,67,0 days 00:00:00.055963
networkx/networkx,1,networkx-,37,7,25,10,47,0 days 00:00:00.456200
downshift-js/downshift,1,v,49,38,4,179,228,0 days 00:00:00.124588
tymondesigns/jwt-auth,1,,6,3,2,29,35,0 days 00:00:00.090021
App-vNext/Polly,2, v,7,3,2,4,11,0 days 00:00:00.060991
mholt/PapaParse,1,,19,5,7,55,74,0 days 00:00:00.048944
polybar/polybar,1,,20,12,7,84,104,0 days 00:00:00.152744
ionic-team/stencil,1,v,53,40,2,189,242,0 days 00:00:00.432273
go-playground/validator,1,v,94,69,10,59,153,0 days 00:00:00.211331
star7th/showdoc,2, v,18,6,6,124,142,0 days 00:00:00.246974
spatie/laravel-permission,1,,87,61,11,71,158,0 days 00:00:00.226415
abseil/abseil-cpp,1,,17,5,9,0,17,0 days 00:00:00.077711
rqlite/rqlite,1,v,56,37,8,39,95,0 days 00:00:00.187801
PatrickJS/angular-starter,2, v,6,4,1,5,11,0 days 00:00:00.087253
restify/node-restify,2, v,44,27,13,96,140,0 days 00:00:00.144183
VSCodeVim/Vim,2, v,38,19,6,187,225,0 days 00:00:00.442868
akiran/react-slick,2, v,13,3,8,27,40,0 days 00:00:00.071052
swaywm/sway,1,,22,7,8,7,29,0 days 00:00:00.633744
GoogleContainerTools/kaniko,1,v,33,19,4,4,37,0 days 00:00:00.128743
peers/peerjs,2, v,6,1,4,30,36,0 days 00:00:00.063256
thanos-io/thanos,1,v,26,7,2,17,43,0 days 00:00:00.196759
dbcli/mycli,1,v,26,8,10,20,46,0 days 00:00:00.114407
dotnet/AspNetCore.Docs,1,,40,33,1,0,40,0 days 00:00:00.756192
dangrossman/daterangepicker,2, v,5,1,3,58,63,0 days 00:00:00.060938
dbcli/pgcli,2, v,39,16,10,47,86,0 days 00:00:00.257641
aws/aws-cli,1,,46,24,17,1642,1688,0 days 00:00:04.397735
luin/ioredis,2, v,54,33,11,132,186,0 days 00:00:00.133937
avwo/whistle,1,v,31,12,10,342,373,0 days 00:00:00.782297
tidwall/gjson,1,v,15,5,6,42,57,0 days 00:00:00.032444
TypeStrong/ts-node,1,v,52,29,9,83,135,0 days 00:00:00.104520
golangci/golangci-lint,1,v,47,31,1,63,110,0 days 00:00:00.143256
imakewebthings/waypoints,2, v,6,1,4,17,23,0 days 00:00:00.027143
jina-ai/clip-as-service,1,v,15,11,2,92,107,0 days 00:00:00.116958
styleguidist/react-styleguidist,2, v,47,30,7,215,262,0 days 00:00:00.208549
redis/redis-py,2, v,15,2,9,49,64,0 days 00:00:00.124291
okonet/lint-staged,2, v,44,23,7,145,189,0 days 00:00:00.110581
reactstrap/reactstrap,2, v,61,45,7,54,115,0 days 00:00:00.105454
snabbdom/snabbdom,1,v,14,3,6,33,47,0 days 00:00:00.064639
shipshapecode/shepherd,1,v,46,28,9,73,119,0 days 00:00:00.159491
lucidrains/vit-pytorch,1,,32,27,1,105,137,0 days 00:00:00.058492
netbox-community/netbox,2, v,24,6,13,173,197,0 days 00:00:00.650736
debug-js/debug,1,,22,7,8,47,69,0 days 00:00:00.047784
PrismJS/prism,2, v,29,8,11,11,40,0 days 00:00:00.298222
ansible/awx,1,,36,18,3,20,56,0 days 00:00:02.294698
pagekit/vue-resource,1,,12,5,4,41,53,0 days 00:00:00.039419
AppIntro/AppIntro,2, v,10,1,8,8,18,0 days 00:00:00.061950
plouc/nivo,1,v,67,56,7,45,112,0 days 00:00:00.134954
mailhog/MailHog,2, v,10,7,2,16,26,0 days 00:00:00.029314
jantimon/html-webpack-plugin,2, v,47,34,10,36,83,0 days 00:00:00.082202
vercel/micro,2, v,21,13,5,34,55,0 days 00:00:00.049400
cyclejs/cyclejs,1,v,32,27,1,50,82,0 days 00:00:00.056444
SpacehuhnTech/esp8266_deauther,3, v v.,10,5,3,3,13,0 days 00:00:00.048269
aspnetboilerplate/aspnetboilerplate,3, v v.,91,57,7,125,216,0 days 00:00:00.569431
react-static/react-static,1,v,28,20,5,162,190,0 days 00:00:00.165450
serbanghita/Mobile-Detect,1,,6,2,3,64,70,0 days 00:00:00.061430
clauderic/react-sortable-hoc,1,v,20,14,3,52,72,0 days 00:00:00.046094
git-lfs/git-lfs,2, v,29,3,19,60,89,0 days 00:00:00.614616
haltu/muuri,1,,9,1,5,14,23,0 days 00:00:00.039542
samuelcolvin/pydantic,2,V v,42,30,6,37,79,0 days 00:00:00.100109
ant-design/ant-design-mobile,2, v,28,19,4,107,135,0 days 00:00:00.572642
apple/darwin-xnu,1,xnu-,19,16,2,104,123,0 days 00:00:00.050464
spencermountain/compromise,2, v,70,45,12,148,218,0 days 00:00:00.480712
atomiks/tippyjs,2, v,27,20,5,65,92,0 days 00:00:00.095370
milvus-io/milvus,1,v,9,3,3,15,24,0 days 00:00:01.129844
tinygo-org/tinygo,1,v,23,9,3,4,27,0 days 00:00:00.169684
jacomyal/sigma.js,1,v,7,1,3,8,15,0 days 00:00:00.093928
qrohlf/trianglify,1,v,12,1,8,8,20,0 days 00:00:00.027544
typesense/typesense,2, v,16,5,5,8,24,0 days 00:00:00.093943
nhn/tui.calendar,1,v,21,13,3,42,63,0 days 00:00:00.130978
spotify/annoy,3, v v.,9,1,4,15,24,0 days 00:00:00.050439
h2o/h2o,1,v,12,3,2,32,44,0 days 00:00:00.256995
zricethezav/gitleaks,1,v,60,47,5,62,122,0 days 00:00:00.087663
Ciphey/Ciphey,2, v,18,15,1,8,26,0 days 00:00:00.133757
bitwarden/server,2, v,49,31,4,58,107,0 days 00:00:00.202189
FredrikNoren/ungit,2, v,16,9,6,126,142,0 days 00:00:00.342583
NaturalNode/natural,2, v,6,2,3,44,50,0 days 00:00:00.081774
w7corp/easywechat,1,,47,25,16,241,288,0 days 00:00:00.267054
kubernetes-sigs/kind,2, v,14,2,6,10,24,0 days 00:00:00.338779
coryhouse/react-slingshot,2, v,8,3,2,7,15,0 days 00:00:00.041265
socketio/socket.io-client,1,,28,2,16,97,125,0 days 00:00:00.152863
immerjs/immer,2, v,35,23,5,94,129,0 days 00:00:00.108551
HandBrake/HandBrake,1,,8,1,6,35,43,0 days 00:00:00.839482
visgl/deck.gl,2, v,32,8,11,250,282,0 days 00:00:00.514785
tj/commander.js,2, v,50,19,18,38,88,0 days 00:00:00.097240
squidfunk/mkdocs-material,1,,52,34,6,192,244,0 days 00:00:00.463848
jesseduffield/lazydocker,1,v,18,11,5,27,45,0 days 00:00:00.052109
doczjs/docz,1,v,19,13,5,66,85,0 days 00:00:00.116892
vega/vega,1,v,45,20,15,73,118,0 days 00:00:00.368100
dromara/hutool,1,,11,1,6,102,113,0 days 00:00:00.330681
alibaba/nacos,2, v,16,9,6,15,31,0 days 00:00:00.242394
labstack/echo,2, v,20,3,10,75,95,0 days 00:00:00.119733
halo-dev/halo,1,v,10,2,5,42,52,0 days 00:00:00.128977
dask/dask,1,,97,59,9,141,238,0 days 00:00:00.869728
frida/frida,1,,54,30,10,579,633,0 days 00:00:00.747296
pure-css/pure,1,v,9,1,7,14,23,0 days 00:00:00.053756
react-native-elements/react-native-elements,2, v,30,18,5,52,82,0 days 00:00:00.174314
vuejs/devtools,1,v,10,4,4,36,46,0 days 00:00:00.222069
dmlc/xgboost,2, v,21,1,14,12,33,0 days 00:00:00.487982
files-community/Files,1,v,23,18,4,38,61,0 days 00:00:00.198957
frappe/erpnext,2, v,153,136,7,763,916,0 days 00:00:04.126597
lovell/sharp,1,v,30,4,16,88,118,0 days 00:00:00.216894
t4t5/sweetalert,2, v,9,2,3,23,32,0 days 00:00:00.034214
redux-saga/redux-saga,2, v,18,9,5,40,58,0 days 00:00:00.116461
reduxjs/react-redux,1,v,26,17,6,59,85,0 days 00:00:00.094844
ovity/octotree,1,v,5,1,3,26,31,0 days 00:00:00.049841
seata/seata,3,V  v,15,6,3,18,33,0 days 00:00:00.167210
dimsemenov/PhotoSwipe,1,v,5,1,2,43,48,0 days 00:00:00.042419
sampotts/plyr,1,v,16,6,7,195,211,0 days 00:00:00.193185
python-pillow/Pillow,1,,39,1,35,35,74,0 days 00:00:01.066296
inconshreveable/ngrok,1,,20,18,1,1,21,0 days 00:00:00.028874
ramda/ramda,2, v,28,13,9,26,54,0 days 00:00:00.181518
facebook/draft-js,2, v,11,7,3,16,27,0 days 00:00:00.077430
github/hub,1,v,29,14,10,59,88,0 days 00:00:00.199758
feathericons/feather,1,v,39,28,3,12,51,0 days 00:00:00.046117
angular/components,1,,31,13,7,128,159,0 days 00:00:00.906770
fabricjs/fabric.js,2, v,34,10,14,69,103,0 days 00:00:00.268547
swagger-api/swagger-ui,3, v v/,69,51,10,189,258,0 days 00:00:00.382714
httpie/httpie,1,,19,2,12,28,47,0 days 00:00:00.103672
ehang-io/nps,3,V v v.,19,14,1,44,63,0 days 00:00:00.053108
bevacqua/dragula,2, v,18,14,1,49,67,0 days 00:00:00.044307
usablica/intro.js,2, v,29,5,13,12,41,0 days 00:00:00.082591
appwrite/appwrite,1,,13,1,3,30,43,0 days 00:00:00.812879
rook/rook,1,v,19,1,16,103,122,0 days 00:00:00.959607
bilibili/flv.js,1,v,7,1,4,8,15,0 days 00:00:00.037117
conwnet/github1s,1,v,7,4,1,19,26,0 days 00:00:00.032041
vercel/pkg,1,,15,7,5,42,57,0 days 00:00:00.181669
paularmstrong/normalizr,2, v,16,7,5,18,34,0 days 00:00:00.041872
qishibo/AnotherRedisDesktopManager,2, v,6,1,3,34,40,0 days 00:00:00.047186
chenglou/react-motion,1,v,5,1,2,19,24,0 days 00:00:00.060130
helm/helm,2, v,32,8,12,68,100,0 days 00:00:00.584192
mochajs/mocha,2, v,65,28,15,110,175,0 days 00:00:00.358599
jlmakes/scrollreveal,1,v,10,3,5,36,46,0 days 00:00:00.065102
openfaas/faas,2, v,18,9,7,110,128,0 days 00:00:00.399776
slidevjs/slidev,1,v,31,27,1,143,174,0 days 00:00:00.115145
docsifyjs/docsify,1,v,44,35,6,147,191,0 days 00:00:00.149393
sirupsen/logrus,2, v,20,6,8,35,55,0 days 00:00:00.081590
yeasy/docker_practice,1,v,13,1,9,0,13,0 days 00:00:00.077204
michalsnik/aos,2, v,11,4,4,24,35,0 days 00:00:00.023151
localForage/localForage,1,,19,10,7,43,62,0 days 00:00:00.096236
vuejs/vuepress,1,v,24,14,5,50,74,0 days 00:00:00.117828
react-bootstrap/react-bootstrap,2, v,44,24,10,108,152,0 days 00:00:00.410274
nicolargo/glances,1,v,22,2,15,70,92,0 days 00:00:00.292261
StevenBlack/hosts,2, v,24,10,7,405,429,0 days 00:00:00.423664
microsoft/cascadia-code,1,v,18,8,3,0,18,0 days 00:00:00.030838
postcss/autoprefixer,1,,53,27,14,133,186,0 days 00:00:00.227470
uglide/RedisDesktopManager,1,,33,19,4,38,71,0 days 00:00:00.127068
rollup/rollup,1,v,169,157,3,411,580,0 days 00:00:00.775664
homebridge/homebridge,2, v,6,1,4,51,57,0 days 00:00:00.094752
DrKLO/Telegram,1,release-,47,40,1,37,84,0 days 00:00:00.064348
python-poetry/poetry,1,,14,10,3,63,77,0 days 00:00:00.138961
eslint/eslint,1,v,164,153,3,103,267,0 days 00:00:00.586674
avajs/ava,1,v,54,37,4,23,77,0 days 00:00:00.137812
necolas/react-native-web,1,,17,6,7,242,259,0 days 00:00:00.203518
petkaantonov/bluebird,1,v,24,11,7,115,139,0 days 00:00:00.295872
guzzle/guzzle,2, v,37,16,14,96,133,0 days 00:00:01.432746
electron-react-boilerplate/electron-react-boilerplate,1,v,32,13,10,31,63,0 days 00:00:00.088155
open-mmlab/mmdetection,1,v,29,26,1,6,35,0 days 00:00:00.232205
Seldaek/monolog,1,,36,9,21,26,62,0 days 00:00:00.287970
schollz/croc,1,v,31,15,6,106,137,0 days 00:00:00.136631
mozilla/DeepSpeech,1,v,9,1,6,13,22,0 days 00:00:00.216473
js-cookie/js-cookie,1,v,10,1,7,13,23,0 days 00:00:00.055500
zyedidia/micro,1,v,6,1,3,22,28,0 days 00:00:00.149412
spf13/viper,1,v,13,2,8,13,26,0 days 00:00:00.041460
validatorjs/validator.js,2, v,107,79,8,43,150,0 days 00:00:00.307779
signalapp/Signal-Android,3, v v.,180,163,8,860,1040,0 days 00:00:01.856378
ShareX/ShareX,1,v,50,24,11,22,72,0 days 00:00:00.463255
benweet/stackedit,1,v,23,17,4,104,127,0 days 00:00:00.116751
felixrieseberg/windows95,1,v,11,4,5,3,14,0 days 00:00:00.022349
parse-community/parse-server,1,,34,15,12,111,145,0 days 00:00:00.264599
alibaba/Sentinel,2, v,8,2,3,16,24,0 days 00:00:00.058687
afollestad/material-dialogs,3, v v.,20,12,3,98,118,0 days 00:00:00.129344
codex-team/editor.js,2, v,11,3,5,16,27,0 days 00:00:00.064340
apache/skywalking,1,v,20,4,6,11,31,0 days 00:00:00.402909
streamlit/streamlit,2, v,83,79,1,46,129,0 days 00:00:00.535962
eligrey/FileSaver.js,2, v,3,1,1,12,15,0 days 00:00:00.031958
youzan/vant,1,v,33,13,6,377,410,0 days 00:00:00.735781
emberjs/ember.js,1,v,68,20,4,184,252,0 days 00:00:02.113538
marmelab/react-admin,1,v,46,32,4,168,214,0 days 00:00:00.978373
locustio/locust,2, v,27,9,10,56,83,0 days 00:00:00.260424
winstonjs/winston,2, v,24,6,13,62,86,0 days 00:00:00.102413
TeamNewPipe/NewPipe,2, v,17,3,10,100,117,0 days 00:00:00.734118
celery/celery,2, v,22,3,17,143,165,0 days 00:00:00.872301
taichi-dev/taichi,2, v,7,1,3,96,103,0 days 00:00:00.528371
segmentio/nightmare,1,,21,9,4,67,88,0 days 00:00:00.674717
zhongyang219/TrafficMonitor,1,V,18,8,6,4,22,0 days 00:00:00.050496
vuejs/vue-router,1,v,19,9,5,59,78,0 days 00:00:00.145450
osquery/osquery,2, v,39,13,12,80,119,0 days 00:00:00.417572
google/ExoPlayer,1,r,20,1,14,84,104,0 days 00:00:00.843970
reduxjs/reselect,1,v,11,6,4,14,25,0 days 00:00:00.050462
python-telegram-bot/python-telegram-bot,3,V  v,49,27,8,39,88,0 days 00:00:00.148761
chalk/chalk,1,v,16,3,8,16,32,0 days 00:00:00.035055
Popmotion/popmotion,2, v,21,14,5,131,152,0 days 00:00:00.188175
vadimdemedes/ink,1,v,16,6,6,23,39,0 days 00:00:00.043067
graphql/graphql-js,2, v,34,12,13,88,122,0 days 00:00:00.214754
solidjs/solid,1,v,27,16,2,137,164,0 days 00:00:00.129643
pbatard/rufus,1,v,42,11,15,28,70,0 days 00:00:00.123209
sideway/joi,2, v,92,63,11,135,227,0 days 00:00:00.212759
mingrammer/diagrams,1,v,20,14,3,16,36,0 days 00:00:00.038692
urfave/cli,1,v,33,20,8,34,67,0 days 00:00:00.155797
Baseflow/PhotoView,2, v,8,2,4,12,20,0 days 00:00:00.033789
recharts/recharts,1,v,26,13,6,93,119,0 days 00:00:00.136846
OpenZeppelin/openzeppelin-contracts,1,v,30,10,5,22,52,0 days 00:00:00.184220
wenyan-lang/wenyan,1,v,3,1,1,12,15,0 days 00:00:00.054701
websockets/ws,2, v,40,13,11,114,154,0 days 00:00:00.134464
vnpy/vnpy,2, v,22,6,7,28,50,0 days 00:00:00.414442
jumpserver/jumpserver,2, v,31,24,5,103,134,0 days 00:00:00.538060
iawia002/lux,2, v,15,7,5,59,74,0 days 00:00:00.061659
PyTorchLightning/pytorch-lightning,1,,16,3,4,98,114,0 days 00:00:00.580499
eggjs/egg,1,,70,51,10,43,113,0 days 00:00:00.094941
dapr/dapr,1,v,19,9,1,23,42,0 days 00:00:00.331945
go-kratos/kratos,1,v,11,2,7,21,32,0 days 00:00:00.091101
lensapp/lens,1,v,19,6,6,56,75,0 days 00:00:00.347848
philc/vimium,2, v,11,2,5,17,28,0 days 00:00:00.250405
valyala/fasthttp,1,v,43,27,4,3,46,0 days 00:00:00.107838
svg/svgo,2, v,20,8,11,66,86,0 days 00:00:00.107512
quii/learn-go-with-tests,2, v,22,13,5,27,49,0 days 00:00:00.077974
telegramdesktop/tdesktop,1,v,34,11,15,542,576,0 days 00:00:01.110515
magenta/magenta,2, v,7,1,3,42,49,0 days 00:00:00.091865
dgraph-io/dgraph,1,v,13,1,9,60,73,0 days 00:00:00.467980
typicode/lowdb,1,v,21,8,9,36,57,0 days 00:00:00.050870
appsmithorg/appsmith,3, v v.,13,7,3,129,142,0 days 00:00:00.800212
react-dnd/react-dnd,2, v,45,25,10,100,145,0 days 00:00:00.240079
NickeManarin/ScreenToGif,1,,37,16,7,43,80,0 days 00:00:00.199271
flameshot-org/flameshot,1,v,11,3,6,30,41,0 days 00:00:00.125590
SortableJS/Vue.Draggable,2,v v.,24,13,6,25,49,0 days 00:00:00.050024
Redocly/redoc,1,v,39,33,1,56,95,0 days 00:00:00.121036
facebook/flux,1,,4,1,2,9,13,0 days 00:00:00.038902
nosir/cleave.js,1,v,9,2,5,57,66,0 days 00:00:00.040636
aseprite/aseprite,2, v,9,1,7,84,93,0 days 00:00:00.494892
TanStack/table,1,v,36,24,6,86,122,0 days 00:00:00.132429
pubkey/rxdb,1,,58,43,2,55,113,0 days 00:00:00.543398
mysqljs/mysql,1,v,28,10,9,26,54,0 days 00:00:00.100856
jsdom/jsdom,2, v,98,67,9,144,242,0 days 00:00:00.405821
mybatis/mybatis-3,1,mybatis-,5,1,3,32,37,0 days 00:00:00.263905
jquense/yup,1,v,27,12,8,67,94,0 days 00:00:00.064030
alibaba/ice,3,V  v,23,17,1,57,80,0 days 00:00:00.118992
pmndrs/zustand,1,v,13,4,6,56,69,0 days 00:00:00.064788
Molunerfinn/PicGo,1,v,11,4,5,21,32,0 days 00:00:00.032767
linlinjava/litemall,1,v,19,10,2,3,22,0 days 00:00:00.069042
ai/nanoid,1,,12,5,4,73,85,0 days 00:00:00.066193
wekan/wekan,2, v,610,607,2,27,637,0 days 00:00:01.040221
facebookresearch/fairseq,1,v,8,1,4,6,14,0 days 00:00:00.115521
oldj/SwitchHosts,1,v,9,2,5,36,45,0 days 00:00:00.194093
arendst/Tasmota,1,v,35,14,7,58,93,0 days 00:00:01.053356
cookiecutter/cookiecutter,1,,14,3,7,15,29,0 days 00:00:00.156175
bazelbuild/bazel,1,,47,30,8,56,103,0 days 00:00:02.006810
nostra13/Android-Universal-Image-Loader,1,v,3,1,1,12,15,0 days 00:00:00.058887
badges/shields,1,,8,3,4,3,11,0 days 00:00:00.298100
jhipster/generator-jhipster,1,v,110,89,5,114,224,0 days 00:00:02.761169
remix-run/remix,1,v,27,22,1,61,88,0 days 00:00:00.185328
freqtrade/freqtrade,1,,44,35,3,14,58,0 days 00:00:01.041735
defunkt/jquery-pjax,2, v,12,6,3,15,27,0 days 00:00:00.040088
less/less.js,1,v,26,8,13,42,68,0 days 00:00:00.166621
facebook/fresco,1,v,35,14,13,12,47,0 days 00:00:00.186424
gorilla/mux,1,v,8,1,5,6,14,0 days 00:00:00.027837
restic/restic,1,v,13,2,7,18,31,0 days 00:00:00.348221
handlebars-lang/handlebars.js,2, v,14,5,6,56,70,0 days 00:00:00.110013
fingerprintjs/fingerprintjs,2, v,23,11,7,50,73,0 days 00:00:00.167473
brettwooldridge/HikariCP,1,HikariCP-,17,2,10,82,99,0 days 00:00:00.294711
eclipse-theia/theia,2, v,43,36,2,33,76,0 days 00:00:00.578100
monicahq/monica,1,v,47,32,4,39,86,0 days 00:00:00.241252
dropzone/dropzone,1,v,32,15,12,83,115,0 days 00:00:00.087699
testing-library/react-testing-library,1,v,57,43,2,110,167,0 days 00:00:00.083120
zloirock/core-js,2, v,41,26,7,156,197,0 days 00:00:00.382483
twitter/typeahead.js,1,v,4,1,2,11,15,0 days 00:00:00.040985
GoogleChromeLabs/squoosh,1,v,10,4,5,17,27,0 days 00:00:00.067684
grafana/k6,1,v,36,12,6,36,72,0 days 00:00:00.282093
jamiebuilds/react-loadable,1,v,13,8,3,16,29,0 days 00:00:00.023582
plotly/dash,1,v,42,29,3,33,75,0 days 00:00:00.362302
responsively-org/responsively-app,1,v,18,14,3,10,28,0 days 00:00:00.204982
derailed/k9s,2, v,25,17,2,155,180,0 days 00:00:00.245553
Tencent/tinker,1,v,7,3,2,46,53,0 days 00:00:00.055336
nfl/react-helmet,1,,15,5,4,18,33,0 days 00:00:00.032923
joewalnes/websocketd,1,v,11,3,2,15,26,0 days 00:00:00.028717
framework7io/framework7,1,v,43,19,11,172,215,0 days 00:00:00.609229
handsontable/handsontable,2, v,62,27,14,117,179,0 days 00:00:00.550595
aFarkas/lazysizes,1,,21,10,7,45,66,0 days 00:00:00.058424
hubotio/hubot,1,v,26,7,12,68,94,0 days 00:00:00.132963
sanic-org/sanic,2, v,21,2,13,49,70,0 days 00:00:00.178892
gchq/CyberChef,1,v,119,106,4,273,392,0 days 00:00:00.397216
matryer/xbar,2, v,9,5,2,5,14,0 days 00:00:00.052577
nondanee/UnblockNeteaseMusic,1,v,23,17,1,34,57,0 days 00:00:00.038557
ionic-team/ionicons,2, v,21,9,10,51,72,0 days 00:00:00.149699
mpv-player/mpv,1,v,34,10,8,46,80,0 days 00:00:03.118052
zadam/trilium,2, v,14,11,1,134,148,0 days 00:00:00.445278
visionmedia/superagent,2, v,50,23,13,84,134,0 days 00:00:00.134965
trojan-gfw/trojan,1,v,24,15,4,19,43,0 days 00:00:00.038273
notepad-plus-plus/notepad-plus-plus,2, v,42,8,11,159,201,0 days 00:00:00.338478
youzan/vant-weapp,1,v,16,7,4,91,107,0 days 00:00:00.149087
nginx/nginx,1,release-,32,10,20,516,548,0 days 00:00:01.014791
grafana/loki,1,v,17,4,4,8,25,0 days 00:00:00.450187
uber-go/zap,1,v,22,11,8,6,28,0 days 00:00:00.043736
EastWorld/wechat-app-mall,2, v,14,6,4,8,22,0 days 00:00:00.044050
v2fly/v2ray-core,1,v,185,168,4,217,402,0 days 00:00:00.675052
bokeh/bokeh,1,,23,1,14,50,73,0 days 00:00:01.145828
jaegertracing/jaeger,1,v,40,24,3,13,53,0 days 00:00:00.120242
filebrowser/filebrowser,1,v,34,23,6,62,96,0 days 00:00:00.238489
wagerfield/parallax,1,v,6,2,2,5,11,0 days 00:00:00.018269
react-grid-layout/react-grid-layout,2, v,22,9,8,86,108,0 days 00:00:00.074988
knex/knex,2, v,25,2,17,146,171,0 days 00:00:00.233319
oblador/react-native-vector-icons,1,v,37,14,10,42,79,0 days 00:00:00.061586
briannesbitt/Carbon,1,,99,80,7,79,178,0 days 00:00:00.260532
buger/goreplay,2, v,18,5,10,23,41,0 days 00:00:00.079327
ustbhuangyi/better-scroll,3, v v.,17,6,4,41,58,0 days 00:00:00.111734
simdjson/simdjson,1,v,12,1,5,26,38,0 days 00:00:00.257805
semantic-release/semantic-release,2, v,62,48,9,206,268,0 days 00:00:00.176226
motdotla/dotenv,1,v,33,17,11,26,59,0 days 00:00:00.042936
nikic/PHP-Parser,1,v,24,7,12,41,65,0 days 00:00:00.088703
BabylonJS/Babylon.js,2, v,36,16,14,36,72,0 days 00:00:02.674229
radareorg/radare2,2, release-,42,22,6,43,85,0 days 00:00:01.585896
spotify/luigi,2, v,13,4,7,46,59,0 days 00:00:00.371770
JedWatson/classnames,1,v,4,1,2,16,20,0 days 00:00:00.030736
jhao104/proxy_pool,1,,10,1,6,2,12,0 days 00:00:00.041500
janl/mustache.js,2, v,20,6,12,23,43,0 days 00:00:00.061362
wulkano/Kap,1,v,13,2,5,14,27,0 days 00:00:00.065116
jasmine/jasmine,1,v,28,5,17,29,57,0 days 00:00:00.156355
auth0/node-jsonwebtoken,1,v,29,13,9,42,71,0 days 00:00:00.045004
outline/outline,2, v,64,54,1,39,103,0 days 00:00:00.269331
tailwindlabs/heroicons,1,v,4,1,2,15,19,0 days 00:00:00.017877
huiyadanli/RevokeMsgPatcher,1,,15,6,3,0,15,0 days 00:00:00.026282
KaTeX/KaTeX,1,v,15,3,10,41,56,0 days 00:00:00.135622
facebook/yoga,2, v,19,6,8,23,42,0 days 00:00:00.136486
cool-RR/PySnooper,1,,7,1,5,10,17,0 days 00:00:00.031720
airbnb/visx,1,v,29,25,1,200,229,0 days 00:00:00.254292
lottie-react-native/lottie-react-native,1,v,16,2,9,37,53,0 days 00:00:00.062602
infernojs/inferno,2, v,38,29,6,160,198,0 days 00:00:00.483541
designmodo/Flat-UI,1,,5,1,3,5,10,0 days 00:00:00.020739
bower/bower,2, v,18,8,4,83,101,0 days 00:00:00.181228
DapperLib/Dapper,1,,31,22,6,13,44,0 days 00:00:00.105259
airbnb/react-sketchapp,2, v,20,11,5,27,47,0 days 00:00:00.059664
catchorg/Catch2,3,V v v.,24,7,7,62,86,0 days 00:00:00.344101
teambit/bit,1,v,18,7,5,121,139,0 days 00:00:00.486055
2dust/v2rayNG,1,,8,1,5,111,119,0 days 00:00:00.051214
LMAX-Exchange/disruptor,1,,9,1,4,22,31,0 days 00:00:00.062137
matomo-org/matomo,1,,64,20,21,130,194,0 days 00:00:02.088537
ChainSafe/web3.js,2, v,25,16,7,54,79,0 days 00:00:00.226888
qbittorrent/qBittorrent,1,release-,24,5,16,145,169,0 days 00:00:01.224036
flatpickr/flatpickr,2, v,23,10,4,121,144,0 days 00:00:00.273556
cloudreve/Cloudreve,1,,7,1,5,14,21,0 days 00:00:00.055083
pouchdb/pouchdb,2, v,24,7,8,47,71,0 days 00:00:00.378825
fullcalendar/fullcalendar,1,v,44,16,18,72,116,0 days 00:00:00.410587
icsharpcode/ILSpy,2, v,16,2,11,9,25,0 days 00:00:00.559363
nodemailer/nodemailer,1,v,47,20,15,170,217,0 days 00:00:00.133475
Tencent/ncnn,1,,32,9,3,0,32,0 days 00:00:00.141532
riot/riot,1,v,44,16,10,155,199,0 days 00:00:00.303381
gabime/spdlog,1,v,19,4,10,15,34,0 days 00:00:00.221561
pyg-team/pytorch_geometric,1,,9,1,5,22,31,0 days 00:00:00.362403
you-dont-need/You-Dont-Need-Lodash-Underscore,1,v,14,5,6,6,20,0 days 00:00:00.040850
Tencent/vConsole,2, v,24,13,7,34,58,0 days 00:00:00.070449
pqrs-org/Karabiner-Elements,1,v,28,11,5,0,28,0 days 00:00:00.257988
magic-wormhole/magic-wormhole,1,,12,2,6,22,34,0 days 00:00:00.094993
browsh-org/browsh,1,v,5,2,2,45,50,0 days 00:00:00.035581
kovidgoyal/kitty,1,v,25,8,9,58,83,0 days 00:00:00.780105
antonmedv/fx,1,,27,18,4,34,61,0 days 00:00:00.035972
frappe/charts,2, v,5,1,3,13,18,0 days 00:00:00.034786
mkdocs/mkdocs,1,,20,9,9,27,47,0 days 00:00:00.103475
iovisor/bcc,1,v,24,1,6,9,33,0 days 00:00:00.390329
framer/motion,1,v,60,51,3,243,303,0 days 00:00:00.522666
Anuken/Mindustry,1,v,136,129,4,0,136,0 days 00:00:00.931275
cocos2d/cocos2d-x,1,cocos2d-x-,20,2,8,17,37,0 days 00:00:02.568573
hdodenhof/CircleImageView,1,v,9,1,7,6,15,0 days 00:00:00.020087
node-red/node-red,2, v,26,3,18,99,125,0 days 00:00:00.440834
checkly/headless-recorder,1,v,8,4,3,10,18,0 days 00:00:00.033544
jellyfin/jellyfin,1,v,8,2,4,30,38,0 days 00:00:01.218066
localtunnel/localtunnel,1,v,13,3,6,20,33,0 days 00:00:00.027638
InstaPy/InstaPy,2, v,6,2,1,37,43,0 days 00:00:00.181534
krisk/Fuse,2, v,25,12,10,50,75,0 days 00:00:00.080683
erusev/parsedown,2, v,17,10,5,51,68,0 days 00:00:00.157556
greensock/GSAP,1,,26,5,17,72,98,0 days 00:00:00.051396
barryvdh/laravel-debugbar,2,V v,24,11,10,99,123,0 days 00:00:00.088176
hashcat/hashcat,1,v,17,4,9,8,25,0 days 00:00:00.530656
joke2k/faker,1,v,95,84,9,138,233,0 days 00:00:00.288311
chrislusf/seaweedfs,2, v,218,211,2,0,218,0 days 00:00:00.475798
fmtlib/fmt,2, v,23,2,14,16,39,0 days 00:00:00.470407
iBotPeaches/Apktool,1,v,12,3,8,23,35,0 days 00:00:00.117706
jarun/nnn,1,v,34,11,4,2,36,0 days 00:00:00.267761
Kr328/ClashForAndroid,2, v,18,10,1,94,112,0 days 00:00:00.088003
FormidableLabs/webpack-dashboard,2, v,12,3,8,31,43,0 days 00:00:00.031203
sweetalert2/sweetalert2,1,v,129,115,3,544,673,0 days 00:00:00.702999
infinitered/ignite,2, v,52,42,6,94,146,0 days 00:00:00.157887
browserify/browserify,2, v,149,129,7,264,413,0 days 00:00:00.342540
alibaba/ARouter,1,,4,1,2,16,20,0 days 00:00:00.027743
google/filament,1,v,23,13,5,70,93,0 days 00:00:00.392893
be5invis/Iosevka,1,v,59,45,8,163,222,0 days 00:00:00.299320
janpaepke/ScrollMagic,1,v,5,2,2,21,26,0 days 00:00:00.043202
medcl/elasticsearch-analysis-ik,1,v,42,5,11,130,172,0 days 00:00:00.084834
microsoft/LightGBM,1,v,9,1,6,19,28,0 days 00:00:00.174580
marcuswestin/store.js,1,v,4,1,2,31,35,0 days 00:00:00.039203
uNetworking/uWebSockets,1,v,66,52,5,26,92,0 days 00:00:00.113632
CopyTranslator/CopyTranslator,2, v,6,1,3,14,20,0 days 00:00:00.070212
gpujs/gpu.js,1,,21,15,3,55,76,0 days 00:00:00.088670
desktop/desktop,1,release-,22,6,8,136,158,0 days 00:00:02.012911
bootstrap-vue/bootstrap-vue,2, v,47,38,2,66,113,0 days 00:00:00.443076
docker-slim/docker-slim,1,,38,21,10,17,55,0 days 00:00:00.056752
micropython/micropython,1,v,19,4,10,31,50,0 days 00:00:00.805778
wting/autojump,1,release-v,31,14,8,22,53,0 days 00:00:00.060506
plotly/plotly.js,1,v,72,54,3,133,205,0 days 00:00:01.783678
Qv2ray/Qv2ray,1,v,15,11,2,32,47,0 days 00:00:00.181618
koel/koel,1,v,18,6,6,38,56,0 days 00:00:00.283449
commitizen/cz-cli,2, v,16,6,7,58,74,0 days 00:00:00.044516
kamranahmedse/driver.js,2, v,8,3,1,27,35,0 days 00:00:00.037360
foreversd/forever,2, v,17,2,10,51,68,0 days 00:00:00.065524
markdown-it/markdown-it,1,,29,13,10,47,76,0 days 00:00:00.075605
thomaspark/bootswatch,1,v,15,1,11,34,49,0 days 00:00:00.135385
infinitered/reactotron,1,v,46,36,3,40,86,0 days 00:00:00.104786
hapijs/hapi,2, v,129,106,11,194,323,0 days 00:00:00.619447
vuejs/vue,2, v,15,4,7,145,160,0 days 00:00:00.355709
dogecoin/dogecoin,2, v,17,3,10,64,81,0 days 00:00:01.244293
axios/axios,2, v,27,10,10,30,57,0 days 00:00:00.082481
d3/d3,1,v,91,58,12,197,288,0 days 00:00:00.350796
containers/podman,1,v,21,5,4,95,116,0 days 00:00:01.302016
hashicorp/packer,2, v,21,5,15,82,103,0 days 00:00:01.308452
vercel/next.js,2, v,33,11,8,122,155,0 days 00:00:00.891318
facebook/react,2, v,36,8,14,58,94,0 days 00:00:01.407167
puppeteer/puppeteer,1,v,61,49,1,33,94,0 days 00:00:00.182733
twbs/bootstrap,1,v,23,3,15,36,59,0 days 00:00:01.532069
nvbn/thefuck,1,,79,64,8,4,83,0 days 00:00:00.113347
iluwatar/java-design-patterns,1,,19,3,13,0,19,0 days 00:00:00.230745
FortAwesome/Font-Awesome,2, v,30,6,15,40,70,0 days 00:00:00.105187
RasaHQ/rasa,1,,33,15,7,233,266,0 days 00:00:02.330348
Genymobile/scrcpy,1,v,25,9,5,2,27,0 days 00:00:00.223711
microsoft/PowerToys,2, v,28,19,3,31,59,0 days 00:00:00.502298
facebook/react-native,2, v,67,52,8,144,211,0 days 00:00:02.045751
tensorflow/models,2,v v.,19,3,9,6,25,0 days 00:00:00.671719
elastic/kibana,1,v,55,17,12,190,245,0 days 00:00:07.381906
typicode/json-server,2, v,17,4,10,106,123,0 days 00:00:00.076781
laravel/laravel,1,v,40,19,17,134,174,0 days 00:00:00.618398
hakimel/reveal.js,1,,27,3,18,11,38,0 days 00:00:00.173324
huggingface/transformers,2, v,46,41,1,49,95,0 days 00:00:00.765113
gin-gonic/gin,1,v,13,3,8,13,26,0 days 00:00:00.088480
electron/electron,1,v,113,74,19,595,708,0 days 00:00:02.786804
microsoft/TypeScript,1,v,12,2,2,120,132,0 days 00:00:02.197141
ant-design/ant-design,1,,79,66,4,329,408,0 days 00:00:01.817583
mrdoob/three.js,1,r,132,107,6,0,132,0 days 00:00:02.734594
reduxjs/redux,1,v,26,16,6,42,68,0 days 00:00:00.183870
pallets/flask,1,,16,5,10,25,41,0 days 00:00:00.290164
fatedier/frp,1,v,42,23,11,30,72,0 days 00:00:00.080759
tailwindlabs/tailwindcss,1,v,21,9,8,127,148,0 days 00:00:00.330086
gohugoio/hugo,1,v,93,72,10,101,194,0 days 00:00:00.706622
chartjs/Chart.js,2, v,21,7,10,31,52,0 days 00:00:00.258401
521xueweihan/HelloGitHub,1,vol.,19,16,1,0,19,0 days 00:00:00.019934
socketio/socket.io,1,,30,5,15,118,148,0 days 00:00:00.208282
webpack/webpack,1,v,152,134,8,224,376,0 days 00:00:01.233161
adam-p/markdown-here,1,v,15,8,6,34,49,0 days 00:00:00.255905
sveltejs/svelte,1,v,134,119,2,244,378,0 days 00:00:00.764841
expressjs/express,1,,61,40,12,185,246,0 days 00:00:00.585512
shadowsocks/shadowsocks-windows,1,,13,4,7,49,62,0 days 00:00:00.196654
jquery/jquery,1,,23,1,21,63,86,0 days 00:00:00.576419
h5bp/html5-boilerplate,2, v,19,2,13,10,29,0 days 00:00:00.116607
coder/code-server,2, v,20,9,4,22,42,0 days 00:00:00.281333
protocolbuffers/protobuf,1,v,29,6,14,46,75,0 days 00:00:00.607608
lodash/lodash,1,,48,39,4,59,107,0 days 00:00:00.557881
apache/echarts,1,,29,5,14,64,93,0 days 00:00:00.459244
azl397985856/leetcode,2, v,35,25,3,5,40,0 days 00:00:00.232345
psf/requests,2, v,43,11,22,101,144,0 days 00:00:00.364196
remix-run/react-router,1,v,39,22,11,76,115,0 days 00:00:00.431030
django/django,1,,19,1,14,248,267,0 days 00:00:03.121436
storybookjs/storybook,1,v,107,90,13,323,430,0 days 00:00:03.343575
tiangolo/fastapi,2, v,77,68,3,52,129,0 days 00:00:00.155135
moment/moment,1,,40,15,12,46,86,0 days 00:00:00.309332
ionic-team/ionic-framework,2, v,43,27,10,140,183,0 days 00:00:01.028626
bitcoin/bitcoin,1,v,25,3,20,82,107,0 days 00:00:03.436157
nestjs/nest,2, v,33,18,5,167,200,0 days 00:00:00.878463
tesseract-ocr/tesseract,1,,15,1,10,8,23,0 days 00:00:00.403370
junegunn/fzf,1,,27,8,13,76,103,0 days 00:00:00.144737
3b1b/manim,2, v,8,1,1,10,18,0 days 00:00:00.231352
juliangarnier/anime,2, v,8,2,5,6,14,0 days 00:00:00.044512
soimort/you-get,1,v,3,1,1,143,146,0 days 00:00:00.193670
ColorlibHQ/AdminLTE,2, v,13,4,6,47,60,0 days 00:00:00.295101
prettier/prettier,2, v,39,20,8,71,110,0 days 00:00:00.421898
atom/atom,2, v,271,256,2,104,375,0 days 00:00:02.730586
yarnpkg/yarn,2, v,50,38,1,114,164,0 days 00:00:00.200797
scrapy/scrapy,1,,32,7,17,58,90,0 days 00:00:00.837644
caddyserver/caddy,1,v,14,2,10,49,63,0 days 00:00:00.407865
prometheus/prometheus,2, v,67,35,6,79,146,0 days 00:00:00.883687
gogs/gogs,1,v,11,4,6,51,62,0 days 00:00:00.420383
nuxt/nuxt.js,1,v,30,17,7,112,142,0 days 00:00:00.518407
v2ray/v2ray-core,1,v,168,154,3,182,350,0 days 00:00:00.496048
iamkun/dayjs,1,v,11,5,4,99,110,0 days 00:00:00.116885
strapi/strapi,1,v,16,7,3,79,95,0 days 00:00:01.743002
vercel/hyper,2, v,18,9,6,43,61,0 days 00:00:00.224995
Dogfalo/materialize,2, v,17,10,4,20,37,0 days 00:00:00.320442
impress/impress.js,1,,8,4,3,4,12,0 days 00:00:00.034031
FiloSottile/mkcert,1,v,6,3,2,8,14,0 days 00:00:00.019877
facebook/jest,2, v,68,45,10,143,211,0 days 00:00:00.430576
PhilJay/MPAndroidChart,1,v,8,2,4,33,41,0 days 00:00:00.118885
grafana/grafana,2, v,46,7,9,181,227,0 days 00:00:02.701913
babel/babel,1,v,90,67,9,606,696,0 days 00:00:01.473226
commaai/openpilot,1,v,8,1,6,62,70,0 days 00:00:00.081687
ocornut/imgui,1,v,72,44,5,2,74,0 days 00:00:00.493703
hexojs/hexo,1,,38,15,12,101,139,0 days 00:00:00.406070
obsproject/obs-studio,1,,30,1,13,89,119,0 days 00:00:00.744767
TryGhost/Ghost,2, v,170,154,8,318,488,0 days 00:00:01.400576
Leaflet/Leaflet,1,v,16,1,13,27,43,0 days 00:00:00.516087
dcloudio/uni-app,2, v,8,2,1,8,16,0 days 00:00:00.664889
shadowsocks/shadowsocks,1,,4,1,2,14,18,0 days 00:00:00.045969
facebook/docusaurus,1,v,14,8,1,37,51,0 days 00:00:00.230126
sahat/hackathon-starter,1,,8,2,4,6,14,0 days 00:00:00.120663
airbnb/lottie-android,2,v v.,21,8,9,42,63,0 days 00:00:00.103105
d2l-ai/d2l-zh,1,v,9,5,3,0,9,0 days 00:00:00.154958
ansible/ansible,2, v,26,4,13,174,200,0 days 00:00:04.344779
quilljs/quill,1,v,23,12,5,99,122,0 days 00:00:00.256173
videojs/video.js,2, v,70,38,15,220,290,0 days 00:00:00.439743
lerna/lerna,1,v,39,26,6,70,109,0 days 00:00:00.286290
vuetifyjs/vuetify,1,v,23,7,8,284,307,0 days 00:00:00.878240
zenorocha/clipboard.js,1,v,9,5,3,33,42,0 days 00:00:00.035878
gulpjs/gulp,2, v,6,2,3,13,19,0 days 00:00:00.070854
koajs/koa,1,,43,23,13,44,87,0 days 00:00:00.183513
wg/wrk,1,,10,1,6,11,21,0 days 00:00:00.015203
bumptech/glide,1,v,21,6,11,15,36,0 days 00:00:00.159086
rclone/rclone,1,v,69,36,11,21,90,0 days 00:00:00.459129
wagoodman/dive,1,v,10,5,2,15,25,0 days 00:00:00.036259
marktext/marktext,1,v,7,2,4,20,27,0 days 00:00:00.098269
ant-design/ant-design-pro,2, v,18,6,6,12,30,0 days 00:00:00.127192
immutable-js/immutable-js,2, v,16,11,3,39,55,0 days 00:00:00.106850
google/zx,1,,23,21,1,19,42,0 days 00:00:00.031486
shadowsocks/shadowsocks-android,1,v,24,8,11,156,180,0 days 00:00:00.365062
nolimits4web/swiper,1,v,49,14,12,139,188,0 days 00:00:00.210425
evanw/esbuild,1,v,12,5,2,284,296,0 days 00:00:00.334161
XX-net/XX-Net,1,,51,36,5,285,336,0 days 00:00:00.314726
nativefier/nativefier,2, v,56,42,9,90,146,0 days 00:00:00.119809
Blankj/AndroidUtilCode,1,,27,12,7,89,116,0 days 00:00:00.183649
carbon-app/carbon,1,,24,14,4,194,218,0 days 00:00:00.219988
nlohmann/json,2, v,15,2,8,36,51,0 days 00:00:00.276612
microsoft/monaco-editor,2, v,28,11,10,36,64,0 days 00:00:00.167680
pandas-dev/pandas,2, v,28,1,22,56,84,0 days 00:00:01.977426
google/leveldb,2, v,21,7,7,0,21,0 days 00:00:00.035452
NervJS/taro,1,v,12,2,5,272,284,0 days 00:00:00.849557
photonstorm/phaser,2, v,39,20,11,59,98,0 days 00:00:01.073832
2dust/v2rayN,1,,117,111,1,2,119,0 days 00:00:00.075628
fxsjy/jieba,1,v,23,17,5,5,28,0 days 00:00:00.039959
date-fns/date-fns,2,v v.,77,62,7,42,119,0 days 00:00:00.150158
streamich/react-use,1,v,134,130,3,117,251,0 days 00:00:00.324512
react-boilerplate/react-boilerplate,1,v,17,6,6,13,30,0 days 00:00:00.100848
tastejs/todomvc,2, v,7,1,3,6,13,0 days 00:00:00.156824
jashkenas/backbone,2, v,10,2,7,22,32,0 days 00:00:00.197370
beego/beego,1,v,16,3,10,24,40,0 days 00:00:00.252022
RocketChat/Rocket.Chat,1,,103,94,1,245,348,0 days 00:00:01.639924
openai/gym,2, v,15,7,6,34,49,0 days 00:00:00.222526
nocodb/nocodb,2, v,9,5,2,86,95,0 days 00:00:00.297202
vuejs/vuex,1,v,21,7,7,24,45,0 days 00:00:00.076512
Dreamacro/clash,1,v,28,10,3,14,42,0 days 00:00:00.053353
certbot/certbot,1,v,68,54,2,31,99,0 days 00:00:00.802344
caolan/async,2, v,25,13,10,52,77,0 days 00:00:00.116488
markedjs/marked,2, v,16,2,11,94,110,0 days 00:00:00.168112
kenwheeler/slick,2, v,8,3,3,43,51,0 days 00:00:00.057787
square/leakcanary,1,v,14,4,9,10,24,0 days 00:00:00.131786
istio/istio,1,,22,3,12,143,165,0 days 00:00:01.502190
atlassian/react-beautiful-dnd,2, v,24,15,4,46,70,0 days 00:00:00.065827
hashicorp/terraform,2, v,18,2,12,158,176,0 days 00:00:02.130884
naptha/tesseract.js,2, v,4,1,2,28,32,0 days 00:00:00.055155
jesseduffield/lazygit,2, v,33,21,5,151,184,0 days 00:00:00.210757
mitmproxy/mitmproxy,2, v,30,4,17,35,65,0 days 00:00:00.628408
standard/standard,1,v,66,55,8,87,153,0 days 00:00:00.154891
typicode/husky,1,v,34,16,11,88,122,0 days 00:00:00.088613
tannerlinsley/react-query,1,v,77,73,2,294,371,0 days 00:00:00.311271
ReactiveX/rxjs,1,,19,7,6,45,64,0 days 00:00:00.338223
airbnb/lottie-web,2,v v.,24,9,9,144,168,0 days 00:00:00.203559
denysdovhan/wtfjs,1,v,23,13,6,16,39,0 days 00:00:00.045833
apolloconfig/apollo,2, v,19,2,9,16,35,0 days 00:00:00.318110
jashkenas/underscore,1,,20,5,13,54,74,0 days 00:00:00.169586
layui/layui,2, v,7,1,4,41,48,0 days 00:00:00.031962
niklasvh/html2canvas,2, v,7,3,3,17,24,0 days 00:00:00.064228
hankcs/HanLP,1,v,9,2,5,44,53,0 days 00:00:00.073552
aria2/aria2,1,release-,53,22,18,87,140,0 days 00:00:00.453342
postcss/postcss,1,,20,4,10,207,227,0 days 00:00:00.432607
request/request,1,v,73,55,6,71,144,0 days 00:00:00.171898
github/fetch,1,v,21,10,9,19,40,0 days 00:00:00.049716
webtorrent/webtorrent,1,v,125,112,9,284,409,0 days 00:00:00.583635
cheeriojs/cheerio,2, v,22,7,7,30,52,0 days 00:00:00.074409
select2/select2,1,,9,2,5,27,36,0 days 00:00:00.150630
Modernizr/Modernizr,1,v,20,4,12,23,43,0 days 00:00:00.162456
docker/compose,2, v,41,12,15,67,108,0 days 00:00:00.597838
SortableJS/Sortable,1,,17,3,10,18,35,0 days 00:00:00.072364
composer/composer,1,,15,1,11,110,125,0 days 00:00:00.847504
harness/drone,1,v,31,17,9,44,75,0 days 00:00:00.238316
GitbookIO/gitbook,1,,22,17,2,68,90,0 days 00:00:00.238755
parallax/jsPDF,3, v v.,9,1,7,26,35,0 days 00:00:00.136229
Binaryify/NeteaseCloudMusicApi,2, v,52,36,7,102,154,0 days 00:00:00.128954
lenve/vhr,1,v,12,9,1,0,12,0 days 00:00:00.016737
GoogleChrome/lighthouse,2, v,56,40,4,42,98,0 days 00:00:00.400799
remy/nodemon,1,v,20,7,9,101,121,0 days 00:00:00.194408
kubernetes/kubernetes,1,v,45,20,19,329,374,0 days 00:00:10.360707
tmux/tmux,1,,25,1,19,0,25,0 days 00:00:00.540854
sequelize/sequelize,2, v,137,107,19,334,471,0 days 00:00:01.011623
akveo/ngx-admin,1,v,19,2,9,8,27,0 days 00:00:00.070910
YMFE/yapi,2, v,9,2,3,68,77,0 days 00:00:00.417208
bvaughn/react-virtualized,2, v,71,65,3,129,200,0 days 00:00:00.176964
ggreer/the_silver_searcher,1,,37,17,8,12,49,0 days 00:00:00.140290
CodeHubApp/CodeHub,1,,15,10,3,13,28,0 days 00:00:00.044705
fastify/fastify,1,v,104,96,1,90,194,0 days 00:00:00.246995
pmndrs/react-spring,1,v,22,15,3,150,172,0 days 00:00:00.279436
getsentry/sentry,2, v,102,90,9,294,396,0 days 00:00:03.309842
encode/django-rest-framework,1,,22,1,17,106,128,0 days 00:00:00.551724
elastic/elasticsearch,1,v,67,22,16,231,298,0 days 00:00:09.162751
explosion/spaCy,2, v,28,14,11,72,100,0 days 00:00:01.061873
kubernetes/minikube,1,v,61,43,1,45,106,0 days 00:00:01.418433
Automattic/mongoose,2, v,58,15,20,646,704,0 days 00:00:01.730201
laravel/framework,2, v,163,148,13,630,793,0 days 00:00:03.303510
influxdata/influxdb,2, v,26,6,14,133,159,0 days 00:00:02.625809
