project,prefixes,prefixes_names,main_releases,rapid_releases,trad_releases,patches,releases,time
1adrianb/face-alignment,1,v,5,1,2,5,10,0 days 00:00:00.029894
bytedance/IconPark,1,v,4,1,1,32,36,0 days 00:00:00.035252
FaisalUmair/udemy-downloader-gui,1,v,9,4,2,12,21,0 days 00:00:00.035667
robinvdvleuten/vuex-persistedstate,1,v,21,9,7,14,35,0 days 00:00:00.042063
stevenjoezhang/live2d-widget,1,v,8,5,2,9,17,0 days 00:00:00.017914
mindoc-org/mindoc,1,v,14,10,3,17,31,0 days 00:00:00.058945
expressjs/session,1,v,17,7,6,45,62,0 days 00:00:00.062785
Yelp/dumb-init,1,v,8,4,3,14,22,0 days 00:00:00.027826
kalcaddle/KodExplorer,2, v,31,15,10,3,34,0 days 00:00:00.030112
jquense/react-big-calendar,1,v,37,18,12,77,114,0 days 00:00:00.098909
vuejs/apollo,2, v,5,1,2,8,13,0 days 00:00:00.046056
listen1/listen1_desktop,1,v,26,18,5,40,66,0 days 00:00:00.034380
botman/botman,2, v,17,9,6,44,61,0 days 00:00:00.071496
bblanchon/ArduinoJson,1,v,42,20,11,56,98,0 days 00:00:00.109843
googleapis/google-api-python-client,1,v,60,50,6,52,112,0 days 00:00:00.149761
telegraf/telegraf,2, v,68,48,5,112,180,0 days 00:00:00.154244
go-yaml/yaml,1,v,6,2,3,10,16,0 days 00:00:00.033697
VirusTotal/yara,1,v,17,1,12,16,33,0 days 00:00:00.183104
projectdiscovery/subfinder,2, v,10,5,4,24,34,0 days 00:00:00.070695
matthewmueller/x-ray,1,,5,2,2,13,18,0 days 00:00:00.023223
ecrmnn/collect.js,1,,35,24,5,154,189,0 days 00:00:00.118142
substack/tape,1,v,50,23,16,85,135,0 days 00:00:00.096459
joeyespo/grip,1,v,15,3,10,9,24,0 days 00:00:00.042535
encode/apistar,1,,6,2,3,88,94,0 days 00:00:00.072259
bchavez/Bogus,1,v,7,5,1,97,104,0 days 00:00:00.082587
maaslalani/slides,1,v,8,4,1,8,16,0 days 00:00:00.022374
eternnoir/pyTelegramBotAPI,1,,15,3,7,37,52,0 days 00:00:00.117062
graphql-editor/graphql-editor,2, v,19,15,1,127,146,0 days 00:00:00.076977
neutralinojs/neutralinojs,1,v,26,18,4,4,30,0 days 00:00:00.098462
Dman95/SASM,1,v,15,4,9,11,26,0 days 00:00:00.032987
lightbend/config,1,v,9,1,4,19,28,0 days 00:00:00.160478
kickstarter/android-oss,1,v,36,18,5,36,72,0 days 00:00:00.383467
Xhofe/alist,1,v,9,5,2,33,42,0 days 00:00:00.141758
assaf/zombie,2, v,21,12,7,111,132,0 days 00:00:00.217504
thephpleague/omnipay,2, v,12,4,5,18,30,0 days 00:00:00.048880
tijsverkoyen/CssToInlineStyles,1,,9,2,5,20,29,0 days 00:00:00.025423
capstone-engine/capstone,1,,5,2,2,9,14,0 days 00:00:00.305670
MikeMcl/bignumber.js,2, v,20,3,11,27,47,0 days 00:00:00.027039
roots/bedrock,1,,21,3,12,82,103,0 days 00:00:00.065114
ml5js/ml5-library,3, V v,9,3,3,45,54,0 days 00:00:00.265613
golden-layout/golden-layout,2, v,7,1,3,25,32,0 days 00:00:00.051814
datreeio/datree,1,,14,11,2,93,107,0 days 00:00:00.110680
OpenNMT/OpenNMT-py,2, v,15,6,8,14,29,0 days 00:00:00.245727
kyleconroy/sqlc,2, v,15,6,3,1,16,0 days 00:00:00.060662
docker/docker-py,1,,40,7,11,63,103,0 days 00:00:00.328470
lebab/lebab,1,v,14,8,2,28,42,0 days 00:00:00.064692
modulz/stitches,1,v,5,2,1,22,27,0 days 00:00:00.067426
shaka-project/shaka-player,1,v,18,2,10,119,137,0 days 00:00:00.602916
Respect/Validation,1,,11,1,8,108,119,0 days 00:00:00.152067
nodeca/js-yaml,1,,23,2,18,51,74,0 days 00:00:00.096744
haifengl/smile,1,v,12,3,6,10,22,0 days 00:00:00.137009
documentationjs/documentation,1,v,36,23,7,49,85,0 days 00:00:00.112259
vuejs/vetur,2, v,23,12,6,47,70,0 days 00:00:00.235664
google/ios-webkit-debug-proxy,2, v,9,2,5,9,18,0 days 00:00:00.021307
graphql-java/graphql-java,2, v,40,13,14,2,42,0 days 00:00:00.191001
sockeqwe/mosby,1,,7,3,2,8,15,0 days 00:00:00.038843
tilt-dev/tilt,1,v,30,18,4,172,202,0 days 00:00:00.344545
Lexikos/AutoHotkey_L,2,L v,56,48,2,146,202,0 days 00:00:00.184085
antonioru/beautiful-react-hooks,1,,5,2,1,6,11,0 days 00:00:00.035276
gzu-liyujiang/AndroidPicker,1,,11,3,5,45,56,0 days 00:00:00.045853
benbusby/whoogle-search,2, v,7,1,2,15,22,0 days 00:00:00.047014
dinerojs/dinero.js,2, v,13,8,3,17,30,0 days 00:00:00.041039
dotnetcore/CAP,1,v,22,5,11,30,52,0 days 00:00:00.115666
nl8590687/ASRT_SpeechRecognition,1,v,10,4,4,4,14,0 days 00:00:00.024924
express-validator/express-validator,1,v,55,29,15,60,115,0 days 00:00:00.113280
doctrine/common,2, v,18,1,16,31,49,0 days 00:00:00.352481
pagekit/pagekit,1,,4,1,2,31,35,0 days 00:00:00.349277
tensorflow/serving,2, r,25,6,10,27,52,0 days 00:00:00.452219
expressjs/cors,1,v,11,3,5,23,34,0 days 00:00:00.025200
hashicorp/serf,1,v,9,3,3,22,31,0 days 00:00:00.221226
mikaelbr/node-notifier,1,v,24,4,13,45,69,0 days 00:00:00.057010
jackc/pgx,1,v,36,11,14,18,54,0 days 00:00:00.254570
bfenetworks/bfe,1,v,18,10,3,0,18,0 days 00:00:00.068147
missive/emoji-mart,1,v,20,8,7,40,60,0 days 00:00:00.062711
jrnl-org/jrnl,2, v,13,2,5,24,37,0 days 00:00:00.105107
MinecraftForge/MinecraftForge,2, v,59,33,13,10,69,0 days 00:00:00.697627
jbaysolutions/vue-grid-layout,1,,5,1,1,29,34,0 days 00:00:00.031020
johnkerl/miller,2, v,29,15,8,23,52,0 days 00:00:00.504482
evernote/android-job,1,v,4,1,2,36,40,0 days 00:00:00.038032
lutris/lutris,2, v,3,1,1,63,66,0 days 00:00:00.367039
jaywcjlove/hotkeys,1,v,12,4,7,62,74,0 days 00:00:00.045432
serilog/serilog,1,v,19,3,7,13,32,0 days 00:00:00.109088
SixLabors/ImageSharp,1,v,3,1,1,6,9,0 days 00:00:01.241500
NVIDIA/TensorRT,2, v,27,17,2,6,33,0 days 00:00:00.032970
jonls/redshift,2, v,17,6,7,2,19,0 days 00:00:00.047251
angular-ui/ui-grid,1,v,24,10,11,86,110,0 days 00:00:00.294540
gcanti/io-ts,1,,20,10,3,84,104,0 days 00:00:00.060025
valor-software/ngx-bootstrap,2, v,31,15,9,81,112,0 days 00:00:00.164456
weaveworks/scope,2, v,31,17,5,30,61,0 days 00:00:00.406138
algolia/places,1,v,34,26,4,69,103,0 days 00:00:00.095477
anishathalye/dotbot,1,v,20,6,11,28,48,0 days 00:00:00.031776
nathancahill/split,2, v,10,5,3,38,48,0 days 00:00:00.031736
jonschlinkert/remarkable,2, v,9,6,2,13,22,0 days 00:00:00.038359
fatih/color,1,v,16,4,10,1,17,0 days 00:00:00.019547
ppoffice/hexo-theme-icarus,2, v,22,9,9,9,31,0 days 00:00:00.044723
ly525/luban-h5,1,v,18,12,3,14,32,0 days 00:00:00.047417
chyroc/WechatSogou,1,v,8,1,3,15,23,0 days 00:00:00.023549
kaorun343/vue-property-decorator,1,v,24,8,5,16,40,0 days 00:00:00.036213
mwouts/jupytext,3, v. v,20,10,7,75,95,0 days 00:00:00.140694
mixn/carbon-now-cli,2, v,5,2,1,7,12,0 days 00:00:00.023757
arachnys/cabot,1,,6,4,1,33,39,0 days 00:00:00.053577
go-flutter-desktop/go-flutter,1,v,39,33,3,15,54,0 days 00:00:00.046908
go-acme/lego,1,v,34,15,7,17,51,0 days 00:00:00.080505
log4js-node/log4js-node,1,v,32,19,9,90,122,0 days 00:00:00.229524
open-cli-tools/concurrently,2, v,27,7,14,18,45,0 days 00:00:00.037068
gorakhargosh/watchdog,1,v,12,2,6,35,47,0 days 00:00:00.079514
agentejo/cockpit,1,,8,1,5,27,35,0 days 00:00:00.163964
alan-turing-institute/sktime,1,v,10,1,4,14,24,0 days 00:00:00.242321
bytedance/xgplayer,1,v,4,1,2,44,48,0 days 00:00:00.057109
barryvdh/laravel-dompdf,1,v,10,1,8,24,34,0 days 00:00:00.024837
devicons/devicon,1,v,17,6,5,4,21,0 days 00:00:00.068360
berty/berty,1,v,390,387,1,579,969,0 days 00:00:01.520813
PyGithub/PyGithub,2, v,62,40,9,23,85,0 days 00:00:00.129564
django/channels,1,,20,9,8,44,64,0 days 00:00:00.088931
oauth2-proxy/oauth2-proxy,1,v,18,1,10,9,27,0 days 00:00:00.211050
i-tu/Hasklig,2, v,12,5,4,0,12,0 days 00:00:00.061851
domlysz/BlenderGIS,2, v,3,1,1,0,3,0 days 00:00:00.032824
tjanczuk/edge,1,v,11,5,5,23,34,0 days 00:00:00.047854
encode/uvicorn,1,,17,4,4,119,136,0 days 00:00:00.092319
leongersen/noUiSlider,1,,45,19,16,58,103,0 days 00:00:00.077500
ExactTarget/fuelux,1,,25,10,6,59,84,0 days 00:00:00.290069
containers/buildah,3, V v,42,22,3,70,112,0 days 00:00:00.448037
tzapu/WiFiManager,2, v,16,10,3,0,16,0 days 00:00:00.032069
alibaba/transmittable-thread-local,2, v,18,6,8,31,49,0 days 00:00:00.057856
arturbien/React95,1,v,13,7,3,6,19,0 days 00:00:00.043514
h6ah4i/android-advancedrecyclerview,1,,8,1,6,22,30,0 days 00:00:00.043142
crowdsecurity/crowdsec,1,v,7,1,3,39,46,0 days 00:00:00.064509
substack/minimist,1,,6,2,2,20,26,0 days 00:00:00.015542
wasabeef/Blurry,1,,6,1,4,7,13,0 days 00:00:00.015937
mher/flower,1,v,9,1,6,15,24,0 days 00:00:00.086669
graphql-dotnet/graphql-dotnet,2, v,42,24,7,45,87,0 days 00:00:00.137694
kartik-v/bootstrap-fileinput,1,v,26,18,7,61,87,0 days 00:00:00.084538
release-it/release-it,1,,84,66,12,176,260,0 days 00:00:00.176250
go-task/task,1,v,26,9,7,26,52,0 days 00:00:00.076877
nodegit/nodegit,1,v,27,9,10,67,94,0 days 00:00:00.223172
crossplane/crossplane,1,v,23,11,3,34,57,0 days 00:00:00.335006
naver/billboard.js,1,,21,1,13,54,75,0 days 00:00:00.237349
sachinchoolur/lightGallery,2, v,16,4,8,66,82,0 days 00:00:00.070199
phan/phan,1,,33,13,10,127,160,0 days 00:00:00.417682
nhn/tui.image-editor,2, v,21,7,12,17,38,0 days 00:00:00.057334
bestiejs/benchmark.js,1,,5,2,2,19,24,0 days 00:00:00.062722
chainer/chainer,1,v,60,47,3,18,78,0 days 00:00:02.201579
wangyu-/udp2raw,1,,38,31,2,0,38,0 days 00:00:00.049702
vrana/adminer,1,v,17,4,11,35,52,0 days 00:00:00.301950
snorkel-team/snorkel,1,v,4,1,2,11,15,0 days 00:00:00.246959
GoogleChrome/lighthouse-ci,1,v,9,1,5,24,33,0 days 00:00:00.057297
share/sharedb,1,v,23,7,9,111,134,0 days 00:00:00.214671
onionshare/onionshare,2, v,18,5,11,9,27,0 days 00:00:00.417429
windicss/windicss,1,v,13,8,1,81,94,0 days 00:00:00.071411
arkime/arkime,1,v,32,2,17,70,102,0 days 00:00:00.402868
hiroppy/fusuma,1,v,37,32,3,59,96,0 days 00:00:00.270641
microsoft/Windows-driver-samples,1,,609,57,1,0,609,0 days 00:00:00.431592
rmax/scrapy-redis,2, v,6,1,3,12,18,0 days 00:00:00.021222
vuejs/v2.vuejs.org,1,v,8,4,3,9,17,0 days 00:00:00.035665
lancedikson/bowser,2, v,26,11,8,33,59,0 days 00:00:00.084217
ai/size-limit,1,,45,29,7,101,146,0 days 00:00:00.095631
timolins/react-hot-toast,1,v,7,3,2,5,12,0 days 00:00:00.025048
reviewdog/reviewdog,2, v,6,1,4,21,27,0 days 00:00:00.159693
reactchartjs/react-chartjs-2,3, v. v,24,9,9,51,75,0 days 00:00:00.051274
laravel/socialite,1,v,18,2,9,62,80,0 days 00:00:00.065479
luraproject/lura,2, v,15,2,10,12,27,0 days 00:00:00.050142
nhn/tui.chart,2, v,38,21,8,60,98,0 days 00:00:00.161272
msiemens/tinydb,2, v,34,10,16,26,60,0 days 00:00:00.065258
reek/anti-adblock-killer,1,v,31,29,1,0,31,0 days 00:00:00.034836
rectorphp/rector,2, v,13,1,9,351,364,0 days 00:00:01.204434
expressjs/body-parser,1,,21,9,8,47,68,0 days 00:00:00.048995
openpgpjs/openpgpjs,1,v,40,18,13,109,149,0 days 00:00:00.200791
jarun/buku,2, v,36,18,6,3,39,0 days 00:00:00.113113
standard-things/esm,1,,29,27,1,160,189,0 days 00:00:00.410189
btraceio/btrace,3, release- v,5,1,2,34,39,0 days 00:00:00.081060
TommyLemon/Android-ZBLibrary,1,,21,13,4,4,25,0 days 00:00:00.036980
jvm-profiling-tools/async-profiler,1,v,14,2,9,9,23,0 days 00:00:00.137580
healthchecks/healthchecks,2, v,28,10,1,8,36,0 days 00:00:00.150130
pypa/pipx,1,,15,7,5,36,51,0 days 00:00:00.045564
journeyapps/zxing-android-embedded,1,v,15,4,9,7,22,0 days 00:00:00.069764
minbrowser/min,2, v,26,4,8,31,57,0 days 00:00:00.154295
spectreconsole/spectre.console,1,,44,38,1,3,47,0 days 00:00:00.046613
Mailtrain-org/mailtrain,1,v,25,20,2,10,35,0 days 00:00:00.082755
laravel-mix/laravel-mix,1,v,27,19,3,105,132,0 days 00:00:00.214666
istanbuljs/nyc,1,v,58,43,4,56,114,0 days 00:00:00.081313
wiremock/wiremock,2, release-,55,28,16,28,83,0 days 00:00:00.151294
lukeed/polka,1,v,5,2,2,9,14,0 days 00:00:00.022950
uber/prototool,1,v,18,13,3,2,20,0 days 00:00:00.034310
Snapchat/KeyDB,1,v,6,1,2,16,22,0 days 00:00:01.631745
zhaojun1998/zfile,1,,32,26,3,11,43,0 days 00:00:00.035269
ZipArchive/ZipArchive,2, v,17,4,9,80,97,0 days 00:00:00.065734
json5/json5,1,v,10,1,7,8,18,0 days 00:00:00.032664
aws/aws-sdk-php,1,,234,217,7,1228,1462,0 days 00:00:02.597472
uNetworking/uWebSockets.js,1,v,59,51,3,6,65,0 days 00:00:00.067625
material-shell/material-shell,2, v,11,7,2,0,11,0 days 00:00:00.052189
kedacore/keda,1,v,14,3,4,3,17,0 days 00:00:00.104692
timber/timber,2, v,32,10,14,96,128,0 days 00:00:00.321918
johannesjo/super-productivity,1,v,58,48,3,296,354,0 days 00:00:00.695424
rauchg/slackin,1,,14,8,3,26,40,0 days 00:00:00.029117
google/benchmark,1,v,8,2,5,9,17,0 days 00:00:00.074994
pedroslopez/whatsapp-web.js,1,v,18,8,3,39,57,0 days 00:00:00.044337
panjf2000/gnet,1,v,8,2,5,35,43,0 days 00:00:00.167149
Angel-ML/angel,2,Release- v,14,2,6,4,18,0 days 00:00:00.158836
fengyuanchen/viewerjs,1,v,21,6,10,28,49,0 days 00:00:00.039747
kubeedge/kubeedge,1,v,14,1,10,11,25,0 days 00:00:00.273409
reactjs/react-rails,2, v,24,9,9,31,55,0 days 00:00:00.102182
docker/machine,2, v,16,2,8,16,32,0 days 00:00:00.234617
roadrunner-server/roadrunner,2, v,22,7,7,81,103,0 days 00:00:00.210770
vitalets/x-editable,1,,6,4,1,9,15,0 days 00:00:00.036036
SigmaHQ/sigma,1,,19,6,6,10,29,0 days 00:00:00.743306
meetecho/janus-gateway,1,v,11,1,7,53,64,0 days 00:00:00.279040
ponylang/ponyc,2, release-,51,31,9,56,107,0 days 00:00:00.489986
LonamiWebs/Telethon,1,v,44,26,4,91,135,0 days 00:00:00.270886
sghall/react-move,1,v,28,19,7,21,49,0 days 00:00:00.044227
hajimehoshi/ebiten,1,v,17,2,13,66,83,0 days 00:00:00.394366
go-admin-team/go-admin,1,v,6,1,3,27,33,0 days 00:00:00.084396
glidejs/glide,1,v,8,1,5,25,33,0 days 00:00:00.043081
hotoo/pinyin,1,,13,1,10,28,41,0 days 00:00:00.033353
espnet/espnet,1,v.,11,1,6,32,43,0 days 00:00:00.967519
mobxjs/mobx-state-tree,2, v,38,28,7,64,102,0 days 00:00:00.252442
0x7c13/Notepads,1,v,14,9,2,42,56,0 days 00:00:00.066776
electronicarts/EASTL,1,,14,1,8,31,45,0 days 00:00:00.036950
ServiceStack/ServiceStack,1,v,17,2,12,41,58,0 days 00:00:00.842233
boto/boto,2, v,50,28,10,29,79,0 days 00:00:00.527043
wilsonpage/fastdom,2, v,8,5,2,23,31,0 days 00:00:00.029632
ocrmypdf/OCRmyPDF,1,v,63,40,7,115,178,0 days 00:00:00.310854
electerm/electerm,2, v,35,23,5,292,327,0 days 00:00:00.211513
mbdavid/LiteDB,2,v. v,8,1,3,27,35,0 days 00:00:00.125235
baconjs/bacon.js,1,,9,3,3,200,209,0 days 00:00:00.223035
sebastianbergmann/exporter,1,,7,2,4,12,19,0 days 00:00:00.040013
mRemoteNG/mRemoteNG,2, v,17,9,7,23,40,0 days 00:00:00.238974
zendesk/android-floating-action-button,1,,11,9,1,4,15,0 days 00:00:00.017934
zo0r/react-native-push-notification,2, v,16,10,2,19,35,0 days 00:00:00.057298
kelektiv/node.bcrypt.js,2, v,11,1,9,39,50,0 days 00:00:00.044607
rs/zerolog,1,v,27,9,8,16,43,0 days 00:00:00.032246
houtianze/bypy,1,,5,1,2,69,74,0 days 00:00:00.049234
appleboy/gorush,2, v,16,6,8,15,31,0 days 00:00:00.057910
doctrine/annotations,2, v,14,1,9,20,34,0 days 00:00:00.281985
rancher/os,1,v,15,4,6,43,58,0 days 00:00:00.159411
opencart/opencart,1,,11,4,5,24,35,0 days 00:00:00.910328
sindresorhus/caprine,2, v,70,49,3,43,113,0 days 00:00:00.074879
linkedin/css-blocks,2, v,17,9,4,22,39,0 days 00:00:00.192387
Squirrel/Squirrel.Windows,1,,17,5,7,48,65,0 days 00:00:00.081007
optuna/optuna,1,v,36,27,2,4,40,0 days 00:00:00.741352
the-benchmarker/web-frameworks,2, v,3,1,1,13,16,0 days 00:00:00.056191
conventional-changelog/standard-version,1,v,24,8,13,13,37,0 days 00:00:00.033604
mautic/mautic,1,,30,6,13,59,89,0 days 00:00:01.861577
sebastianbergmann/environment,1,,11,1,6,27,38,0 days 00:00:00.164900
yugabyte/yugabyte-db,2, v,18,1,12,73,91,0 days 00:00:01.025912
ramboxapp/community-edition,1,,7,3,3,36,43,0 days 00:00:00.079802
gocd/gocd,1,,69,48,4,2,71,0 days 00:00:00.994494
kpdecker/jsdiff,1,v,15,3,9,24,39,0 days 00:00:00.134036
dylanaraps/pywal,1,,17,10,2,65,82,0 days 00:00:00.081555
simeji/jid,2, v,7,4,1,14,21,0 days 00:00:00.018036
Uberi/speech_recognition,1,,16,6,6,29,45,0 days 00:00:00.037034
graphql/express-graphql,1,v,12,3,7,31,43,0 days 00:00:00.058072
isomorphic-git/isomorphic-git,1,v,96,86,3,238,334,0 days 00:00:00.222236
vmware-tanzu/velero,1,v,17,2,8,43,60,0 days 00:00:00.236488
automl/auto-sklearn,3, v. v,12,2,6,21,33,0 days 00:00:00.224120
Cyan4973/xxHash,2,r v,12,4,4,11,23,0 days 00:00:00.074291
katspaugh/wavesurfer.js,2, v,26,5,10,105,131,0 days 00:00:00.112268
baldurk/renderdoc,1,v,39,6,11,0,39,0 days 00:00:00.944604
invoiceninja/invoiceninja,1,v,41,21,5,387,428,0 days 00:00:01.507253
arc298/instagram-scraper,2, v,11,3,4,68,79,0 days 00:00:00.047275
FreeRDP/FreeRDP,1,,9,2,4,8,17,0 days 00:00:01.018632
node-formidable/formidable,2, v,12,8,3,33,45,0 days 00:00:00.050586
maxogden/menubar,1,v,18,4,8,47,65,0 days 00:00:00.036072
PHPOffice/PHPWord,1,,12,3,7,8,20,0 days 00:00:00.127744
feross/simple-peer,1,v,50,34,10,71,121,0 days 00:00:00.122717
elasticsearch-dump/elasticsearch-dump,2, v,113,92,6,137,250,0 days 00:00:00.176378
symfony/translation,1,v,26,4,21,462,488,0 days 00:00:00.537255
albertlauncher/albert,1,v,17,9,5,64,81,0 days 00:00:00.106652
Radarr/Radarr,2, v,99,64,14,13,112,0 days 00:00:00.773305
dtm-labs/dtm,1,v,21,18,1,35,56,0 days 00:00:00.087696
JetBrains/Exposed,1,,8,3,3,78,86,0 days 00:00:00.115959
99designs/aws-vault,1,v,34,17,9,32,66,0 days 00:00:00.203154
doccano/doccano,1,v,8,2,3,19,27,0 days 00:00:00.273625
yocontra/react-responsive,1,v,8,2,4,28,36,0 days 00:00:00.029560
StackExchange/blackbox,1,v,18,6,8,0,18,0 days 00:00:00.037988
amoffat/sh,1,,34,26,5,17,51,0 days 00:00:00.097438
apache/storm,2, v,11,1,9,26,37,0 days 00:00:00.986035
gitalk/gitalk,1,v,5,1,3,16,21,0 days 00:00:00.020077
Zizaco/entrust,1,,10,2,7,8,18,0 days 00:00:00.034615
i18next/i18next,2, v,91,66,9,222,313,0 days 00:00:00.234712
jackocnr/intl-tel-input,2, v,62,41,10,262,324,0 days 00:00:00.362413
react-native-video/react-native-video,2, v,24,13,7,49,73,0 days 00:00:00.110587
go-resty/resty,1,v,34,14,10,7,41,0 days 00:00:00.046486
RichardKnop/machinery,1,v,11,1,7,86,97,0 days 00:00:00.086936
yagop/node-telegram-bot-api,1,v,26,14,6,13,39,0 days 00:00:00.049410
DIYgod/APlayer,2, v,6,3,2,15,21,0 days 00:00:00.031863
shentao/vue-multiselect,2, v,5,2,1,20,25,0 days 00:00:00.033892
maxence-charriere/go-app,2, v,37,24,6,69,106,0 days 00:00:00.086554
jiaaro/pydub,1,v,17,3,9,19,36,0 days 00:00:00.056336
medialize/URI.js,2,v. v,20,7,11,54,74,0 days 00:00:00.164334
NixOS/nix,1,,37,5,23,53,90,0 days 00:00:00.840470
baskerville/bspwm,1,,9,5,1,15,24,0 days 00:00:00.090207
dataarts/dat.gui,2, v,6,1,2,18,24,0 days 00:00:00.041658
software-mansion/react-native-reanimated,1,,23,10,2,19,42,0 days 00:00:00.106061
swaggo/swag,2,v. v,9,1,5,23,32,0 days 00:00:00.046533
redux-offline/redux-offline,2, v,7,1,4,9,16,0 days 00:00:00.037887
thephpleague/oauth2-server,1,,25,3,11,72,97,0 days 00:00:00.171924
bpmn-io/bpmn-js,2, v,75,46,7,155,230,0 days 00:00:00.252840
ArthurHub/Android-Image-Cropper,1,,9,2,6,23,32,0 days 00:00:00.039287
simonw/datasette,1,,55,43,6,39,94,0 days 00:00:00.139037
faker-js/faker,1,v,22,10,9,26,48,0 days 00:00:00.137380
fruitcake/laravel-cors,2,V v,16,5,10,33,49,0 days 00:00:00.035390
gruntwork-io/terratest,1,v,39,21,9,296,335,0 days 00:00:00.309270
securego/gosec,2, v,16,3,8,8,24,0 days 00:00:00.188908
electerious/Lychee,2, v,11,1,6,31,42,0 days 00:00:00.087888
garris/BackstopJS,2, v,25,9,8,106,131,0 days 00:00:00.116784
dylang/npm-check,2, v,12,4,6,33,45,0 days 00:00:00.030262
centrifugal/centrifugo,1,v,24,5,9,57,81,0 days 00:00:00.090497
belluzj/fantasque-sans,2, v,5,1,2,10,15,0 days 00:00:00.020595
pahen/madge,2, v,30,13,11,29,59,0 days 00:00:00.039441
react-native-svg/react-native-svg,2, v,45,30,7,164,209,0 days 00:00:00.166895
chrismaltby/gb-studio,2, v,6,3,2,6,12,0 days 00:00:00.330697
marshmallow-code/marshmallow,1,,48,22,11,77,125,0 days 00:00:00.344647
uber/cadence,1,v,22,9,7,55,77,0 days 00:00:00.222155
snipe/snipe-it,3, V v,30,12,13,130,160,0 days 00:00:00.729590
PaddlePaddle/Paddle-Lite,3, release/ v,15,4,7,6,21,0 days 00:00:00.466539
gsoft-inc/craco,1,v,32,24,2,27,59,0 days 00:00:00.044424
tindy2013/subconverter,1,v,7,3,2,28,35,0 days 00:00:00.047649
jenssegers/laravel-mongodb,2, v,19,3,12,91,110,0 days 00:00:00.098924
concourse/concourse,1,v,134,117,4,81,215,0 days 00:00:01.791385
crater-invoice/crater,1,,11,4,4,19,30,0 days 00:00:00.095385
aws/aws-sam-cli,1,v,96,89,1,36,132,0 days 00:00:00.149033
thedevs-network/kutt,1,v,10,5,2,51,61,0 days 00:00:00.050774
chancejs/chancejs,2, v,9,3,5,47,56,0 days 00:00:00.151476
mcollina/autocannon,1,v,52,36,9,43,95,0 days 00:00:00.063858
filhodanuvem/gitql,2, v,10,2,6,8,18,0 days 00:00:00.024386
supertokens/supertokens-core,1,v,22,15,2,17,39,0 days 00:00:00.050350
SocketCluster/socketcluster,3, v. v,17,13,3,26,43,0 days 00:00:00.073489
flot/flot,2, v,16,6,7,35,51,0 days 00:00:00.087563
hashicorp/raft,1,v,5,1,3,15,20,0 days 00:00:00.060630
onsi/ginkgo,1,v,19,3,11,21,40,0 days 00:00:00.064166
reactiveui/refit,2, v,13,3,6,39,52,0 days 00:00:00.133915
wojtekmaj/react-pdf,1,v,27,13,6,36,63,0 days 00:00:00.199201
burnash/gspread,2, v,19,9,8,21,40,0 days 00:00:00.072329
google/error-prone,1,v,15,3,5,34,49,0 days 00:00:00.317497
fabiospampinato/cash,1,,16,8,5,36,52,0 days 00:00:00.053262
xonsh/xonsh,1,,12,1,10,100,112,0 days 00:00:00.679057
sindresorhus/query-string,2, v,34,12,12,38,72,0 days 00:00:00.032631
OJ/gobuster,1,v,11,1,7,4,15,0 days 00:00:00.036421
karatelabs/karate,1,v,11,1,6,27,38,0 days 00:00:00.228373
bytedeco/javacv,1,,17,1,14,14,31,0 days 00:00:00.047999
plantuml/plantuml,1,v,9,2,4,78,87,0 days 00:00:00.212914
jazzband/pip-tools,1,,45,22,12,49,94,0 days 00:00:00.232681
ractivejs/ractive,1,v,10,1,6,88,98,0 days 00:00:00.172397
trpc/trpc,2, v,57,54,1,48,105,0 days 00:00:00.143766
platformio/platformio-core,3, v. v,43,22,13,72,115,0 days 00:00:00.310153
Graylog2/graylog2-server,1,,25,1,20,124,149,0 days 00:00:01.518616
heroiclabs/nakama,1,v,38,17,5,29,67,0 days 00:00:00.087157
rest-assured/rest-assured,1,rest-assured-,32,6,15,40,72,0 days 00:00:00.137216
ianstormtaylor/superstruct,1,v,14,7,4,55,69,0 days 00:00:00.063922
webslides/WebSlides,1,,7,4,1,7,14,0 days 00:00:00.034956
perkeep/perkeep,1,,11,5,5,0,11,0 days 00:00:00.464695
File-New-Project/EarTrumpet,1,,9,2,6,29,38,0 days 00:00:00.083734
spulec/moto,2, v,14,2,8,152,166,0 days 00:00:00.535826
moroshko/react-autosuggest,1,v,41,30,6,54,95,0 days 00:00:00.062888
gruntwork-io/terragrunt,1,v,37,18,12,337,374,0 days 00:00:00.299343
geerlingguy/ansible-for-devops,1,,32,16,9,1,33,0 days 00:00:00.035734
Unleash/unleash,2, v,34,19,7,132,166,0 days 00:00:00.328616
Shougo/deoplete.nvim,1,,14,1,11,0,14,0 days 00:00:00.249093
twitchtv/twirp,1,v,18,8,8,10,28,0 days 00:00:00.047830
kulshekhar/ts-jest,2, v,30,14,8,88,118,0 days 00:00:00.364092
sparklemotion/nokogiri,2,REL_ v,15,2,10,89,104,0 days 00:00:00.502295
airbnb/hypernova,1,v,9,1,4,8,17,0 days 00:00:00.019843
neuecc/UniRx,1,,18,8,5,7,25,0 days 00:00:00.061123
yuliskov/SmartTubeNext,1,,73,54,1,0,73,0 days 00:00:00.354053
postmanlabs/newman,3, v. v,26,8,8,80,106,0 days 00:00:00.361013
mahmoud/boltons,1,,24,9,9,21,45,0 days 00:00:00.091683
davidjbradshaw/iframe-resizer,2, v,26,16,7,96,122,0 days 00:00:00.109085
mitchellh/mapstructure,1,v,6,2,3,11,17,0 days 00:00:00.029458
cupy/cupy,1,v,56,48,1,6,62,0 days 00:00:02.277992
weibocom/motan,1,,5,1,3,17,22,0 days 00:00:00.038275
ethereum-mining/ethminer,1,v,10,1,5,3,13,0 days 00:00:01.038331
vmware-tanzu/octant,1,v,25,16,3,15,40,0 days 00:00:00.264234
TypeStrong/typedoc,2, v,22,3,13,127,149,0 days 00:00:00.167539
travist/jsencrypt,2, v,7,2,3,3,10,0 days 00:00:00.021468
react-native-device-info/react-native-device-info,1,v,57,43,7,114,171,0 days 00:00:00.229414
Jrohy/multi-v2ray,1,v,18,10,4,79,97,0 days 00:00:00.135463
voidcosmos/npkill,1,v,8,5,2,19,27,0 days 00:00:00.036234
pentaho/pentaho-kettle,1,,31,10,16,37,68,0 days 00:00:00.977810
Financial-Times/polyfill-service,2, v,87,65,5,87,174,0 days 00:00:00.353200
python-visualization/folium,1,v,11,1,7,10,21,0 days 00:00:00.114300
HMBSbige/ShadowsocksR-Windows,1,,28,12,13,127,155,0 days 00:00:00.147972
vuejs/vue-class-component,1,v,10,2,5,15,25,0 days 00:00:00.028545
gevent/gevent,2, v,19,4,12,35,54,0 days 00:00:00.504586
deepmipt/DeepPavlov,1,,17,6,4,28,45,0 days 00:00:00.147633
plasma-umass/scalene,2, v,3,1,1,22,25,0 days 00:00:00.116542
redux-observable/redux-observable,2, v,23,13,7,8,31,0 days 00:00:00.041047
mattn/go-sqlite3,1,v,16,4,7,19,35,0 days 00:00:00.193666
PrestaShop/PrestaShop,1,,30,14,3,83,113,0 days 00:00:04.561114
kelseyhightower/confd,1,v,15,3,8,7,22,0 days 00:00:00.069976
vercel/serve,2, v,49,34,7,96,145,0 days 00:00:00.085964
taigaio/taiga-back,1,,24,7,9,74,98,0 days 00:00:00.248668
UKPLab/sentence-transformers,1,v,10,3,5,20,30,0 days 00:00:00.064539
jsx-eslint/eslint-plugin-react,1,v,81,55,6,88,169,0 days 00:00:00.269358
mozilla/nunjucks,3, v. v,14,1,7,37,51,0 days 00:00:00.090791
brython-dev/brython,1,,12,1,9,46,58,0 days 00:00:00.416310
carla-simulator/carla,1,,9,4,3,38,47,0 days 00:00:00.261042
adnanh/webhook,1,,9,5,3,21,30,0 days 00:00:00.038853
gcanti/fp-ts,1,,38,23,8,115,153,0 days 00:00:00.180093
metalsmith/metalsmith,2, v,24,15,3,60,84,0 days 00:00:00.048600
ffmpegwasm/ffmpeg.wasm,1,v,10,6,2,18,28,0 days 00:00:00.025146
sindresorhus/type-fest,1,v,40,29,3,34,74,0 days 00:00:00.039180
remix-run/history,1,v,38,24,7,40,78,0 days 00:00:00.083111
cortexlabs/cortex,1,v,42,36,1,20,62,0 days 00:00:00.158876
hybridgroup/gobot,3, v. v,29,10,11,16,45,0 days 00:00:00.281788
hoffstadt/DearPyGui,1,v,8,4,1,10,18,0 days 00:00:00.513512
alibaba/formily,1,v,9,1,4,85,94,0 days 00:00:00.177874
colinhacks/zod,2, v,20,15,2,23,43,0 days 00:00:00.097633
rebassjs/rebass,1,v,11,3,5,42,53,0 days 00:00:00.121381
beautify-web/js-beautify,1,v,13,3,7,74,87,0 days 00:00:00.271606
BeyondDimension/SteamTools,1,,10,6,3,28,38,0 days 00:00:00.300901
mvt-project/mvt,1,v,4,2,1,36,40,0 days 00:00:00.038955
mrdoob/stats.js,1,r,16,6,8,0,16,0 days 00:00:00.017078
probot/probot,2, v,71,58,3,124,195,0 days 00:00:00.173043
sindresorhus/ora,1,v,24,9,9,13,37,0 days 00:00:00.023352
prompt-toolkit/python-prompt-toolkit,1,,5,1,1,51,56,0 days 00:00:00.232924
nodegui/nodegui,1,v,48,42,1,45,93,0 days 00:00:00.092334
yjs/yjs,1,v,19,9,8,151,170,0 days 00:00:00.172909
chromedp/chromedp,1,v,8,1,5,33,41,0 days 00:00:00.046689
tailscale/tailscale,1,v,19,8,2,54,73,0 days 00:00:00.284937
yiminghe/async-validator,2, v,18,4,11,59,77,0 days 00:00:00.038339
paramiko/paramiko,3, release- v,23,3,13,152,175,0 days 00:00:00.262787
signalapp/Signal-Server,1,v,215,206,2,18,233,0 days 00:00:00.214280
theonedev/onedev,2, v,26,17,2,131,157,0 days 00:00:00.289728
kubernetes/kompose,1,v,34,22,6,3,37,0 days 00:00:00.096223
sindresorhus/ky,1,v,29,15,2,18,47,0 days 00:00:00.030053
go-swagger/go-swagger,2, v,29,8,11,26,55,0 days 00:00:00.357204
ckeditor/ckeditor5,2, v,48,30,3,6,54,0 days 00:00:03.486082
developit/mitt,2, v,6,1,3,5,11,0 days 00:00:00.019438
99designs/gqlgen,2, v,16,7,6,35,51,0 days 00:00:00.152411
react-native-image-picker/react-native-image-picker,2, v,37,22,8,86,123,0 days 00:00:00.074150
react-grid-layout/react-draggable,1,v,24,9,7,57,81,0 days 00:00:00.053951
swagger-api/swagger-editor,3, v/ v,27,11,11,364,391,0 days 00:00:00.491258
QuantConnect/Lean,2, v,1917,1077,4,10,1927,0 days 00:00:04.961682
konvajs/konva,1,,41,18,8,131,172,0 days 00:00:00.271615
chaijs/chai,2, v,30,11,9,48,78,0 days 00:00:00.104465
akveo/nebular,1,v,23,9,4,23,46,0 days 00:00:00.136381
symfony/http-kernel,1,v,26,4,21,489,515,0 days 00:00:00.744522
retejs/rete,2, v,12,4,3,35,47,0 days 00:00:00.037996
go-vgo/robotgo,2, v,21,4,9,24,45,0 days 00:00:00.072409
NginxProxyManager/nginx-proxy-manager,2, v,10,4,2,48,58,0 days 00:00:00.209751
dropwizard/metrics,1,v,10,1,8,77,87,0 days 00:00:00.407540
isaacs/node-glob,2, v,18,5,10,102,120,0 days 00:00:00.062725
streamlink/streamlink,1,,30,9,7,17,47,0 days 00:00:00.236456
visionmedia/page.js,2, v,10,3,4,29,39,0 days 00:00:00.049765
HangfireIO/Hangfire,2,v. v,13,4,4,92,105,0 days 00:00:00.197307
xupefei/Locale-Emulator,2, v,13,7,5,14,27,0 days 00:00:00.030928
secdev/scapy,1,v,80,71,8,432,512,0 days 00:00:00.748211
prometheus/node_exporter,2, v,17,2,12,11,28,0 days 00:00:00.148334
trustedsec/social-engineer-toolkit,1,,17,4,9,87,104,0 days 00:00:00.841701
DaveGamble/cJSON,1,v,9,5,1,36,45,0 days 00:00:00.083463
guzzle/psr7,1,,12,1,9,17,29,0 days 00:00:00.049124
twigphp/Twig,1,v,66,29,23,139,205,0 days 00:00:00.502356
metricsgraphics/metrics-graphics,3,V v. v,25,12,5,10,35,0 days 00:00:00.107764
doctrine/cache,2, v,17,4,9,27,44,0 days 00:00:00.063956
InsertKoinIO/koin,1,,13,5,6,33,46,0 days 00:00:00.134615
symfony/polyfill-mbstring,1,v,25,2,13,9,34,0 days 00:00:00.019461
FormidableLabs/radium,1,v,17,6,6,46,63,0 days 00:00:00.076033
react-cosmos/react-cosmos,2, v,33,18,8,41,74,0 days 00:00:00.243325
ionic-team/capacitor,2, v,18,6,3,138,156,0 days 00:00:00.393861
webdriverio/webdriverio,1,v,91,65,12,415,506,0 days 00:00:00.996115
altair-viz/altair,2, v,13,3,7,8,21,0 days 00:00:00.266232
openspug/spug,2,V v,8,3,3,34,42,0 days 00:00:00.071910
wix/react-native-calendars,2, v,1248,229,2,59,1307,0 days 00:00:01.996932
kelektiv/node-cron,2, v,12,2,8,23,35,0 days 00:00:00.033805
oclif/oclif,1,v,59,50,5,261,320,0 days 00:00:00.202653
webpack/webpack-dev-server,1,v,42,25,9,70,112,0 days 00:00:00.162750
cryptomator/cryptomator,1,,18,7,6,73,91,0 days 00:00:00.246116
gogf/gf,1,v,14,2,4,106,120,0 days 00:00:00.336920
gotify/server,1,v,5,1,3,41,46,0 days 00:00:00.039173
krallin/tini,1,v,19,6,6,14,33,0 days 00:00:00.026338
lanpa/tensorboardX,1,v,15,2,9,1,16,0 days 00:00:00.035315
facebook/jscodeshift,2, v,11,1,8,45,56,0 days 00:00:00.039014
lib/pq,1,v,11,3,5,10,21,0 days 00:00:00.050373
LeetCode-OpenSource/vscode-leetcode,1,v,17,9,4,26,43,0 days 00:00:00.030694
sosedoff/pgweb,1,v,11,6,3,31,42,0 days 00:00:00.068897
Supervisor/supervisor,1,,8,1,6,22,30,0 days 00:00:00.147412
sandboxie-plus/Sandboxie,2, v,11,3,4,58,69,0 days 00:00:00.103506
mopidy/mopidy,1,v,29,6,16,38,67,0 days 00:00:00.510412
cerebroapp/cerebro,2, v,5,1,3,16,21,0 days 00:00:00.046908
numba/numba,2, v,54,9,8,51,105,0 days 00:00:01.606687
Sonarr/Sonarr,1,v,44,27,6,8,52,0 days 00:00:00.620461
symfony/debug,1,v,16,2,13,354,370,0 days 00:00:00.238930
winsw/winsw,1,v,21,6,12,10,31,0 days 00:00:00.051366
fideloper/TrustedProxy,1,,13,1,11,11,24,0 days 00:00:00.028233
JeffreySu/WeiXinMPSDK,2, v,4,1,2,40,44,0 days 00:00:00.580233
davemorrissey/subsampling-scale-image-view,1,v,13,7,5,8,21,0 days 00:00:00.031466
i18next/react-i18next,2, v,84,68,6,164,248,0 days 00:00:00.180709
mamedev/mame,1,mame,124,89,11,0,124,0 days 00:00:05.240938
AlessandroZ/LaZagne,2, v,14,6,5,6,20,0 days 00:00:00.063280
facebook/litho,1,v,41,25,3,157,198,0 days 00:00:01.039204
FluentValidation/FluentValidation,1,,49,14,24,60,109,0 days 00:00:00.146969
be5invis/Sarasa-Gothic,1,v,25,12,8,93,118,0 days 00:00:00.057688
AppImage/AppImageKit,1,,13,4,8,0,13,0 days 00:00:00.115217
rocksdanister/lively,1,v,18,15,2,29,47,0 days 00:00:00.033540
PointCloudLibrary/pcl,1,pcl-,13,2,8,12,25,0 days 00:00:00.940594
xo/usql,1,v,10,4,5,22,32,0 days 00:00:00.044899
terkelg/prompts,1,v,9,2,4,24,33,0 days 00:00:00.027657
sebastianbergmann/php-timer,1,,7,1,3,19,26,0 days 00:00:00.031322
evilsocket/opensnitch,1,v,4,1,2,7,11,0 days 00:00:00.082313
qemu/qemu,2,release_ v,48,2,42,86,134,0 days 00:00:07.830198
cjbassi/gotop,1,,9,5,1,24,33,0 days 00:00:00.034290
MichalLytek/type-graphql,1,v,19,13,1,18,37,0 days 00:00:00.055036
pennersr/django-allauth,1,,42,13,18,13,55,0 days 00:00:00.152632
smartystreets/goconvey,2, v,7,3,3,20,27,0 days 00:00:00.068856
styled-components/polished,2,v. v,22,12,6,56,78,0 days 00:00:00.069002
fancyapps/fancybox,3, V v,5,1,3,30,35,0 days 00:00:00.031561
ngrx/platform,2, v,35,19,5,25,60,0 days 00:00:00.110262
pytube/pytube,2, v,31,18,9,78,109,0 days 00:00:00.107770
inorganik/countUp.js,2, v,13,3,8,26,39,0 days 00:00:00.038367
chrisvfritz/prerender-spa-plugin,2, v,10,4,3,1,11,0 days 00:00:00.017620
barteksc/AndroidPdfViewer,1,,14,8,2,8,22,0 days 00:00:00.016121
graphql-python/graphene,2,v. v,16,7,5,29,45,0 days 00:00:00.103337
sveltejs/sapper,1,v,29,23,4,149,178,0 days 00:00:00.167482
angular/angularfire,2, v,11,2,5,28,39,0 days 00:00:00.075306
jpillora/chisel,2, v,8,2,4,21,29,0 days 00:00:00.028081
OWASP/Amass,2, v,37,25,6,123,160,0 days 00:00:00.255456
java-native-access/jna,2, v,26,3,18,32,58,0 days 00:00:00.233940
lz4/lz4,2,r v,18,11,2,11,29,0 days 00:00:00.128163
leeoniya/uPlot,1,,7,3,1,44,51,0 days 00:00:00.069589
symfony/routing,1,v,26,4,21,441,467,0 days 00:00:00.688630
boto/boto3,1,,24,8,11,1045,1069,0 days 00:00:01.725106
es-shims/es5-shim,1,v,19,8,7,77,96,0 days 00:00:00.076960
kekingcn/kkFileView,2, v,5,1,2,5,10,0 days 00:00:00.023308
sebastianbergmann/diff,1,,7,1,5,11,18,0 days 00:00:00.030980
pillarjs/path-to-regexp,2, v,24,9,11,28,52,0 days 00:00:00.042266
apache/cassandra,1,cassandra-,23,8,13,183,206,0 days 00:00:01.874099
surmon-china/vue-quill-editor,1,v,6,2,2,21,27,0 days 00:00:00.017526
metafizzy/flickity,1,v,10,3,6,24,34,0 days 00:00:00.040157
marionettejs/backbone.marionette,1,v,32,15,10,93,125,0 days 00:00:00.320419
hrydgard/ppsspp,1,v,20,3,14,46,66,0 days 00:00:02.024976
yhirose/cpp-httplib,1,v,9,3,5,75,84,0 days 00:00:00.072204
Zettlr/Zettlr,3, v. v,28,14,6,49,77,0 days 00:00:00.314640
ljharb/qs,1,v,25,11,10,49,74,0 days 00:00:00.062548
laravel/tinker,1,v,9,3,4,17,26,0 days 00:00:00.024600
nopSolutions/nopCommerce,1,release-,29,20,8,6,35,0 days 00:00:01.130650
AmruthPillai/Reactive-Resume,1,v,7,4,2,24,31,0 days 00:00:00.280463
google/android-classyshark,1,,15,9,3,0,15,0 days 00:00:00.037153
vercel/styled-jsx,2, v,15,5,8,78,93,0 days 00:00:00.184377
jazzband/django-debug-toolbar,2, v,25,4,15,24,49,0 days 00:00:00.146238
jemalloc/jemalloc,1,,22,4,14,24,46,0 days 00:00:00.196767
sebastianbergmann/php-file-iterator,1,,7,1,5,27,34,0 days 00:00:00.027672
raineorshine/npm-check-updates,2, v,56,34,11,194,250,0 days 00:00:00.191714
phpmyadmin/phpmyadmin,2, RELEASE_,37,9,15,300,337,0 days 00:00:08.038830
symfony/css-selector,1,v,26,4,20,434,460,0 days 00:00:00.409412
gitkraken/vscode-gitlens,2, v,45,33,4,91,136,0 days 00:00:00.504494
symfony/process,1,v,26,4,21,450,476,0 days 00:00:00.384849
encode/starlette,1,,19,8,5,94,113,0 days 00:00:00.087151
mqttjs/MQTT.js,2, v,42,22,7,109,151,0 days 00:00:00.121037
developit/microbundle,2, v,15,7,6,24,39,0 days 00:00:00.059764
ThreeMammals/Ocelot,1,,31,19,6,110,141,0 days 00:00:00.109597
deepstreamIO/deepstream.io,2, v,25,7,8,98,123,0 days 00:00:00.130115
DevinVinson/WordPress-Plugin-Boilerplate,1,,9,5,2,5,14,0 days 00:00:00.033102
TrinityCore/TrinityCore,1,TDB,74,41,22,6,80,0 days 00:00:03.098167
xmrig/xmrig,1,v,46,34,7,73,119,0 days 00:00:00.205404
FullHuman/purgecss,2, v,23,11,7,20,43,0 days 00:00:00.078982
Turfjs/turf,2, v,23,15,5,65,88,0 days 00:00:00.311167
reach/router,1,v,5,2,2,13,18,0 days 00:00:00.025244
wallabag/wallabag,1,,20,6,10,40,60,0 days 00:00:00.536173
projectstorm/react-diagrams,2, v,16,6,6,23,39,0 days 00:00:00.052032
matthew-andrews/isomorphic-fetch,1,v,12,7,3,14,26,0 days 00:00:00.017898
final-form/react-final-form,2,v v.,23,16,3,47,70,0 days 00:00:00.269094
reactjs/react-modal,1,v,19,7,6,91,110,0 days 00:00:00.076728
ffuf/ffuf,1,v,18,8,5,6,24,0 days 00:00:00.027467
jsplumb/jsplumb,1,,28,5,18,188,216,0 days 00:00:00.481743
symfony/var-dumper,1,v,20,4,15,355,375,0 days 00:00:00.279718
readthedocs/readthedocs.org,1,,76,55,5,152,228,0 days 00:00:01.472209
abel533/Mapper,1,,18,8,5,33,51,0 days 00:00:00.051377
cosmtrek/air,1,v,5,1,2,18,23,0 days 00:00:00.024914
trentm/node-bunyan,1,,33,18,7,81,114,0 days 00:00:00.092717
rr-debugger/rr,1,,28,9,14,6,34,0 days 00:00:00.313038
kennethreitz/records,1,v,5,3,1,6,11,0 days 00:00:00.109865
musescore/MuseScore,1,v,11,1,9,24,35,0 days 00:00:01.612253
monero-project/monero,1,v,19,7,7,34,53,0 days 00:00:00.893932
verlok/vanilla-lazyload,2, v,81,56,15,77,158,0 days 00:00:00.154381
cython/cython,1,,19,2,10,71,90,0 days 00:00:01.270300
taskflow/taskflow,1,v,13,3,8,1,14,0 days 00:00:00.102609
Humanizr/Humanizer,3, V v,16,8,5,49,65,0 days 00:00:00.154572
bigskysoftware/htmx,2, v,12,6,1,18,30,0 days 00:00:00.099135
guess-js/guess,2, v,4,1,2,42,46,0 days 00:00:00.043958
microsoft/DeepSpeed,1,v,6,1,3,36,42,0 days 00:00:00.072857
olivere/elastic,1,v,8,1,6,317,325,0 days 00:00:00.246000
brunch/brunch,1,,24,11,8,107,131,0 days 00:00:00.317701
reactiveui/ReactiveUI,2, v,41,24,6,181,222,0 days 00:00:00.780563
monkeytypegame/monkeytype,1,v,16,6,1,111,127,0 days 00:00:00.473701
hashicorp/terraform-provider-aws,1,v,226,223,1,33,259,0 days 00:00:04.091657
barry-ran/QtScrcpy,1,v,9,3,3,15,24,0 days 00:00:00.142020
transmission/transmission,1,,99,69,12,1,100,0 days 00:00:00.744818
filamentgroup/loadCSS,2, v,9,2,6,14,23,0 days 00:00:00.024968
DylanVann/react-native-fast-image,1,v,20,8,7,90,110,0 days 00:00:00.064602
ds300/patch-package,1,v,17,9,3,40,57,0 days 00:00:00.046050
vercel/ncc,1,,31,21,4,46,77,0 days 00:00:00.053836
ssssssss-team/spider-flow,1,v,5,3,1,6,11,0 days 00:00:00.031391
ajenti/ajenti,2, v,5,2,2,123,128,0 days 00:00:00.243368
Nuitka/Nuitka,1,,13,8,4,238,251,0 days 00:00:00.574110
needim/noty,1,v,10,2,5,37,47,0 days 00:00:00.034233
microsoft/azuredatastudio,2, v,40,28,2,89,129,0 days 00:00:00.747735
mongodb/mongo-go-driver,2, v,13,4,7,60,73,0 days 00:00:00.133813
cssinjs/jss,2, v,60,41,8,86,146,0 days 00:00:00.177613
gobuffalo/buffalo,2, v,15,3,9,107,122,0 days 00:00:00.455454
alibaba/MNN,1,,13,9,3,36,49,0 days 00:00:00.071219
tgalal/yowsup,1,v,8,3,4,20,28,0 days 00:00:00.087434
SigNoz/signoz,2, v,7,1,2,28,35,0 days 00:00:00.082818
twpayne/chezmoi,1,v,27,16,4,106,133,0 days 00:00:00.325918
infracost/infracost,2, v,10,6,3,62,72,0 days 00:00:00.133312
kazupon/vue-i18n,1,v,64,37,7,83,147,0 days 00:00:00.167207
NLPchina/elasticsearch-sql,1,,46,21,13,144,190,0 days 00:00:00.212097
cockpit-project/cockpit,2, v,314,303,8,1,315,0 days 00:00:01.477905
SirVer/ultisnips,1,,11,2,7,0,11,0 days 00:00:00.089069
ActivityWatch/activitywatch,1,v,8,4,3,11,19,0 days 00:00:00.052689
jupyterhub/jupyterhub,1,,19,2,11,20,39,0 days 00:00:00.434039
Vincit/objection.js,1,,19,3,10,101,120,0 days 00:00:00.275092
lucas-clemente/quic-go,2,v. v,24,5,10,33,57,0 days 00:00:00.354828
aheckmann/gm,2, v,31,13,12,35,66,0 days 00:00:00.052279
open-policy-agent/opa,1,v,40,22,6,80,120,0 days 00:00:00.266415
aws/aws-sdk-js,1,v,1089,1078,5,301,1390,0 days 00:00:02.507110
kanboard/kanboard,1,v,3,1,1,71,74,0 days 00:00:00.254353
sindresorhus/fkill-cli,2, v,23,9,10,3,26,0 days 00:00:00.019012
lcobucci/jwt,1,,11,3,6,34,45,0 days 00:00:00.090463
BoyceLig/Clash_Chinese_Patch,1,,7,1,3,57,64,0 days 00:00:00.027846
schollz/howmanypeoplearearound,1,v,4,2,1,11,15,0 days 00:00:00.016229
ElemeFE/v-charts,1,v,14,9,2,72,86,0 days 00:00:00.048017
sindresorhus/np,1,v,42,24,10,34,76,0 days 00:00:00.043731
Rob--W/cors-anywhere,2, v,3,1,1,18,21,0 days 00:00:00.018555
juice-shop/juice-shop,2, v,91,67,8,101,192,0 days 00:00:01.144964
grpc/grpc-web,1,,7,4,2,9,16,0 days 00:00:00.059478
gregberge/loadable-components,1,v,30,19,6,35,65,0 days 00:00:00.047830
xojs/xo,1,v,43,24,8,43,86,0 days 00:00:00.060626
enquirer/enquirer,1,,6,2,3,27,33,0 days 00:00:00.038966
hugapi/hug,1,,18,11,5,44,62,0 days 00:00:00.157732
electron/fiddle,2, v,29,14,3,22,51,0 days 00:00:00.104519
Laravel-Lang/lang,1,,20,12,6,174,194,0 days 00:00:00.397444
visgl/react-map-gl,2, v,22,10,9,143,165,0 days 00:00:00.218493
jaredpalmer/tsdx,1,v,13,6,3,40,53,0 days 00:00:00.053250
wailsapp/wails,1,v,19,10,2,44,63,0 days 00:00:00.145670
Hacker0x01/react-datepicker,2, v,107,85,2,73,180,0 days 00:00:00.252483
flyway/flyway,1,flyway-,40,20,13,101,141,0 days 00:00:00.251778
wasabeef/glide-transformations,1,,9,3,5,10,19,0 days 00:00:00.020224
migueldeicaza/gui.cs,1,v,13,6,4,9,22,0 days 00:00:00.271215
eclipse/che,1,,100,95,2,126,226,0 days 00:00:00.858817
josdejong/jsoneditor,1,v,71,48,11,125,196,0 days 00:00:00.149028
QUANTAXIS/QUANTAXIS,2, V,15,4,5,44,59,0 days 00:00:00.506916
grpc/grpc-java,1,v,52,22,4,58,110,0 days 00:00:00.404307
svgdotjs/svg.js,1,,50,38,8,48,98,0 days 00:00:00.106971
stylelint/stylelint,2, v,97,78,4,88,185,0 days 00:00:00.463696
Sylius/Sylius,1,v,30,4,16,151,181,0 days 00:00:02.237594
react-native-camera/react-native-camera,1,v,84,69,5,96,180,0 days 00:00:00.181674
mdbootstrap/material-design-for-bootstrap,1,,18,11,5,46,64,0 days 00:00:00.039216
snapappointments/bootstrap-select,2, v,13,3,7,52,65,0 days 00:00:00.113909
TranslucentTB/TranslucentTB,1,,14,7,6,0,14,0 days 00:00:00.093861
addyosmani/critical,2, v,17,4,9,44,61,0 days 00:00:00.068272
sindresorhus/pageres,2, v,24,8,7,23,47,0 days 00:00:00.044165
meliorence/react-native-snap-carousel,2,V v,22,15,2,29,51,0 days 00:00:00.047639
iterative/dvc,1,,92,83,3,258,350,0 days 00:00:00.739098
TarsCloud/Tars,2, v,15,7,4,32,47,0 days 00:00:00.062596
pockethub/PocketHub,2, v,11,5,3,9,20,0 days 00:00:00.175670
lvgl/lvgl,2, v,26,10,7,20,46,0 days 00:00:00.516716
FormidableLabs/victory,1,v,65,43,8,156,221,0 days 00:00:00.617329
jhen0409/react-native-debugger,1,v,12,3,7,74,86,0 days 00:00:00.171219
senchalabs/connect,1,,52,27,11,174,226,0 days 00:00:00.354660
apidoc/apidoc,1,,27,7,10,19,46,0 days 00:00:00.061355
BookStackApp/BookStack,3, v. v,36,10,9,113,149,0 days 00:00:00.273272
mswjs/msw,2, v,38,31,1,90,128,0 days 00:00:00.105242
charmbracelet/glow,1,v,7,4,1,10,17,0 days 00:00:00.044623
Automattic/kue,2, v,10,2,7,47,57,0 days 00:00:00.071054
vnotex/vnote,2, v,47,34,4,13,60,0 days 00:00:00.098168
deepmind/sonnet,1,v,35,24,1,0,35,0 days 00:00:00.055599
pinojs/pino,2, v,90,69,7,150,240,0 days 00:00:00.183952
botpress/botpress,2, v,88,76,4,234,322,0 days 00:00:00.970910
argoproj/argo-cd,1,v,25,9,4,115,140,0 days 00:00:00.333643
catboost/catboost,3, v. v,25,7,3,57,82,0 days 00:00:01.311312
future-architect/vuls,1,v,19,4,6,64,83,0 days 00:00:00.089572
dingo/api,2, v,16,9,5,41,57,0 days 00:00:00.094012
uncss/uncss,1,,9,2,5,9,18,0 days 00:00:00.041276
FormidableLabs/spectacle,2, v,35,12,11,77,112,0 days 00:00:00.099237
r-spacex/SpaceX-API,2, v,15,9,3,8,23,0 days 00:00:00.118083
Atmosphere-NX/Atmosphere,1,,18,7,6,48,66,0 days 00:00:00.211832
reactjs/react-transition-group,1,v,19,9,7,19,38,0 days 00:00:00.033459
oblador/react-native-animatable,1,v,10,4,4,13,23,0 days 00:00:00.021032
upx/upx,1,v,31,7,18,0,31,0 days 00:00:00.283144
acaudwell/Gource,1,gource-,20,5,11,0,20,0 days 00:00:00.057600
squizlabs/PHP_CodeSniffer,1,,19,5,12,51,70,0 days 00:00:00.504760
arasatasaygin/is.js,1,v,8,5,2,13,21,0 days 00:00:00.028506
cheat/cheat,1,,18,10,4,67,85,0 days 00:00:00.095618
mongodb/node-mongodb-native,3,V v. v,25,4,18,387,412,0 days 00:00:00.938942
bulletphysics/bullet3,1,,18,5,9,6,24,0 days 00:00:00.597296
hackware1993/MagicIndicator,1,,8,4,2,5,13,0 days 00:00:00.018616
deployphp/deployer,1,v,20,6,9,47,67,0 days 00:00:00.240845
docmirror/dev-sidecar,2, v,7,3,2,16,23,0 days 00:00:00.042375
exceljs/exceljs,2, v,41,28,7,180,221,0 days 00:00:00.309898
chimurai/http-proxy-middleware,1,v,26,19,6,30,56,0 days 00:00:00.037286
callstack/react-native-paper,2, v,53,40,5,61,114,0 days 00:00:00.198704
direnv/direnv,2, v,33,8,16,42,75,0 days 00:00:00.074263
crimx/ext-saladict,3, V v,59,47,6,139,198,0 days 00:00:00.229609
coredns/coredns,1,v,20,7,7,42,62,0 days 00:00:00.328418
phpDocumentor/ReflectionDocBlock,1,,14,4,8,24,38,0 days 00:00:00.060013
boardgameio/boardgame.io,1,v,39,28,4,111,150,0 days 00:00:00.157689
rough-stuff/wired-elements,1,v,9,2,4,26,35,0 days 00:00:00.031955
javascript-obfuscator/javascript-obfuscator,1,,63,47,4,122,185,0 days 00:00:00.181429
ydataai/pandas-profiling,2,v. v,20,10,7,14,34,0 days 00:00:00.062702
coleifer/peewee,1,,35,12,13,139,174,0 days 00:00:00.261335
cure53/DOMPurify,2, v,12,3,8,68,80,0 days 00:00:00.111353
aksonov/react-native-router-flux,2, v,13,3,6,34,47,0 days 00:00:00.091359
pyinstaller/pyinstaller,2, v,28,5,19,6,34,0 days 00:00:00.491888
Gallopsled/pwntools,1,,26,5,8,35,61,0 days 00:00:00.293353
react-dropzone/react-dropzone,2, v,55,34,12,120,175,0 days 00:00:00.089019
symfony/console,1,v,26,4,21,466,492,0 days 00:00:00.507493
sinonjs/sinon,2, v,57,27,18,121,178,0 days 00:00:00.355597
didi/cube-ui,2, v,13,10,1,69,82,0 days 00:00:00.296799
ginuerzh/gost,2, v,21,11,7,11,32,0 days 00:00:00.039319
thumbor/thumbor,1,,61,33,14,178,239,0 days 00:00:00.202409
helmetjs/helmet,1,v,51,23,8,34,85,0 days 00:00:00.072949
paulmillr/chokidar,1,,28,10,14,70,98,0 days 00:00:00.101150
inversify/InversifyJS,2, v,25,15,7,22,47,0 days 00:00:00.093972
sonic-pi-net/sonic-pi,1,v,16,5,7,9,25,0 days 00:00:00.621032
mayswind/AriaNg,1,,9,1,6,14,23,0 days 00:00:00.040197
callstack/linaria,1,v,14,9,4,24,38,0 days 00:00:00.054393
marmelab/gremlins.js,2, v,5,1,3,2,7,0 days 00:00:00.029889
dromara/Sa-Token,1,v,23,18,2,1,24,0 days 00:00:00.057826
didi/chameleon,2, v,4,1,1,19,23,0 days 00:00:00.070798
phpDocumentor/TypeResolver,1,,14,2,9,18,32,0 days 00:00:00.032538
capnproto/capnproto,1,v,9,1,6,12,21,0 days 00:00:00.347154
gka/chroma.js,2, v,9,3,5,26,35,0 days 00:00:00.036015
OWASP/owasp-mstg,2, v,5,1,3,7,12,0 days 00:00:00.518747
aws/chalice,1,,38,17,8,43,81,0 days 00:00:00.150183
fkhadra/react-toastify,1,v,33,16,8,60,93,0 days 00:00:00.103843
crawlab-team/crawlab,1,v,6,1,3,21,27,0 days 00:00:00.125662
react-page/react-page,2, v,58,45,6,214,272,0 days 00:00:00.186691
PrefectHQ/prefect,1,,17,5,6,102,119,0 days 00:00:00.962709
antvis/G6,1,,9,2,3,64,73,0 days 00:00:00.283961
heartexlabs/label-studio,2,v. v,14,4,2,24,38,0 days 00:00:00.113140
webtorrent/webtorrent-desktop,1,v,25,18,5,13,38,0 days 00:00:00.164364
TuSimple/naive-ui,2, v,26,23,1,70,96,0 days 00:00:00.481535
facebook/chisel,1,,10,1,6,3,13,0 days 00:00:00.035170
remarkjs/react-markdown,2, v,22,7,11,46,68,0 days 00:00:00.046335
tinode/chat,1,v,6,1,4,45,51,0 days 00:00:00.169414
facebookresearch/ParlAI,2, v,10,5,2,10,20,0 days 00:00:00.228026
encode/httpx,1,,23,10,4,47,70,0 days 00:00:00.088905
golang-migrate/migrate,1,v,24,7,7,25,49,0 days 00:00:00.082715
tweepy/tweepy,2, v,40,17,15,4,44,0 days 00:00:00.200160
Aircoookie/WLED,1,v,8,1,6,15,23,0 days 00:00:00.113849
GoogleChromeLabs/comlink,1,v,15,8,4,23,38,0 days 00:00:00.069903
cert-manager/cert-manager,1,v,25,3,3,49,74,0 days 00:00:00.623893
zerotier/ZeroTierOne,1,,15,4,6,68,83,0 days 00:00:00.402499
OpenRefine/OpenRefine,2, v,13,1,10,9,22,0 days 00:00:00.474977
coursera-dl/coursera-dl,1,,8,1,5,12,20,0 days 00:00:00.068977
gregberge/svgr,1,v,36,29,4,19,55,0 days 00:00:00.056808
desandro/imagesloaded,1,v,11,3,5,27,38,0 days 00:00:00.029217
ultralytics/yolov3,1,v,12,6,4,0,12,0 days 00:00:00.136699
mementum/backtrader,1,,7,2,1,132,139,0 days 00:00:00.301936
mapeditor/tiled,1,v,27,3,20,56,83,0 days 00:00:00.443030
libretro/RetroArch,2, v,15,3,7,77,92,0 days 00:00:03.488070
caprover/caprover,2,V v,12,6,5,17,29,0 days 00:00:00.083334
pyodide/pyodide,2, v,20,11,6,25,45,0 days 00:00:00.123321
cefsharp/CefSharp,1,v,27,5,11,70,97,0 days 00:00:00.473410
piskelapp/piskel,1,v,14,2,9,16,30,0 days 00:00:00.129718
microsoft/Windows-universal-samples,2, v,438,13,9,171,609,0 days 00:00:00.448318
cyrus-and/gdb-dashboard,1,v,15,6,8,15,30,0 days 00:00:00.031913
questdb/questdb,2, v,12,1,8,39,51,0 days 00:00:00.192433
tweenjs/tween.js,3, r v,30,12,12,23,53,0 days 00:00:00.061976
openframeworks/openFrameworks,1,,10,1,6,16,26,0 days 00:00:01.140631
spotDL/spotify-downloader,1,v,14,4,4,38,52,0 days 00:00:00.090333
mailpile/Mailpile,1,,5,1,2,6,11,0 days 00:00:00.279546
EpistasisLab/tpot,2, v,9,1,5,15,24,0 days 00:00:00.134341
Automattic/node-canvas,2, v,30,11,13,88,118,0 days 00:00:00.136707
aws/serverless-application-model,2, v,42,25,6,9,51,0 days 00:00:00.076515
claudiodangelis/qrcp,1,,6,2,3,17,23,0 days 00:00:00.025388
XTLS/Xray-core,1,v,6,3,1,21,27,0 days 00:00:00.031923
Justson/AgentWeb,2, v,4,1,1,13,17,0 days 00:00:00.043322
muesli/duf,1,v,8,5,2,4,12,0 days 00:00:00.019595
pytest-dev/pytest,1,,42,10,17,122,164,0 days 00:00:01.054226
Shopify/sarama,1,v,34,10,15,18,52,0 days 00:00:00.183049
google/go-github,1,v,59,43,6,35,94,0 days 00:00:00.223133
doctrine/dbal,2, v,18,2,14,79,97,0 days 00:00:00.843387
nextapps-de/flexsearch,1,,4,2,1,13,17,0 days 00:00:00.024358
jprichardson/node-fs-extra,2, v,43,18,12,42,85,0 days 00:00:00.085074
pmndrs/jotai,1,v,24,17,1,88,112,0 days 00:00:00.091785
welldone-software/why-did-you-render,2,v. v,19,8,6,67,86,0 days 00:00:00.048603
shipshapecode/tether,1,v,13,6,4,60,73,0 days 00:00:00.077737
listen1/listen1_chrome_extension,1,v,32,22,7,36,68,0 days 00:00:00.054245
chakra-core/ChakraCore,1,v,9,1,3,52,61,0 days 00:00:00.796822
MarshallOfSound/Google-Play-Music-Desktop-Player-UNOFFICIAL-,2, v,26,17,3,32,58,0 days 00:00:00.100559
wkentaro/labelme,1,v,50,38,9,125,175,0 days 00:00:00.141202
gskinner/regexr,1,,5,2,1,6,11,0 days 00:00:00.024075
tsayen/dom-to-image,1,,13,7,3,23,36,0 days 00:00:00.031512
blevesearch/bleve,1,v,14,3,7,27,41,0 days 00:00:00.176013
OnsenUI/OnsenUI,1,,20,6,8,68,88,0 days 00:00:00.615599
restsharp/RestSharp,2, v,30,14,11,29,59,0 days 00:00:00.240716
nilaoda/N_m3u8DL-CLI,1,,18,9,3,65,83,0 days 00:00:00.053142
James-Yu/LaTeX-Workshop,1,v,89,74,1,126,215,0 days 00:00:00.417326
nodejs/node-gyp,2, v,37,7,18,98,135,0 days 00:00:00.136706
node-schedule/node-schedule,2, v,10,3,5,36,46,0 days 00:00:00.043033
jwtk/jjwt,1,,11,4,6,15,26,0 days 00:00:00.044856
cesanta/mongoose,1,,43,12,22,1,44,0 days 00:00:00.311469
cytoscape/cytoscape.js,1,v,29,10,13,198,227,0 days 00:00:00.365242
KurtBestor/Hitomi-Downloader,1,v,17,3,8,0,17,0 days 00:00:00.017769
rq/rq,2, v,24,2,15,44,68,0 days 00:00:00.130323
giampaolo/psutil,1,release-,32,8,17,52,84,0 days 00:00:00.620349
projectdiscovery/nuclei,2,v. v,10,2,6,43,53,0 days 00:00:00.270739
HabitRPG/habitica,2, v,351,348,2,612,963,0 days 00:00:02.529594
junit-team/junit4,1,r,8,1,6,5,13,0 days 00:00:00.169774
MonoGame/MonoGame,2, v,12,1,9,4,16,0 days 00:00:00.833702
Nozbe/WatermelonDB,1,v,19,5,6,17,36,0 days 00:00:00.211725
panjf2000/ants,1,v,9,4,4,15,24,0 days 00:00:00.035555
uber/react-vis,2, v,22,14,3,77,99,0 days 00:00:00.072292
chocolatey/choco,1,,5,1,2,38,43,0 days 00:00:00.358539
sebastianbergmann/php-code-coverage,1,,23,4,13,138,161,0 days 00:00:00.323131
myclabs/DeepCopy,1,,12,1,10,18,30,0 days 00:00:00.022904
borgbackup/borg,1,,22,13,5,36,58,0 days 00:00:00.521783
libgit2/libgit2,1,v,29,7,16,48,77,0 days 00:00:01.063118
square/moshi,1,moshi-parent-,15,1,12,4,19,0 days 00:00:00.067312
MahApps/MahApps.Metro,1,,21,5,11,33,54,0 days 00:00:00.341088
dat-ecosystem-archive/dat,1,v,43,31,8,64,107,0 days 00:00:00.171572
benoitc/gunicorn,1,,31,12,14,51,82,0 days 00:00:00.215488
agenda/agenda,2, v,20,5,11,65,85,0 days 00:00:00.177198
stanfordnlp/CoreNLP,1,v,11,5,3,12,23,0 days 00:00:00.977361
protobufjs/protobuf.js,2, v,23,11,6,55,78,0 days 00:00:00.182724
coil-kt/coil,1,,15,5,6,12,27,0 days 00:00:00.170970
jopohl/urh,1,v,17,8,7,74,91,0 days 00:00:00.182506
pre-commit/pre-commit,1,v,60,32,9,111,171,0 days 00:00:00.223698
vector-im/element-web,1,v,27,9,9,172,199,0 days 00:00:00.835253
devhubapp/devhub,2, v,55,47,3,61,116,0 days 00:00:00.210972
NG-ZORRO/ng-zorro-antd,1,,41,30,5,65,106,0 days 00:00:00.151085
bloomrpc/bloomrpc,2, v,6,2,3,9,15,0 days 00:00:00.018903
lima-vm/lima,1,v,11,6,1,16,27,0 days 00:00:00.077714
tidwall/tile38,1,,27,6,7,59,86,0 days 00:00:00.098578
googleapis/google-api-php-client,2, v,13,2,8,32,45,0 days 00:00:00.100878
hediet/vscode-drawio,1,v,10,6,2,13,23,0 days 00:00:00.028484
OpenFeign/feign,3, release- v,72,48,10,54,126,0 days 00:00:00.113218
ninja-build/ninja,2,release- v,14,1,10,12,26,0 days 00:00:00.181869
olivernn/lunr.js,1,v,12,1,6,46,58,0 days 00:00:00.044659
knadh/listmonk,1,v,4,1,2,0,4,0 days 00:00:00.067163
resilience4j/resilience4j,3, v. v,22,5,9,15,37,0 days 00:00:00.099698
google/or-tools,1,v,32,7,8,3,35,0 days 00:00:00.553345
dropwizard/dropwizard,1,v,15,1,11,119,134,0 days 00:00:00.542347
symfony/event-dispatcher,1,v,26,4,21,436,462,0 days 00:00:00.406038
symfony/http-foundation,1,v,26,4,21,464,490,0 days 00:00:00.628206
apache/tvm,1,v,7,1,5,1,8,0 days 00:00:00.465490
happyfish100/fastdfs,1,V,16,7,5,0,16,0 days 00:00:00.023972
paragonie/random_compat,2, v,7,3,1,54,61,0 days 00:00:00.151434
rofl0r/proxychains-ng,1,v,16,3,10,1,17,0 days 00:00:00.032862
PaddlePaddle/PaddleHub,2, v,12,3,1,10,22,0 days 00:00:00.111838
OpenIMSDK/Open-IM-Server,1,v,3,1,1,15,18,0 days 00:00:00.106567
VulcanJS/Vulcan,2, v,22,11,6,45,67,0 days 00:00:00.478419
shwenzhang/AndResGuard,1,,3,1,1,35,38,0 days 00:00:00.038451
Koenkk/zigbee2mqtt,1,,28,16,5,33,61,0 days 00:00:00.316274
electron/electron-packager,1,v,53,30,10,42,95,0 days 00:00:00.227201
sockjs/sockjs-client,1,v,11,1,7,20,31,0 days 00:00:00.069707
Stuk/jszip,1,v,19,5,11,14,33,0 days 00:00:00.061809
dotnet/machinelearning,1,v,18,12,4,5,23,0 days 00:00:00.189752
szimek/signature_pad,1,v,11,3,4,19,30,0 days 00:00:00.037459
sahat/satellizer,1,,14,7,4,41,55,0 days 00:00:00.136039
symfony/finder,1,v,26,4,20,440,466,0 days 00:00:00.329601
ag-grid/ag-grid,2, v,87,62,5,103,190,0 days 00:00:01.700562
ng-bootstrap/ng-bootstrap,1,,27,12,6,49,76,0 days 00:00:00.185720
airbnb/epoxy,1,,41,26,5,22,63,0 days 00:00:00.046943
smicallef/spiderfoot,1,v,8,1,6,1,9,0 days 00:00:00.207159
arrow-py/arrow,1,,17,3,11,37,54,0 days 00:00:00.106544
adrai/flowchart.js,1,v,17,4,9,31,48,0 days 00:00:00.032814
Jguer/yay,1,v,49,33,9,26,75,0 days 00:00:00.157802
ChrisRM/material-theme-jetbrains,2, v,83,68,2,163,246,0 days 00:00:00.276204
Pikaday/Pikaday,1,,9,1,7,6,15,0 days 00:00:00.035340
pypa/pip,1,,36,2,27,73,109,0 days 00:00:00.929869
grommet/grommet,2, v,41,18,8,76,117,0 days 00:00:00.455756
doitsujin/dxvk,1,v,40,30,5,32,72,0 days 00:00:00.349852
tiangolo/typer,1,,4,1,1,15,19,0 days 00:00:00.026265
mjmlio/mjml,3, V v,25,8,11,50,75,0 days 00:00:00.160257
mediaelement/mediaelement,1,,32,8,12,117,149,0 days 00:00:00.284685
firefly-iii/firefly-iii,1,,41,19,8,201,242,0 days 00:00:01.148848
abpframework/abp,2, v,43,33,3,60,103,0 days 00:00:01.680608
huggingface/datasets,1,,26,21,1,26,52,0 days 00:00:00.267553
videolan/vlc,1,,9,1,3,50,59,0 days 00:00:04.847824
justauth/JustAuth,3, v. v,14,9,2,25,39,0 days 00:00:00.044521
wtfutil/wtf,2, v,41,26,1,26,67,0 days 00:00:00.187440
zalmoxisus/redux-devtools-extension,2, v,27,23,2,43,70,0 days 00:00:00.065551
grpc-ecosystem/grpc-gateway,1,v,28,10,10,43,71,0 days 00:00:00.121853
d2l-ai/d2l-en,1,v,8,1,4,17,25,0 days 00:00:00.266507
automerge/automerge,1,v,13,4,6,20,33,0 days 00:00:00.051691
google/cadvisor,2, v,45,20,15,71,116,0 days 00:00:00.289983
JustArchiNET/ArchiSteamFarm,1,,167,154,10,431,598,0 days 00:00:01.067641
orhanobut/logger,2, v,13,7,3,1,14,0 days 00:00:00.017915
Tencent/APIJSON,1,,37,21,7,51,88,0 days 00:00:00.153638
openshift/origin,1,v,14,2,10,25,39,0 days 00:00:02.300768
powerline/powerline,1,,13,3,7,10,23,0 days 00:00:00.180539
android-hacker/VirtualXposed,2, v,12,3,3,55,67,0 days 00:00:00.247207
keybase/client,2, v,29,21,4,65,94,0 days 00:00:02.150976
liabru/matter-js,1,,10,1,7,8,18,0 days 00:00:00.053820
authelia/authelia,1,v,55,39,5,114,169,0 days 00:00:00.269993
verdaccio/verdaccio,1,v,64,34,13,148,212,0 days 00:00:00.597718
fabric/fabric,1,,26,4,19,97,123,0 days 00:00:00.503936
qutebrowser/qutebrowser,1,v,32,4,16,49,81,0 days 00:00:01.540770
microsoft/AirSim,2,v. v,3,1,1,15,18,0 days 00:00:00.099072
RaRe-Technologies/gensim,1,,23,6,11,36,59,0 days 00:00:00.253358
ahmetb/kubectx,1,v,9,2,5,11,20,0 days 00:00:00.025792
flipped-aurora/gin-vue-admin,3,V v. v,7,2,2,21,28,0 days 00:00:00.125321
microsoft/recommenders,1,,9,3,3,2,11,0 days 00:00:00.497729
txthinking/brook,1,v,43,22,6,0,43,0 days 00:00:00.046473
getgrav/grav,1,,13,3,8,170,183,0 days 00:00:00.594710
brix/crypto-js,2, release-,4,2,1,10,14,0 days 00:00:00.017798
modood/Administrative-divisions-of-China,1,,9,1,7,7,16,0 days 00:00:00.017934
timescale/timescaledb,1,,28,8,8,33,61,0 days 00:00:00.309075
termux/termux-app,1,v,89,73,7,0,89,0 days 00:00:00.081351
remotion-dev/remotion,1,v,14,8,1,81,95,0 days 00:00:00.355371
xtaci/kcptun,2, v,106,79,7,0,106,0 days 00:00:00.064550
bcicen/ctop,2, v,5,2,2,11,16,0 days 00:00:00.040275
mdx-js/mdx,2, v,26,19,5,140,166,0 days 00:00:00.344224
WerWolv/ImHex,1,v,19,14,2,12,31,0 days 00:00:00.084509
selectize/selectize.js,1,v,12,5,2,64,76,0 days 00:00:00.066990
python/mypy,1,v,59,38,8,7,66,0 days 00:00:00.770676
gionkunz/chartist-js,1,v,11,6,4,47,58,0 days 00:00:00.058452
http-party/node-http-proxy,2, v,27,11,13,70,97,0 days 00:00:00.089217
xtermjs/xterm.js,1,,76,52,7,35,111,0 days 00:00:00.592804
redwoodjs/redwood,2, v,57,53,1,71,128,0 days 00:00:00.591693
filp/whoops,1,,18,6,8,50,68,0 days 00:00:00.074721
DIYgod/DPlayer,2, v,21,12,5,21,42,0 days 00:00:00.067259
arduino/Arduino,1,,26,5,13,46,72,0 days 00:00:00.505931
mockito/mockito,1,v,58,32,10,409,467,0 days 00:00:00.838014
you-dont-need/You-Dont-Need-Momentjs,1,v,6,3,2,5,11,0 days 00:00:00.022943
wechaty/wechaty,1,v,15,4,7,8,23,0 days 00:00:00.396033
Semantic-Org/Semantic-UI-React,1,v,93,78,5,211,304,0 days 00:00:00.312247
GoogleContainerTools/skaffold,1,v,80,76,1,29,109,0 days 00:00:00.749147
umijs/qiankun,1,v,14,4,7,92,106,0 days 00:00:00.080949
faressoft/terminalizer,1,v,6,3,1,25,31,0 days 00:00:00.020027
google/gvisor,1,release-,99,94,2,0,99,0 days 00:00:00.411495
Intervention/image,1,,15,3,8,93,108,0 days 00:00:00.088174
CachetHQ/Cachet,1,v,7,1,2,30,37,0 days 00:00:00.312618
rwaldron/johnny-five,2, v,14,3,7,73,87,0 days 00:00:00.191205
charmbracelet/bubbletea,1,v,20,14,4,27,47,0 days 00:00:00.046832
redux-form/redux-form,1,v,46,30,8,141,187,0 days 00:00:00.160743
moment/luxon,1,,37,21,6,69,106,0 days 00:00:00.085893
showdownjs/showdown,2, v,14,3,7,42,56,0 days 00:00:00.053230
onnx/onnx,1,v,13,1,10,9,22,0 days 00:00:00.133035
psf/requests-html,1,v,8,6,1,22,30,0 days 00:00:00.032612
scylladb/scylla,1,scylla-,33,11,10,130,163,0 days 00:00:02.491635
horovod/horovod,1,v,16,3,10,53,69,0 days 00:00:00.088256
revel/revel,1,v,18,4,10,7,25,0 days 00:00:00.244449
Foundry376/Mailspring,1,,11,1,6,43,54,0 days 00:00:00.523690
Budibase/budibase,1,v,10,5,3,479,489,0 days 00:00:01.714862
bvaughn/react-window,1,,4,2,1,16,20,0 days 00:00:00.030517
pqina/filepond,1,,52,41,4,143,195,0 days 00:00:00.196221
OptimalBits/bull,2, v,49,26,13,84,133,0 days 00:00:00.151799
thephpleague/flysystem,1,,13,2,6,175,188,0 days 00:00:00.187195
openstf/stf,1,v,12,4,7,16,28,0 days 00:00:00.121206
surmon-china/vue-awesome-swiper,2, v,14,5,5,36,50,0 days 00:00:00.031628
uuidjs/uuid,1,v,16,6,8,21,37,0 days 00:00:00.048487
barryvdh/laravel-ide-helper,1,v,25,8,15,61,86,0 days 00:00:00.071362
danilowoz/react-content-loader,2, v,16,6,8,27,43,0 days 00:00:00.034698
liriliri/eruda,1,v,15,6,5,40,55,0 days 00:00:00.050938
pyecharts/pyecharts,1,v,14,4,6,29,43,0 days 00:00:00.151210
MaterialDesignInXAML/MaterialDesignInXamlToolkit,2, v,21,5,12,12,33,0 days 00:00:00.146506
wkhtmltopdf/wkhtmltopdf,1,,8,4,3,31,39,0 days 00:00:00.078529
gaearon/react-hot-loader,2, v,25,13,6,107,132,0 days 00:00:00.166311
josdejong/mathjs,1,v,109,83,4,118,227,0 days 00:00:00.307283
11ty/eleventy,1,v,13,2,7,41,54,0 days 00:00:00.114386
aquasecurity/trivy,1,v,28,19,2,59,87,0 days 00:00:00.076999
rt2zz/redux-persist,1,v,36,27,6,76,112,0 days 00:00:00.068070
tensorflow/tensor2tensor,3, v. v,15,5,4,61,76,0 days 00:00:00.335929
oliver-moran/jimp,2, v,15,8,4,71,86,0 days 00:00:00.072793
systemjs/systemjs,2, v,40,18,10,187,227,0 days 00:00:00.285510
visionmedia/supertest,2, v,29,8,13,29,58,0 days 00:00:00.224211
tabler/tabler-icons,1,v,69,65,2,15,84,0 days 00:00:00.072332
lra/mackup,1,,8,4,3,53,61,0 days 00:00:00.237341
foambubble/foam,1,v,17,10,3,44,61,0 days 00:00:00.068152
arut/nginx-rtmp-module,1,v,12,5,3,100,112,0 days 00:00:00.076369
casbin/casbin,1,v,68,52,5,118,186,0 days 00:00:00.270663
Delgan/loguru,1,,6,1,4,12,18,0 days 00:00:00.038902
carloscuesta/gitmoji,1,v,13,5,2,5,18,0 days 00:00:00.047570
mlflow/mlflow,2, v,35,21,1,20,55,0 days 00:00:00.225025
webpack-contrib/webpack-bundle-analyzer,1,v,32,19,8,34,66,0 days 00:00:00.051591
react-dates/react-dates,1,v,78,74,1,81,159,0 days 00:00:00.140130
Miserlou/Zappa,2, v,50,42,3,71,121,0 days 00:00:00.189464
http-party/http-server,2, v,15,2,10,30,45,0 days 00:00:00.060246
roots/sage,2, v,27,10,12,35,62,0 days 00:00:00.154842
jaredreich/pell,1,v,6,4,1,6,12,0 days 00:00:00.014504
aurelia/framework,1,,23,16,5,32,55,0 days 00:00:00.053073
Tamsiree/RxTool,2, v,15,7,4,177,192,0 days 00:00:00.100831
FaridSafi/react-native-gifted-chat,2, v,16,6,7,46,62,0 days 00:00:00.156680
ramsey/uuid,1,,26,6,14,37,63,0 days 00:00:00.080092
Tonejs/Tone.js,2, r,12,1,8,4,16,0 days 00:00:00.236768
NodeBB/NodeBB,1,v,30,2,17,93,123,0 days 00:00:01.420776
karma-runner/karma,2, v,35,14,12,198,233,0 days 00:00:00.240409
ben-manes/caffeine,2, v,16,4,7,45,61,0 days 00:00:00.092644
freebsd/freebsd-src,1,release/,62,3,58,16,78,0 days 00:00:20.694021
emirpasic/gods,1,v,19,14,3,6,25,0 days 00:00:00.037350
keycloak/keycloak,1,,16,3,7,21,37,0 days 00:00:01.247734
segmentio/evergreen,1,v,51,39,2,84,135,0 days 00:00:00.198501
OpenAPITools/openapi-generator,2, v,16,2,11,38,54,0 days 00:00:01.150314
NetEase/pomelo,2, v,9,1,4,84,93,0 days 00:00:00.075920
AdguardTeam/AdGuardHome,1,v,19,6,4,31,50,0 days 00:00:00.275281
flairNLP/flair,1,v,11,1,6,12,23,0 days 00:00:00.359212
PuerkitoBio/goquery,1,v,12,1,8,10,22,0 days 00:00:00.027915
QL-Win/QuickLook,2, v,4,1,1,38,42,0 days 00:00:00.053722
go-chi/chi,1,v,12,1,5,27,39,0 days 00:00:00.047947
mikepenz/MaterialDrawer,1,v,35,19,8,166,201,0 days 00:00:00.205269
LuckSiege/PictureSelector,2,v. v,12,6,5,91,103,0 days 00:00:00.225516
apexcharts/apexcharts.js,2, v,32,15,3,54,86,0 days 00:00:00.145885
koekeishiya/yabai,1,v,12,5,1,34,46,0 days 00:00:00.065453
thingsboard/thingsboard,1,v,15,2,7,33,48,0 days 00:00:00.530969
rjsf-team/react-jsonschema-form,1,v,71,56,6,52,123,0 days 00:00:00.104330
ranger/ranger,1,v,10,1,8,31,41,0 days 00:00:00.386310
spicetify/spicetify-cli,2,v. v,23,14,5,52,75,0 days 00:00:00.061582
mifi/lossless-cut,1,v,70,52,9,67,137,0 days 00:00:00.137477
meolu/walle-web,1,v,13,8,1,6,19,0 days 00:00:00.073578
microsoft/nni,1,v,27,9,2,16,43,0 days 00:00:00.308801
sindresorhus/got,1,v,70,49,11,71,141,0 days 00:00:00.128940
netchx/netch,2, v,6,1,3,47,53,0 days 00:00:00.114203
d2-projects/d2-admin,2, v,25,17,4,62,87,0 days 00:00:00.195985
nock/nock,2, v,125,108,13,181,306,0 days 00:00:00.257255
hotwired/stimulus,1,v,12,5,4,14,26,0 days 00:00:00.078182
nexe/nexe,1,v,5,2,1,14,19,0 days 00:00:00.045743
bettercap/bettercap,1,v,33,23,5,10,43,0 days 00:00:00.131354
graphile/postgraphile,1,v,35,20,7,60,95,0 days 00:00:00.155174
apache/druid,1,druid-,18,1,13,366,384,0 days 00:00:01.028687
java-decompiler/jd-gui,1,v,7,5,1,11,18,0 days 00:00:00.028629
rizinorg/cutter,1,v,14,6,5,16,30,0 days 00:00:00.231805
cloudwu/skynet,1,v,15,7,6,18,33,0 days 00:00:00.109080
conventional-changelog/commitlint,1,v,47,28,10,89,136,0 days 00:00:00.166463
slimphp/Slim,1,,40,11,21,55,95,0 days 00:00:00.357456
wenzhixin/bootstrap-table,1,,18,3,9,39,57,0 days 00:00:00.350135
searx/searx,2, v,14,1,12,3,17,0 days 00:00:00.286248
pagehelper/Mybatis-PageHelper,1,v,18,9,6,42,60,0 days 00:00:00.049474
antvis/G2,2, v,13,2,8,144,157,0 days 00:00:00.275151
kubernetes/dashboard,1,v,15,1,10,20,35,0 days 00:00:00.252141
single-spa/single-spa,2, v,29,15,10,85,114,0 days 00:00:00.065264
PHPOffice/PhpSpreadsheet,1,,24,6,7,10,34,0 days 00:00:00.310579
ccampbell/mousetrap,1,,7,1,5,21,28,0 days 00:00:00.031060
video-dev/hls.js,1,v,16,2,9,185,201,0 days 00:00:00.629303
micro/micro,2, v,62,46,2,37,99,0 days 00:00:00.255337
google/brotli,1,v,6,1,4,10,16,0 days 00:00:00.064739
nightwatchjs/nightwatch,1,v,16,1,9,207,223,0 days 00:00:00.237523
mail-in-a-box/mailinabox,1,v,45,16,11,0,45,0 days 00:00:00.122013
argoproj/argo-workflows,2, v,23,7,9,102,125,0 days 00:00:00.429726
RPCS3/rpcs3,1,v,5,1,3,21,26,0 days 00:00:00.779537
ajv-validator/ajv,2, v,71,54,6,89,160,0 days 00:00:00.189856
davisking/dlib,1,v,55,14,13,0,55,0 days 00:00:00.520736
SFTtech/openage,1,v,5,2,2,4,9,0 days 00:00:00.184980
allenai/allennlp,2, v,24,7,5,23,47,0 days 00:00:00.170412
FriendsOfPHP/PHP-CS-Fixer,1,v,48,26,14,148,196,0 days 00:00:00.637605
jquery/jquery-ui,1,,8,1,6,38,46,0 days 00:00:00.496564
stylus/stylus,1,,53,34,11,115,168,0 days 00:00:00.250620
baidu/amis,1,,9,5,2,37,46,0 days 00:00:00.414619
keeweb/keeweb,1,v,25,10,9,103,128,0 days 00:00:00.389636
tomnomnom/gron,2, v,7,2,2,27,34,0 days 00:00:00.023550
WickyNilliams/headroom.js,1,v,9,1,5,8,17,0 days 00:00:00.025462
containrrr/watchtower,1,v,8,1,5,24,32,0 days 00:00:00.048330
nats-io/nats-server,1,v,17,2,12,49,66,0 days 00:00:00.450031
ent/ent,1,v,10,3,4,21,31,0 days 00:00:00.115211
containerd/containerd,2, v,9,1,7,76,85,0 days 00:00:01.021036
doctrine/inflector,2, v,6,1,4,10,16,0 days 00:00:00.031995
mobile-shell/mosh,1,mosh-,4,2,1,10,14,0 days 00:00:00.071425
dgraph-io/badger,1,v,14,6,7,20,34,0 days 00:00:00.218627
jonas/tig,1,tig-,27,6,19,22,49,0 days 00:00:00.299312
SpartnerNL/Laravel-Excel,2, v,11,3,6,143,154,0 days 00:00:00.132960
Kotlin/kotlinx.coroutines,1,,24,11,6,38,62,0 days 00:00:00.165925
beetbox/beets,1,v,6,1,4,30,36,0 days 00:00:00.568051
lokesh/color-thief,2, v,5,1,2,6,11,0 days 00:00:00.018737
GoogleChrome/workbox,1,v,24,10,7,38,62,0 days 00:00:00.126913
javve/list.js,2, v,11,4,5,10,21,0 days 00:00:00.051707
wbkd/react-flow,2, v,56,52,2,118,174,0 days 00:00:00.234290
summernote/summernote,1,v,8,2,2,52,60,0 days 00:00:00.185117
browserslist/browserslist,1,,49,24,11,119,168,0 days 00:00:00.131363
fengyuanchen/cropperjs,1,v,14,6,4,40,54,0 days 00:00:00.048095
jxnblk/mdx-deck,1,v,21,16,2,91,112,0 days 00:00:00.126593
casesandberg/react-color,2, v,14,8,5,23,37,0 days 00:00:00.049311
lingochamp/FileDownloader,1,v,11,4,4,56,67,0 days 00:00:00.058331
apache/pulsar,1,v,14,1,10,37,51,0 days 00:00:00.834696
Rapptz/discord.py,1,v,24,15,6,41,65,0 days 00:00:00.272737
networkx/networkx,1,networkx-,37,7,25,10,47,0 days 00:00:00.502092
downshift-js/downshift,1,v,49,38,4,179,228,0 days 00:00:00.164686
App-vNext/Polly,2, v,7,3,2,4,11,0 days 00:00:00.055134
tymondesigns/jwt-auth,1,,6,3,2,29,35,0 days 00:00:00.091298
polybar/polybar,1,,20,12,7,84,104,0 days 00:00:00.138434
mholt/PapaParse,1,,19,5,7,55,74,0 days 00:00:00.057711
ionic-team/stencil,1,v,53,40,2,189,242,0 days 00:00:00.433492
star7th/showdoc,2, v,18,6,6,124,142,0 days 00:00:00.109191
go-playground/validator,1,v,94,69,10,59,153,0 days 00:00:00.109365
abseil/abseil-cpp,1,,17,5,9,0,17,0 days 00:00:00.075751
swaywm/sway,1,,22,7,8,7,29,0 days 00:00:00.479044
rqlite/rqlite,1,v,56,37,8,39,95,0 days 00:00:00.191742
spatie/laravel-permission,1,,87,61,11,71,158,0 days 00:00:00.237684
PatrickJS/angular-starter,2, v,6,4,1,5,11,0 days 00:00:00.086049
restify/node-restify,2, v,44,27,13,96,140,0 days 00:00:00.156353
akiran/react-slick,2, v,13,3,8,27,40,0 days 00:00:00.077703
GoogleContainerTools/kaniko,1,v,33,19,4,4,37,0 days 00:00:00.127284
peers/peerjs,2, v,6,1,4,30,36,0 days 00:00:00.062883
thanos-io/thanos,1,v,26,7,2,17,43,0 days 00:00:00.195975
aws/aws-cli,1,,46,24,17,1642,1688,0 days 00:00:04.285386
VSCodeVim/Vim,2, v,38,19,6,187,225,0 days 00:00:00.588443
dbcli/mycli,1,v,26,8,10,20,46,0 days 00:00:00.105931
dangrossman/daterangepicker,2, v,5,1,3,58,63,0 days 00:00:00.073678
dbcli/pgcli,2, v,39,16,10,47,86,0 days 00:00:00.355317
dotnet/AspNetCore.Docs,1,,40,33,1,0,40,0 days 00:00:00.812513
TypeStrong/ts-node,1,v,52,29,9,83,135,0 days 00:00:00.089272
golangci/golangci-lint,1,v,47,31,1,63,110,0 days 00:00:00.159373
avwo/whistle,1,v,31,12,10,342,373,0 days 00:00:00.764849
tidwall/gjson,1,v,15,5,6,42,57,0 days 00:00:00.037796
imakewebthings/waypoints,2, v,6,1,4,17,23,0 days 00:00:00.022986
luin/ioredis,2, v,54,33,11,132,186,0 days 00:00:00.251971
jina-ai/clip-as-service,1,v,15,11,2,92,107,0 days 00:00:00.119096
styleguidist/react-styleguidist,2, v,47,30,7,215,262,0 days 00:00:00.223947
redis/redis-py,2, v,15,2,9,49,64,0 days 00:00:00.140593
okonet/lint-staged,2, v,44,23,7,145,189,0 days 00:00:00.147543
reactstrap/reactstrap,2, v,61,45,7,54,115,0 days 00:00:00.097549
snabbdom/snabbdom,1,v,14,3,6,33,47,0 days 00:00:00.064973
netbox-community/netbox,2, v,24,6,13,173,197,0 days 00:00:00.626739
ansible/awx,1,,36,18,3,20,56,0 days 00:00:02.245519
debug-js/debug,1,,22,7,8,47,69,0 days 00:00:00.045544
lucidrains/vit-pytorch,1,,32,27,1,105,137,0 days 00:00:00.055233
shipshapecode/shepherd,1,v,46,28,9,73,119,0 days 00:00:00.184886
pagekit/vue-resource,1,,12,5,4,41,53,0 days 00:00:00.038021
PrismJS/prism,2, v,29,8,11,11,40,0 days 00:00:00.298215
AppIntro/AppIntro,2, v,10,1,8,8,18,0 days 00:00:00.062537
mailhog/MailHog,2, v,10,7,2,16,26,0 days 00:00:00.026462
vercel/micro,2, v,21,13,5,34,55,0 days 00:00:00.050472
plouc/nivo,1,v,67,56,7,45,112,0 days 00:00:00.162069
jantimon/html-webpack-plugin,2, v,47,34,10,36,83,0 days 00:00:00.151044
cyclejs/cyclejs,1,v,32,27,1,50,82,0 days 00:00:00.055816
react-static/react-static,1,v,28,20,5,162,190,0 days 00:00:00.159606
git-lfs/git-lfs,2, v,29,3,19,60,89,0 days 00:00:00.522147
aspnetboilerplate/aspnetboilerplate,3, v. v,91,57,7,125,216,0 days 00:00:00.552308
ant-design/ant-design-mobile,2, v,28,19,4,107,135,0 days 00:00:00.449835
SpacehuhnTech/esp8266_deauther,3, v. v,10,5,3,3,13,0 days 00:00:00.050443
clauderic/react-sortable-hoc,1,v,20,14,3,52,72,0 days 00:00:00.045533
serbanghita/Mobile-Detect,1,,6,2,3,64,70,0 days 00:00:00.067126
milvus-io/milvus,1,v,9,3,3,15,24,0 days 00:00:01.063345
apple/darwin-xnu,1,xnu-,19,16,2,104,123,0 days 00:00:00.050788
haltu/muuri,1,,9,1,5,14,23,0 days 00:00:00.037272
samuelcolvin/pydantic,2,V v,42,30,6,37,79,0 days 00:00:00.103605
spencermountain/compromise,2, v,70,45,12,148,218,0 days 00:00:00.437452
atomiks/tippyjs,2, v,27,20,5,65,92,0 days 00:00:00.097054
typesense/typesense,2, v,16,5,5,8,24,0 days 00:00:00.090070
qrohlf/trianglify,1,v,12,1,8,8,20,0 days 00:00:00.023649
tinygo-org/tinygo,1,v,23,9,3,4,27,0 days 00:00:00.177582
nhn/tui.calendar,1,v,21,13,3,42,63,0 days 00:00:00.125050
spotify/annoy,3, v. v,9,1,4,15,24,0 days 00:00:00.053071
h2o/h2o,1,v,12,3,2,32,44,0 days 00:00:00.229966
jacomyal/sigma.js,1,v,7,1,3,8,15,0 days 00:00:00.188608
Ciphey/Ciphey,2, v,18,15,1,8,26,0 days 00:00:00.123387
bitwarden/server,2, v,49,31,4,58,107,0 days 00:00:00.210711
FredrikNoren/ungit,2, v,16,9,6,126,142,0 days 00:00:00.342866
kubernetes-sigs/kind,2, v,14,2,6,10,24,0 days 00:00:00.225540
zricethezav/gitleaks,1,v,60,47,5,62,122,0 days 00:00:00.197186
NaturalNode/natural,2, v,6,2,3,44,50,0 days 00:00:00.081226
coryhouse/react-slingshot,2, v,8,3,2,7,15,0 days 00:00:00.040684
w7corp/easywechat,1,,47,25,16,241,288,0 days 00:00:00.276475
socketio/socket.io-client,1,,28,2,16,97,125,0 days 00:00:00.130377
immerjs/immer,2, v,35,23,5,94,129,0 days 00:00:00.104811
squidfunk/mkdocs-material,1,,52,34,6,192,244,0 days 00:00:00.388033
jesseduffield/lazydocker,1,v,18,11,5,27,45,0 days 00:00:00.047185
tj/commander.js,2, v,50,19,18,38,88,0 days 00:00:00.106331
HandBrake/HandBrake,1,,8,1,6,35,43,0 days 00:00:00.847006
visgl/deck.gl,2, v,32,8,11,250,282,0 days 00:00:00.587370
dromara/hutool,1,,11,1,6,102,113,0 days 00:00:00.297893
dask/dask,1,,97,59,9,141,238,0 days 00:00:00.777174
doczjs/docz,1,v,19,13,5,66,85,0 days 00:00:00.109207
labstack/echo,2, v,20,3,10,75,95,0 days 00:00:00.115569
vuejs/devtools,1,v,10,4,4,36,46,0 days 00:00:00.106319
halo-dev/halo,1,v,10,2,5,42,52,0 days 00:00:00.128131
dmlc/xgboost,2, v,21,1,14,12,33,0 days 00:00:00.333374
frappe/erpnext,2, v,153,136,7,763,916,0 days 00:00:03.968981
alibaba/nacos,2, v,16,9,6,15,31,0 days 00:00:00.350840
lovell/sharp,1,v,30,4,16,88,118,0 days 00:00:00.103504
frida/frida,1,,54,30,10,579,633,0 days 00:00:00.756479
pure-css/pure,1,v,9,1,7,14,23,0 days 00:00:00.049465
reduxjs/react-redux,1,v,26,17,6,59,85,0 days 00:00:00.083416
redux-saga/redux-saga,2, v,18,9,5,40,58,0 days 00:00:00.116800
python-pillow/Pillow,1,,39,1,35,35,74,0 days 00:00:00.876068
react-native-elements/react-native-elements,2, v,30,18,5,52,82,0 days 00:00:00.299832
files-community/Files,1,v,23,18,4,38,61,0 days 00:00:00.190339
t4t5/sweetalert,2, v,9,2,3,23,32,0 days 00:00:00.034448
seata/seata,3, V v,15,6,3,18,33,0 days 00:00:00.183951
ovity/octotree,1,v,5,1,3,26,31,0 days 00:00:00.048620
dimsemenov/PhotoSwipe,1,v,5,1,2,43,48,0 days 00:00:00.040991
sampotts/plyr,1,v,16,6,7,195,211,0 days 00:00:00.191508
guzzle/guzzle,2, v,37,16,14,96,133,0 days 00:00:00.228801
ramda/ramda,2, v,28,13,9,26,54,0 days 00:00:00.278899
inconshreveable/ngrok,1,,20,18,1,1,21,0 days 00:00:00.027047
facebook/draft-js,2, v,11,7,3,16,27,0 days 00:00:00.076108
github/hub,1,v,29,14,10,59,88,0 days 00:00:00.329605
angular/components,1,,31,13,7,128,159,0 days 00:00:00.872587
feathericons/feather,1,v,39,28,3,12,51,0 days 00:00:00.049125
ehang-io/nps,3,V v. v,19,14,1,44,63,0 days 00:00:00.048909
httpie/httpie,1,,19,2,12,28,47,0 days 00:00:00.103464
fabricjs/fabric.js,2, v,34,10,14,69,103,0 days 00:00:00.380342
swagger-api/swagger-ui,3, v/ v,69,51,10,189,258,0 days 00:00:00.538982
bevacqua/dragula,2, v,18,14,1,49,67,0 days 00:00:00.055066
appwrite/appwrite,1,,13,1,3,30,43,0 days 00:00:00.797232
usablica/intro.js,2, v,29,5,13,12,41,0 days 00:00:00.082193
bilibili/flv.js,1,v,7,1,4,8,15,0 days 00:00:00.032033
openfaas/faas,2, v,18,9,7,110,128,0 days 00:00:00.216993
conwnet/github1s,1,v,7,4,1,19,26,0 days 00:00:00.031428
vercel/pkg,1,,15,7,5,42,57,0 days 00:00:00.082433
paularmstrong/normalizr,2, v,16,7,5,18,34,0 days 00:00:00.042750
rook/rook,1,v,19,1,16,103,122,0 days 00:00:01.032375
chenglou/react-motion,1,v,5,1,2,19,24,0 days 00:00:00.049215
qishibo/AnotherRedisDesktopManager,2, v,6,1,3,34,40,0 days 00:00:00.044248
vega/vega,1,v,45,20,15,73,118,0 days 00:00:01.593104
helm/helm,2, v,32,8,12,68,100,0 days 00:00:00.576684
docsifyjs/docsify,1,v,44,35,6,147,191,0 days 00:00:00.146270
jlmakes/scrollreveal,1,v,10,3,5,36,46,0 days 00:00:00.144373
mochajs/mocha,2, v,65,28,15,110,175,0 days 00:00:00.403975
slidevjs/slidev,1,v,31,27,1,143,174,0 days 00:00:00.110123
yeasy/docker_practice,1,v,13,1,9,0,13,0 days 00:00:00.070612
michalsnik/aos,2, v,11,4,4,24,35,0 days 00:00:00.024219
sirupsen/logrus,2, v,20,6,8,35,55,0 days 00:00:00.170543
localForage/localForage,1,,19,10,7,43,62,0 days 00:00:00.077892
react-bootstrap/react-bootstrap,2, v,44,24,10,108,152,0 days 00:00:00.316636
microsoft/cascadia-code,1,v,18,8,3,0,18,0 days 00:00:00.025534
vuejs/vuepress,1,v,24,14,5,50,74,0 days 00:00:00.147531
uglide/RedisDesktopManager,1,,33,19,4,38,71,0 days 00:00:00.126961
StevenBlack/hosts,2, v,24,10,7,405,429,0 days 00:00:00.420821
nicolargo/glances,1,v,22,2,15,70,92,0 days 00:00:00.249151
homebridge/homebridge,2, v,6,1,4,51,57,0 days 00:00:00.096923
postcss/autoprefixer,1,,53,27,14,133,186,0 days 00:00:00.185881
DrKLO/Telegram,1,release-,47,40,1,37,84,0 days 00:00:00.052441
rollup/rollup,1,v,169,157,3,411,580,0 days 00:00:00.673566
petkaantonov/bluebird,1,v,24,11,7,115,139,0 days 00:00:00.164201
open-mmlab/mmdetection,1,v,29,26,1,6,35,0 days 00:00:00.130379
avajs/ava,1,v,54,37,4,23,77,0 days 00:00:00.161759
Seldaek/monolog,1,,36,9,21,26,62,0 days 00:00:00.169087
python-poetry/poetry,1,,14,10,3,63,77,0 days 00:00:00.248884
validatorjs/validator.js,2, v,107,79,8,43,150,0 days 00:00:00.143262
eslint/eslint,1,v,164,153,3,103,267,0 days 00:00:00.678629
mozilla/DeepSpeech,1,v,9,1,6,13,22,0 days 00:00:00.221451
schollz/croc,1,v,31,15,6,106,137,0 days 00:00:00.161754
electron-react-boilerplate/electron-react-boilerplate,1,v,32,13,10,31,63,0 days 00:00:00.235349
js-cookie/js-cookie,1,v,10,1,7,13,23,0 days 00:00:00.054185
spf13/viper,1,v,13,2,8,13,26,0 days 00:00:00.050932
zyedidia/micro,1,v,6,1,3,22,28,0 days 00:00:00.154056
ShareX/ShareX,1,v,50,24,11,22,72,0 days 00:00:00.477652
parse-community/parse-server,1,,34,15,12,111,145,0 days 00:00:00.301682
benweet/stackedit,1,v,23,17,4,104,127,0 days 00:00:00.116367
necolas/react-native-web,1,,17,6,7,242,259,0 days 00:00:00.826068
felixrieseberg/windows95,1,v,11,4,5,3,14,0 days 00:00:00.020563
signalapp/Signal-Android,3, v. v,180,163,8,860,1040,0 days 00:00:02.109630
streamlit/streamlit,2, v,83,79,1,46,129,0 days 00:00:00.433126
apache/skywalking,1,v,20,4,6,11,31,0 days 00:00:00.486687
alibaba/Sentinel,2, v,8,2,3,16,24,0 days 00:00:00.064410
afollestad/material-dialogs,3, v. v,20,12,3,98,118,0 days 00:00:00.127445
segmentio/nightmare,1,,21,9,4,67,88,0 days 00:00:00.077568
codex-team/editor.js,2, v,11,3,5,16,27,0 days 00:00:00.062377
eligrey/FileSaver.js,2, v,3,1,1,12,15,0 days 00:00:00.025446
youzan/vant,1,v,33,13,6,377,410,0 days 00:00:00.761010
winstonjs/winston,2, v,24,6,13,62,86,0 days 00:00:00.103549
emberjs/ember.js,1,v,68,20,4,184,252,0 days 00:00:01.988214
locustio/locust,2, v,27,9,10,56,83,0 days 00:00:00.215838
marmelab/react-admin,1,v,46,32,4,168,214,0 days 00:00:01.034409
vuejs/vue-router,1,v,19,9,5,59,78,0 days 00:00:00.121384
celery/celery,2, v,22,3,17,143,165,0 days 00:00:00.790676
zhongyang219/TrafficMonitor,1,V,18,8,6,4,22,0 days 00:00:00.048269
TeamNewPipe/NewPipe,2, v,17,3,10,100,117,0 days 00:00:00.689294
osquery/osquery,2, v,39,13,12,80,119,0 days 00:00:00.437512
reduxjs/reselect,1,v,11,6,4,14,25,0 days 00:00:00.051069
graphql/graphql-js,2, v,34,12,13,88,122,0 days 00:00:00.219460
python-telegram-bot/python-telegram-bot,3, V v,49,27,8,39,88,0 days 00:00:00.151905
chalk/chalk,1,v,16,3,8,16,32,0 days 00:00:00.032756
Popmotion/popmotion,2, v,21,14,5,131,152,0 days 00:00:00.288312
vadimdemedes/ink,1,v,16,6,6,23,39,0 days 00:00:00.042128
google/ExoPlayer,1,r,20,1,14,84,104,0 days 00:00:00.866056
sideway/joi,2, v,92,63,11,135,227,0 days 00:00:00.207527
taichi-dev/taichi,2, v,7,1,3,96,103,0 days 00:00:00.651473
solidjs/solid,1,v,27,16,2,137,164,0 days 00:00:00.140313
pbatard/rufus,1,v,42,11,15,28,70,0 days 00:00:00.122901
mingrammer/diagrams,1,v,20,14,3,16,36,0 days 00:00:00.038713
urfave/cli,1,v,33,20,8,34,67,0 days 00:00:00.150597
Baseflow/PhotoView,2, v,8,2,4,12,20,0 days 00:00:00.036916
OpenZeppelin/openzeppelin-contracts,1,v,30,10,5,22,52,0 days 00:00:00.172176
recharts/recharts,1,v,26,13,6,93,119,0 days 00:00:00.234948
wenyan-lang/wenyan,1,v,3,1,1,12,15,0 days 00:00:00.053397
jumpserver/jumpserver,2, v,31,24,5,103,134,0 days 00:00:00.508928
websockets/ws,2, v,40,13,11,114,154,0 days 00:00:00.135129
iawia002/lux,2, v,15,7,5,59,74,0 days 00:00:00.062754
vnpy/vnpy,2, v,22,6,7,28,50,0 days 00:00:00.437216
PyTorchLightning/pytorch-lightning,1,,16,3,4,98,114,0 days 00:00:00.636909
dapr/dapr,1,v,19,9,1,23,42,0 days 00:00:00.209177
lensapp/lens,1,v,19,6,6,56,75,0 days 00:00:00.234814
eggjs/egg,1,,70,51,10,43,113,0 days 00:00:00.116914
go-kratos/kratos,1,v,11,2,7,21,32,0 days 00:00:00.094601
valyala/fasthttp,1,v,43,27,4,3,46,0 days 00:00:00.085064
philc/vimium,2, v,11,2,5,17,28,0 days 00:00:00.258586
quii/learn-go-with-tests,2, v,22,13,5,27,49,0 days 00:00:00.076611
svg/svgo,2, v,20,8,11,66,86,0 days 00:00:00.090171
magenta/magenta,2, v,7,1,3,42,49,0 days 00:00:00.081993
telegramdesktop/tdesktop,1,v,34,11,15,542,576,0 days 00:00:01.255563
typicode/lowdb,1,v,21,8,9,36,57,0 days 00:00:00.052427
appsmithorg/appsmith,3, v. v,13,7,3,129,142,0 days 00:00:00.755918
NickeManarin/ScreenToGif,1,,37,16,7,43,80,0 days 00:00:00.102069
dgraph-io/dgraph,1,v,13,1,9,60,73,0 days 00:00:00.587897
flameshot-org/flameshot,1,v,11,3,6,30,41,0 days 00:00:00.120424
react-dnd/react-dnd,2, v,45,25,10,100,145,0 days 00:00:00.338517
SortableJS/Vue.Draggable,2,v. v,24,13,6,25,49,0 days 00:00:00.049019
Redocly/redoc,1,v,39,33,1,56,95,0 days 00:00:00.115452
facebook/flux,1,,4,1,2,9,13,0 days 00:00:00.035859
aseprite/aseprite,2, v,9,1,7,84,93,0 days 00:00:00.497013
nosir/cleave.js,1,v,9,2,5,57,66,0 days 00:00:00.041306
TanStack/table,1,v,36,24,6,86,122,0 days 00:00:00.124110
pubkey/rxdb,1,,58,43,2,55,113,0 days 00:00:00.492034
jsdom/jsdom,2, v,98,67,9,144,242,0 days 00:00:00.331827
mysqljs/mysql,1,v,28,10,9,26,54,0 days 00:00:00.099501
pmndrs/zustand,1,v,13,4,6,56,69,0 days 00:00:00.053411
jquense/yup,1,v,27,12,8,67,94,0 days 00:00:00.064250
alibaba/ice,3, V v,23,17,1,57,80,0 days 00:00:00.123119
Molunerfinn/PicGo,1,v,11,4,5,21,32,0 days 00:00:00.033637
linlinjava/litemall,1,v,19,10,2,3,22,0 days 00:00:00.069787
ai/nanoid,1,,12,5,4,73,85,0 days 00:00:00.071166
mybatis/mybatis-3,1,mybatis-,5,1,3,32,37,0 days 00:00:00.407542
facebookresearch/fairseq,1,v,8,1,4,6,14,0 days 00:00:00.105330
wekan/wekan,2, v,610,607,2,27,637,0 days 00:00:01.088600
arendst/Tasmota,1,v,35,14,7,58,93,0 days 00:00:01.063799
oldj/SwitchHosts,1,v,9,2,5,36,45,0 days 00:00:00.204604
nostra13/Android-Universal-Image-Loader,1,v,3,1,1,12,15,0 days 00:00:00.055664
cookiecutter/cookiecutter,1,,14,3,7,15,29,0 days 00:00:00.247335
bazelbuild/bazel,1,,47,30,8,56,103,0 days 00:00:02.060051
badges/shields,1,,8,3,4,3,11,0 days 00:00:00.348528
jhipster/generator-jhipster,1,v,110,89,5,114,224,0 days 00:00:02.686945
defunkt/jquery-pjax,2, v,12,6,3,15,27,0 days 00:00:00.038842
facebook/fresco,1,v,35,14,13,12,47,0 days 00:00:00.175738
remix-run/remix,1,v,27,22,1,61,88,0 days 00:00:00.187670
less/less.js,1,v,26,8,13,42,68,0 days 00:00:00.176771
freqtrade/freqtrade,1,,44,35,3,14,58,0 days 00:00:01.103384
gorilla/mux,1,v,8,1,5,6,14,0 days 00:00:00.024602
restic/restic,1,v,13,2,7,18,31,0 days 00:00:00.316140
fingerprintjs/fingerprintjs,2, v,23,11,7,50,73,0 days 00:00:00.068300
brettwooldridge/HikariCP,1,HikariCP-,17,2,10,82,99,0 days 00:00:00.175849
handlebars-lang/handlebars.js,2, v,14,5,6,56,70,0 days 00:00:00.116533
eclipse-theia/theia,2, v,43,36,2,33,76,0 days 00:00:00.627731
monicahq/monica,1,v,47,32,4,39,86,0 days 00:00:00.252842
dropzone/dropzone,1,v,32,15,12,83,115,0 days 00:00:00.083930
testing-library/react-testing-library,1,v,57,43,2,110,167,0 days 00:00:00.082289
zloirock/core-js,2, v,41,26,7,156,197,0 days 00:00:00.444687
derailed/k9s,2, v,25,17,2,155,180,0 days 00:00:00.129545
twitter/typeahead.js,1,v,4,1,2,11,15,0 days 00:00:00.039361
plotly/dash,1,v,42,29,3,33,75,0 days 00:00:00.423240
jamiebuilds/react-loadable,1,v,13,8,3,16,29,0 days 00:00:00.022525
GoogleChromeLabs/squoosh,1,v,10,4,5,17,27,0 days 00:00:00.068830
grafana/k6,1,v,36,12,6,36,72,0 days 00:00:00.391726
Tencent/tinker,1,v,7,3,2,46,53,0 days 00:00:00.057353
nfl/react-helmet,1,,15,5,4,18,33,0 days 00:00:00.032302
framework7io/framework7,1,v,43,19,11,172,215,0 days 00:00:00.561142
joewalnes/websocketd,1,v,11,3,2,15,26,0 days 00:00:00.027654
responsively-org/responsively-app,1,v,18,14,3,10,28,0 days 00:00:00.263984
handsontable/handsontable,2, v,62,27,14,117,179,0 days 00:00:00.602264
aFarkas/lazysizes,1,,21,10,7,45,66,0 days 00:00:00.067924
hubotio/hubot,1,v,26,7,12,68,94,0 days 00:00:00.168090
sanic-org/sanic,2, v,21,2,13,49,70,0 days 00:00:00.179680
matryer/xbar,2, v,9,5,2,5,14,0 days 00:00:00.050815
gchq/CyberChef,1,v,119,106,4,273,392,0 days 00:00:00.438854
ionic-team/ionicons,2, v,21,9,10,51,72,0 days 00:00:00.052616
mpv-player/mpv,1,v,34,10,8,46,80,0 days 00:00:03.019962
nondanee/UnblockNeteaseMusic,1,v,23,17,1,34,57,0 days 00:00:00.046026
zadam/trilium,2, v,14,11,1,134,148,0 days 00:00:00.287865
visionmedia/superagent,2, v,50,23,13,84,134,0 days 00:00:00.143238
trojan-gfw/trojan,1,v,24,15,4,19,43,0 days 00:00:00.037495
grafana/loki,1,v,17,4,4,8,25,0 days 00:00:00.250049
nginx/nginx,1,release-,32,10,20,516,548,0 days 00:00:00.785258
notepad-plus-plus/notepad-plus-plus,2, v,42,8,11,159,201,0 days 00:00:00.376826
uber-go/zap,1,v,22,11,8,6,28,0 days 00:00:00.051373
EastWorld/wechat-app-mall,2, v,14,6,4,8,22,0 days 00:00:00.043851
filebrowser/filebrowser,1,v,34,23,6,62,96,0 days 00:00:00.151081
youzan/vant-weapp,1,v,16,7,4,91,107,0 days 00:00:00.285244
jaegertracing/jaeger,1,v,40,24,3,13,53,0 days 00:00:00.114325
v2fly/v2ray-core,1,v,185,168,4,217,402,0 days 00:00:00.694592
bokeh/bokeh,1,,23,1,14,50,73,0 days 00:00:01.177649
briannesbitt/Carbon,1,,99,80,7,79,178,0 days 00:00:00.259397
wagerfield/parallax,1,v,6,2,2,5,11,0 days 00:00:00.017613
react-grid-layout/react-grid-layout,2, v,22,9,8,86,108,0 days 00:00:00.178408
oblador/react-native-vector-icons,1,v,37,14,10,42,79,0 days 00:00:00.053778
buger/goreplay,2, v,18,5,10,23,41,0 days 00:00:00.082367
knex/knex,2, v,25,2,17,146,171,0 days 00:00:00.478447
BabylonJS/Babylon.js,2, v,36,16,14,36,72,0 days 00:00:02.581263
ustbhuangyi/better-scroll,3, v. v,17,6,4,41,58,0 days 00:00:00.114994
simdjson/simdjson,1,v,12,1,5,26,38,0 days 00:00:00.265277
spotify/luigi,2, v,13,4,7,46,59,0 days 00:00:00.269066
semantic-release/semantic-release,2, v,62,48,9,206,268,0 days 00:00:00.179449
motdotla/dotenv,1,v,33,17,11,26,59,0 days 00:00:00.044945
JedWatson/classnames,1,v,4,1,2,16,20,0 days 00:00:00.025927
nikic/PHP-Parser,1,v,24,7,12,41,65,0 days 00:00:00.101505
jhao104/proxy_pool,1,,10,1,6,2,12,0 days 00:00:00.042306
radareorg/radare2,2, release-,42,22,6,43,85,0 days 00:00:01.615033
janl/mustache.js,2, v,20,6,12,23,43,0 days 00:00:00.073393
wulkano/Kap,1,v,13,2,5,14,27,0 days 00:00:00.065844
outline/outline,2, v,64,54,1,39,103,0 days 00:00:00.253886
auth0/node-jsonwebtoken,1,v,29,13,9,42,71,0 days 00:00:00.058048
jasmine/jasmine,1,v,28,5,17,29,57,0 days 00:00:00.236180
tailwindlabs/heroicons,1,v,4,1,2,15,19,0 days 00:00:00.018020
huiyadanli/RevokeMsgPatcher,1,,15,6,3,0,15,0 days 00:00:00.021061
KaTeX/KaTeX,1,v,15,3,10,41,56,0 days 00:00:00.139898
facebook/yoga,2, v,19,6,8,23,42,0 days 00:00:00.137963
infernojs/inferno,2, v,38,29,6,160,198,0 days 00:00:00.384415
cool-RR/PySnooper,1,,7,1,5,10,17,0 days 00:00:00.027285
airbnb/visx,1,v,29,25,1,200,229,0 days 00:00:00.311276
teambit/bit,1,v,18,7,5,121,139,0 days 00:00:00.355897
lottie-react-native/lottie-react-native,1,v,16,2,9,37,53,0 days 00:00:00.138908
designmodo/Flat-UI,1,,5,1,3,5,10,0 days 00:00:00.021040
bower/bower,2, v,18,8,4,83,101,0 days 00:00:00.176616
DapperLib/Dapper,1,,31,22,6,13,44,0 days 00:00:00.097672
catchorg/Catch2,3,V v. v,24,7,7,62,86,0 days 00:00:00.274719
airbnb/react-sketchapp,2, v,20,11,5,27,47,0 days 00:00:00.058136
2dust/v2rayNG,1,,8,1,5,111,119,0 days 00:00:00.066687
qbittorrent/qBittorrent,1,release-,24,5,16,145,169,0 days 00:00:01.117855
LMAX-Exchange/disruptor,1,,9,1,4,22,31,0 days 00:00:00.066035
matomo-org/matomo,1,,64,20,21,130,194,0 days 00:00:02.112013
flatpickr/flatpickr,2, v,23,10,4,121,144,0 days 00:00:00.274022
fullcalendar/fullcalendar,1,v,44,16,18,72,116,0 days 00:00:00.336295
cloudreve/Cloudreve,1,,7,1,5,14,21,0 days 00:00:00.059057
icsharpcode/ILSpy,2, v,16,2,11,9,25,0 days 00:00:00.570049
pouchdb/pouchdb,2, v,24,7,8,47,71,0 days 00:00:00.439903
ChainSafe/web3.js,2, v,25,16,7,54,79,0 days 00:00:00.413805
nodemailer/nodemailer,1,v,47,20,15,170,217,0 days 00:00:00.132962
Tencent/ncnn,1,,32,9,3,0,32,0 days 00:00:00.148745
pyg-team/pytorch_geometric,1,,9,1,5,22,31,0 days 00:00:00.274986
you-dont-need/You-Dont-Need-Lodash-Underscore,1,v,14,5,6,6,20,0 days 00:00:00.038276
riot/riot,1,v,44,16,10,155,199,0 days 00:00:00.264851
Tencent/vConsole,2, v,24,13,7,34,58,0 days 00:00:00.059321
gabime/spdlog,1,v,19,4,10,15,34,0 days 00:00:00.214321
pqrs-org/Karabiner-Elements,1,v,28,11,5,0,28,0 days 00:00:00.258112
kovidgoyal/kitty,1,v,25,8,9,58,83,0 days 00:00:00.729167
browsh-org/browsh,1,v,5,2,2,45,50,0 days 00:00:00.041177
magic-wormhole/magic-wormhole,1,,12,2,6,22,34,0 days 00:00:00.187713
antonmedv/fx,1,,27,18,4,34,61,0 days 00:00:00.037821
frappe/charts,2, v,5,1,3,13,18,0 days 00:00:00.036165
mkdocs/mkdocs,1,,20,9,9,27,47,0 days 00:00:00.112385
Anuken/Mindustry,1,v,136,129,4,0,136,0 days 00:00:00.850006
framer/motion,1,v,60,51,3,243,303,0 days 00:00:00.496301
cocos2d/cocos2d-x,1,cocos2d-x-,20,2,8,17,37,0 days 00:00:02.605281
hdodenhof/CircleImageView,1,v,9,1,7,6,15,0 days 00:00:00.018134
iovisor/bcc,1,v,24,1,6,9,33,0 days 00:00:00.397842
jellyfin/jellyfin,1,v,8,2,4,30,38,0 days 00:00:01.150667
checkly/headless-recorder,1,v,8,4,3,10,18,0 days 00:00:00.030235
erusev/parsedown,2, v,17,10,5,51,68,0 days 00:00:00.052930
localtunnel/localtunnel,1,v,13,3,6,20,33,0 days 00:00:00.021635
InstaPy/InstaPy,2, v,6,2,1,37,43,0 days 00:00:00.207003
fmtlib/fmt,2, v,23,2,14,16,39,0 days 00:00:00.300536
node-red/node-red,2, v,26,3,18,99,125,0 days 00:00:00.560593
greensock/GSAP,1,,26,5,17,72,98,0 days 00:00:00.051619
krisk/Fuse,2, v,25,12,10,50,75,0 days 00:00:00.076115
barryvdh/laravel-debugbar,2,V v,24,11,10,99,123,0 days 00:00:00.086219
chrislusf/seaweedfs,2, v,218,211,2,0,218,0 days 00:00:00.494100
hashcat/hashcat,1,v,17,4,9,8,25,0 days 00:00:00.523478
iBotPeaches/Apktool,1,v,12,3,8,23,35,0 days 00:00:00.131912
jarun/nnn,1,v,34,11,4,2,36,0 days 00:00:00.262738
Kr328/ClashForAndroid,2, v,18,10,1,94,112,0 days 00:00:00.104621
joke2k/faker,1,v,95,84,9,138,233,0 days 00:00:00.368214
FormidableLabs/webpack-dashboard,2, v,12,3,8,31,43,0 days 00:00:00.031923
infinitered/ignite,2, v,52,42,6,94,146,0 days 00:00:00.156846
google/filament,1,v,23,13,5,70,93,0 days 00:00:00.346535
sweetalert2/sweetalert2,1,v,129,115,3,544,673,0 days 00:00:00.878393
alibaba/ARouter,1,,4,1,2,16,20,0 days 00:00:00.030401
be5invis/Iosevka,1,v,59,45,8,163,222,0 days 00:00:00.330798
browserify/browserify,2, v,149,129,7,264,413,0 days 00:00:00.464400
medcl/elasticsearch-analysis-ik,1,v,42,5,11,130,172,0 days 00:00:00.078448
janpaepke/ScrollMagic,1,v,5,2,2,21,26,0 days 00:00:00.042362
microsoft/LightGBM,1,v,9,1,6,19,28,0 days 00:00:00.165854
marcuswestin/store.js,1,v,4,1,2,31,35,0 days 00:00:00.030551
desktop/desktop,1,release-,22,6,8,136,158,0 days 00:00:01.913291
CopyTranslator/CopyTranslator,2, v,6,1,3,14,20,0 days 00:00:00.066025
uNetworking/uWebSockets,1,v,66,52,5,26,92,0 days 00:00:00.128262
gpujs/gpu.js,1,,21,15,3,55,76,0 days 00:00:00.081361
bootstrap-vue/bootstrap-vue,2, v,47,38,2,66,113,0 days 00:00:00.373683
plotly/plotly.js,1,v,72,54,3,133,205,0 days 00:00:01.656252
koel/koel,1,v,18,6,6,38,56,0 days 00:00:00.220336
wting/autojump,1,release-v,31,14,8,22,53,0 days 00:00:00.059535
Qv2ray/Qv2ray,1,v,15,11,2,32,47,0 days 00:00:00.182210
commitizen/cz-cli,2, v,16,6,7,58,74,0 days 00:00:00.040942
docker-slim/docker-slim,1,,38,21,10,17,55,0 days 00:00:00.172448
kamranahmedse/driver.js,2, v,8,3,1,27,35,0 days 00:00:00.040826
thomaspark/bootswatch,1,v,15,1,11,34,49,0 days 00:00:00.114285
foreversd/forever,2, v,17,2,10,51,68,0 days 00:00:00.057198
infinitered/reactotron,1,v,46,36,3,40,86,0 days 00:00:00.103744
micropython/micropython,1,v,19,4,10,31,50,0 days 00:00:01.076682
hapijs/hapi,2, v,129,106,11,194,323,0 days 00:00:00.546824
markdown-it/markdown-it,1,,29,13,10,47,76,0 days 00:00:00.270073
vuejs/vue,2, v,15,4,7,145,160,0 days 00:00:00.334379
dogecoin/dogecoin,2, v,17,3,10,64,81,0 days 00:00:01.232540
axios/axios,2, v,27,10,10,30,57,0 days 00:00:00.083476
d3/d3,1,v,91,58,12,197,288,0 days 00:00:00.447122
containers/podman,1,v,21,5,4,95,116,0 days 00:00:01.263093
facebook/react,2, v,36,8,14,58,94,0 days 00:00:01.237041
vercel/next.js,2, v,33,11,8,122,155,0 days 00:00:00.860959
hashicorp/packer,2, v,21,5,15,82,103,0 days 00:00:01.410741
puppeteer/puppeteer,1,v,61,49,1,33,94,0 days 00:00:00.169446
twbs/bootstrap,1,v,23,3,15,36,59,0 days 00:00:01.358408
nvbn/thefuck,1,,79,64,8,4,83,0 days 00:00:00.109109
iluwatar/java-design-patterns,1,,19,3,13,0,19,0 days 00:00:00.197738
FortAwesome/Font-Awesome,2, v,30,6,15,40,70,0 days 00:00:00.087750
Genymobile/scrcpy,1,v,25,9,5,2,27,0 days 00:00:00.231334
RasaHQ/rasa,1,,33,15,7,233,266,0 days 00:00:02.378457
microsoft/PowerToys,2, v,28,19,3,31,59,0 days 00:00:00.506548
facebook/react-native,2, v,67,52,8,144,211,0 days 00:00:01.906847
tensorflow/models,2,v. v,19,3,9,6,25,0 days 00:00:00.736797
elastic/kibana,1,v,55,17,12,190,245,0 days 00:00:07.363185
laravel/laravel,1,v,40,19,17,134,174,0 days 00:00:00.416196
typicode/json-server,2, v,17,4,10,106,123,0 days 00:00:00.074948
hakimel/reveal.js,1,,27,3,18,11,38,0 days 00:00:00.171193
huggingface/transformers,2, v,46,41,1,49,95,0 days 00:00:00.751709
gin-gonic/gin,1,v,13,3,8,13,26,0 days 00:00:00.087519
electron/electron,1,v,113,74,19,595,708,0 days 00:00:02.771773
ant-design/ant-design,1,,79,66,4,329,408,0 days 00:00:01.725753
microsoft/TypeScript,1,v,12,2,2,120,132,0 days 00:00:02.312767
reduxjs/redux,1,v,26,16,6,42,68,0 days 00:00:00.178504
pallets/flask,1,,16,5,10,25,41,0 days 00:00:00.284028
gohugoio/hugo,1,v,93,72,10,101,194,0 days 00:00:00.597510
mrdoob/three.js,1,r,132,107,6,0,132,0 days 00:00:02.844226
tailwindlabs/tailwindcss,1,v,21,9,8,127,148,0 days 00:00:00.319916
fatedier/frp,1,v,42,23,11,30,72,0 days 00:00:00.079715
chartjs/Chart.js,2, v,21,7,10,31,52,0 days 00:00:00.265145
521xueweihan/HelloGitHub,1,vol.,19,16,1,0,19,0 days 00:00:00.017496
adam-p/markdown-here,1,v,15,8,6,34,49,0 days 00:00:00.054873
socketio/socket.io,1,,30,5,15,118,148,0 days 00:00:00.153864
shadowsocks/shadowsocks-windows,1,,13,4,7,49,62,0 days 00:00:00.091774
webpack/webpack,1,v,152,134,8,224,376,0 days 00:00:01.448703
expressjs/express,1,,61,40,12,185,246,0 days 00:00:00.546959
sveltejs/svelte,1,v,134,119,2,244,378,0 days 00:00:00.806073
jquery/jquery,1,,23,1,21,63,86,0 days 00:00:00.596478
h5bp/html5-boilerplate,2, v,19,2,13,10,29,0 days 00:00:00.139772
coder/code-server,2, v,20,9,4,22,42,0 days 00:00:00.281941
protocolbuffers/protobuf,1,v,29,6,14,46,75,0 days 00:00:00.708277
lodash/lodash,1,,48,39,4,59,107,0 days 00:00:00.557286
azl397985856/leetcode,2, v,35,25,3,5,40,0 days 00:00:00.100008
apache/echarts,1,,29,5,14,64,93,0 days 00:00:00.661344
psf/requests,2, v,43,11,22,101,144,0 days 00:00:00.369057
remix-run/react-router,1,v,39,22,11,76,115,0 days 00:00:00.393032
django/django,1,,19,1,14,248,267,0 days 00:00:02.941146
bitcoin/bitcoin,1,v,25,3,20,82,107,0 days 00:00:03.080861
storybookjs/storybook,1,v,107,90,13,323,430,0 days 00:00:03.348177
moment/moment,1,,40,15,12,46,86,0 days 00:00:00.248944
tiangolo/fastapi,2, v,77,68,3,52,129,0 days 00:00:00.294232
tesseract-ocr/tesseract,1,,15,1,10,8,23,0 days 00:00:00.390733
nestjs/nest,2, v,33,18,5,167,200,0 days 00:00:00.879865
3b1b/manim,2, v,8,1,1,10,18,0 days 00:00:00.245548
junegunn/fzf,1,,27,8,13,76,103,0 days 00:00:00.142839
ionic-team/ionic-framework,2, v,43,27,10,140,183,0 days 00:00:01.176389
juliangarnier/anime,2, v,8,2,5,6,14,0 days 00:00:00.046452
soimort/you-get,1,v,3,1,1,143,146,0 days 00:00:00.327251
ColorlibHQ/AdminLTE,2, v,13,4,6,47,60,0 days 00:00:00.206733
prettier/prettier,2, v,39,20,8,71,110,0 days 00:00:00.631041
scrapy/scrapy,1,,32,7,17,58,90,0 days 00:00:00.683061
yarnpkg/yarn,2, v,50,38,1,114,164,0 days 00:00:00.196531
caddyserver/caddy,1,v,14,2,10,49,63,0 days 00:00:00.241207
atom/atom,2, v,271,256,2,104,375,0 days 00:00:03.121786
prometheus/prometheus,2, v,67,35,6,79,146,0 days 00:00:00.865836
strapi/strapi,1,v,16,7,3,79,95,0 days 00:00:01.606994
iamkun/dayjs,1,v,11,5,4,99,110,0 days 00:00:00.110683
nuxt/nuxt.js,1,v,30,17,7,112,142,0 days 00:00:00.420152
gogs/gogs,1,v,11,4,6,51,62,0 days 00:00:00.424000
Dogfalo/materialize,2, v,17,10,4,20,37,0 days 00:00:00.200876
vercel/hyper,2, v,18,9,6,43,61,0 days 00:00:00.195472
v2ray/v2ray-core,1,v,168,154,3,182,350,0 days 00:00:00.780204
impress/impress.js,1,,8,4,3,4,12,0 days 00:00:00.035185
facebook/jest,2, v,68,45,10,143,211,0 days 00:00:00.550447
grafana/grafana,2, v,46,7,9,181,227,0 days 00:00:02.647604
FiloSottile/mkcert,1,v,6,3,2,8,14,0 days 00:00:00.020912
commaai/openpilot,1,v,8,1,6,62,70,0 days 00:00:00.091650
PhilJay/MPAndroidChart,1,v,8,2,4,33,41,0 days 00:00:00.120289
ocornut/imgui,1,v,72,44,5,2,74,0 days 00:00:00.478088
hexojs/hexo,1,,38,15,12,101,139,0 days 00:00:00.291138
obsproject/obs-studio,1,,30,1,13,89,119,0 days 00:00:00.721427
babel/babel,1,v,90,67,9,606,696,0 days 00:00:01.859328
Leaflet/Leaflet,1,v,16,1,13,27,43,0 days 00:00:00.516156
dcloudio/uni-app,2, v,8,2,1,8,16,0 days 00:00:00.671088
facebook/docusaurus,1,v,14,8,1,37,51,0 days 00:00:00.211427
shadowsocks/shadowsocks,1,,4,1,2,14,18,0 days 00:00:00.048140
sahat/hackathon-starter,1,,8,2,4,6,14,0 days 00:00:00.125481
TryGhost/Ghost,2, v,170,154,8,318,488,0 days 00:00:01.458517
airbnb/lottie-android,2,v. v,21,8,9,42,63,0 days 00:00:00.183181
lerna/lerna,1,v,39,26,6,70,109,0 days 00:00:00.173826
d2l-ai/d2l-zh,1,v,9,5,3,0,9,0 days 00:00:00.142496
vuetifyjs/vuetify,1,v,23,7,8,284,307,0 days 00:00:00.797462
quilljs/quill,1,v,23,12,5,99,122,0 days 00:00:00.265757
koajs/koa,1,,43,23,13,44,87,0 days 00:00:00.087336
ansible/ansible,2, v,26,4,13,174,200,0 days 00:00:04.485550
gulpjs/gulp,2, v,6,2,3,13,19,0 days 00:00:00.066588
rclone/rclone,1,v,69,36,11,21,90,0 days 00:00:00.385979
zenorocha/clipboard.js,1,v,9,5,3,33,42,0 days 00:00:00.033820
videojs/video.js,2, v,70,38,15,220,290,0 days 00:00:00.530703
wg/wrk,1,,10,1,6,11,21,0 days 00:00:00.014422
wagoodman/dive,1,v,10,5,2,15,25,0 days 00:00:00.034295
bumptech/glide,1,v,21,6,11,15,36,0 days 00:00:00.157160
immutable-js/immutable-js,2, v,16,11,3,39,55,0 days 00:00:00.110369
shadowsocks/shadowsocks-android,1,v,24,8,11,156,180,0 days 00:00:00.234654
marktext/marktext,1,v,7,2,4,20,27,0 days 00:00:00.189015
google/zx,1,,23,21,1,19,42,0 days 00:00:00.034194
ant-design/ant-design-pro,2, v,18,6,6,12,30,0 days 00:00:00.267506
evanw/esbuild,1,v,12,5,2,284,296,0 days 00:00:00.273500
Blankj/AndroidUtilCode,1,,27,12,7,89,116,0 days 00:00:00.088252
XX-net/XX-Net,1,,51,36,5,285,336,0 days 00:00:00.298480
nolimits4web/swiper,1,v,49,14,12,139,188,0 days 00:00:00.392074
nativefier/nativefier,2, v,56,42,9,90,146,0 days 00:00:00.237939
carbon-app/carbon,1,,24,14,4,194,218,0 days 00:00:00.176353
nlohmann/json,2, v,15,2,8,36,51,0 days 00:00:00.282142
NervJS/taro,1,v,12,2,5,272,284,0 days 00:00:00.815917
microsoft/monaco-editor,2, v,28,11,10,36,64,0 days 00:00:00.174346
google/leveldb,2, v,21,7,7,0,21,0 days 00:00:00.032236
streamich/react-use,1,v,134,130,3,117,251,0 days 00:00:00.233829
photonstorm/phaser,2, v,39,20,11,59,98,0 days 00:00:01.253018
2dust/v2rayN,1,,117,111,1,2,119,0 days 00:00:00.064780
pandas-dev/pandas,2, v,28,1,22,56,84,0 days 00:00:02.107712
fxsjy/jieba,1,v,23,17,5,5,28,0 days 00:00:00.040129
react-boilerplate/react-boilerplate,1,v,17,6,6,13,30,0 days 00:00:00.104166
date-fns/date-fns,2,v. v,77,62,7,42,119,0 days 00:00:00.149756
beego/beego,1,v,16,3,10,24,40,0 days 00:00:00.252042
tastejs/todomvc,2, v,7,1,3,6,13,0 days 00:00:00.162553
jashkenas/backbone,2, v,10,2,7,22,32,0 days 00:00:00.192184
RocketChat/Rocket.Chat,1,,103,94,1,245,348,0 days 00:00:01.713546
openai/gym,2, v,15,7,6,34,49,0 days 00:00:00.096202
vuejs/vuex,1,v,21,7,7,24,45,0 days 00:00:00.081454
certbot/certbot,1,v,68,54,2,31,99,0 days 00:00:00.767767
Dreamacro/clash,1,v,28,10,3,14,42,0 days 00:00:00.046195
caolan/async,2, v,25,13,10,52,77,0 days 00:00:00.115842
nocodb/nocodb,2, v,9,5,2,86,95,0 days 00:00:00.294874
istio/istio,1,,22,3,12,143,165,0 days 00:00:01.428941
kenwheeler/slick,2, v,8,3,3,43,51,0 days 00:00:00.055882
square/leakcanary,1,v,14,4,9,10,24,0 days 00:00:00.122909
markedjs/marked,2, v,16,2,11,94,110,0 days 00:00:00.355793
hashicorp/terraform,2, v,18,2,12,158,176,0 days 00:00:02.240139
naptha/tesseract.js,2, v,4,1,2,28,32,0 days 00:00:00.045733
atlassian/react-beautiful-dnd,2, v,24,15,4,46,70,0 days 00:00:00.165260
standard/standard,1,v,66,55,8,87,153,0 days 00:00:00.154886
jesseduffield/lazygit,2, v,33,21,5,151,184,0 days 00:00:00.352180
ReactiveX/rxjs,1,,19,7,6,45,64,0 days 00:00:00.323346
mitmproxy/mitmproxy,2, v,30,4,17,35,65,0 days 00:00:00.676779
apolloconfig/apollo,2, v,19,2,9,16,35,0 days 00:00:00.160028
tannerlinsley/react-query,1,v,77,73,2,294,371,0 days 00:00:00.402026
typicode/husky,1,v,34,16,11,88,122,0 days 00:00:00.087914
airbnb/lottie-web,2,v. v,24,9,9,144,168,0 days 00:00:00.191982
denysdovhan/wtfjs,1,v,23,13,6,16,39,0 days 00:00:00.041134
jashkenas/underscore,1,,20,5,13,54,74,0 days 00:00:00.173641
layui/layui,2, v,7,1,4,41,48,0 days 00:00:00.032808
niklasvh/html2canvas,2, v,7,3,3,17,24,0 days 00:00:00.063646
aria2/aria2,1,release-,53,22,18,87,140,0 days 00:00:00.406454
postcss/postcss,1,,20,4,10,207,227,0 days 00:00:00.333331
webtorrent/webtorrent,1,v,125,112,9,284,409,0 days 00:00:00.375457
hankcs/HanLP,1,v,9,2,5,44,53,0 days 00:00:00.183454
github/fetch,1,v,21,10,9,19,40,0 days 00:00:00.051956
request/request,1,v,73,55,6,71,144,0 days 00:00:00.173744
select2/select2,1,,9,2,5,27,36,0 days 00:00:00.141869
Modernizr/Modernizr,1,v,20,4,12,23,43,0 days 00:00:00.193270
cheeriojs/cheerio,2, v,22,7,7,30,52,0 days 00:00:00.154992
docker/compose,2, v,41,12,15,67,108,0 days 00:00:00.655249
SortableJS/Sortable,1,,17,3,10,18,35,0 days 00:00:00.084141
harness/drone,1,v,31,17,9,44,75,0 days 00:00:00.225445
GitbookIO/gitbook,1,,22,17,2,68,90,0 days 00:00:00.142169
parallax/jsPDF,3, v. v,9,1,7,26,35,0 days 00:00:00.127893
composer/composer,1,,15,1,11,110,125,0 days 00:00:01.019802
GoogleChrome/lighthouse,2, v,56,40,4,42,98,0 days 00:00:00.389510
lenve/vhr,1,v,12,9,1,0,12,0 days 00:00:00.014898
Binaryify/NeteaseCloudMusicApi,2, v,52,36,7,102,154,0 days 00:00:00.201791
remy/nodemon,1,v,20,7,9,101,121,0 days 00:00:00.118044
tmux/tmux,1,,25,1,19,0,25,0 days 00:00:00.470092
sequelize/sequelize,2, v,137,107,19,334,471,0 days 00:00:00.870730
YMFE/yapi,2, v,9,2,3,68,77,0 days 00:00:00.431266
akveo/ngx-admin,1,v,19,2,9,8,27,0 days 00:00:00.066994
getsentry/sentry,2, v,102,90,9,294,396,0 days 00:00:03.124834
ggreer/the_silver_searcher,1,,37,17,8,12,49,0 days 00:00:00.228546
bvaughn/react-virtualized,2, v,71,65,3,129,200,0 days 00:00:00.278276
CodeHubApp/CodeHub,1,,15,10,3,13,28,0 days 00:00:00.042113
kubernetes/kubernetes,1,v,45,20,19,329,374,0 days 00:00:10.819242
elastic/elasticsearch,1,v,67,22,16,231,298,0 days 00:00:08.640869
pmndrs/react-spring,1,v,22,15,3,150,172,0 days 00:00:00.230774
fastify/fastify,1,v,104,96,1,90,194,0 days 00:00:00.245509
encode/django-rest-framework,1,,22,1,17,106,128,0 days 00:00:00.475705
Automattic/mongoose,2, v,58,15,20,646,704,0 days 00:00:01.151847
explosion/spaCy,2, v,28,14,11,72,100,0 days 00:00:01.029967
kubernetes/minikube,1,v,61,43,1,45,106,0 days 00:00:01.314586
laravel/framework,2, v,163,148,13,630,793,0 days 00:00:03.171457
influxdata/influxdb,2, v,26,6,14,133,159,0 days 00:00:02.936922
