project,prefixes,prefixes_names,main_releases,rapid_releases,trad_releases,patches,releases,time
Yelp/dumb-init,1,v,8,2,3,14,22,0 days 00:00:00.035493
kalcaddle/KodExplorer,2, v,31,2,6,3,34,0 days 00:00:00.038766
mindoc-org/mindoc,1,v,14,8,3,17,31,0 days 00:00:00.059192
botman/botman,2, v,17,8,4,44,61,0 days 00:00:00.080103
projectdiscovery/subfinder,2, v,10,3,4,24,34,0 days 00:00:00.081252
jquense/react-big-calendar,1,v,37,4,5,77,114,0 days 00:00:00.096628
bblanchon/ArduinoJson,1,v,42,10,7,56,98,0 days 00:00:00.119929
substack/tape,1,v,50,2,10,85,135,0 days 00:00:00.095051
googleapis/google-api-python-client,1,v,60,8,3,52,112,0 days 00:00:00.140813
joeyespo/grip,1,v,15,2,10,9,24,0 days 00:00:00.047465
telegraf/telegraf,2, v,68,11,5,112,180,0 days 00:00:00.154625
neutralinojs/neutralinojs,1,v,26,18,4,4,30,0 days 00:00:00.087250
eternnoir/pyTelegramBotAPI,1,,15,3,7,37,52,0 days 00:00:00.114961
tijsverkoyen/CssToInlineStyles,1,,9,2,2,20,29,0 days 00:00:00.026513
Xhofe/alist,1,v,9,5,2,33,42,0 days 00:00:00.050172
thephpleague/omnipay,2, v,12,3,4,18,30,0 days 00:00:00.049806
assaf/zombie,2, v,21,8,5,111,132,0 days 00:00:00.131176
kyleconroy/sqlc,2, v,15,6,3,1,16,0 days 00:00:00.064304
capstone-engine/capstone,1,,5,2,2,9,14,0 days 00:00:00.217119
lebab/lebab,1,v,14,8,2,28,42,0 days 00:00:00.062668
OpenNMT/OpenNMT-py,2, v,15,5,7,14,29,0 days 00:00:00.150767
kickstarter/android-oss,1,v,36,14,5,36,72,0 days 00:00:00.362795
nodeca/js-yaml,1,,23,2,11,51,74,0 days 00:00:00.184967
docker/docker-py,1,,40,7,11,63,103,0 days 00:00:00.320314
documentationjs/documentation,1,v,36,3,4,49,85,0 days 00:00:00.192397
haifengl/smile,1,v,12,3,6,10,22,0 days 00:00:00.241166
sockeqwe/mosby,1,,7,3,2,8,15,0 days 00:00:00.040529
nl8590687/ASRT_SpeechRecognition,1,v,10,3,2,4,14,0 days 00:00:00.026275
dinerojs/dinero.js,2, v,13,7,3,17,30,0 days 00:00:00.040327
vuejs/vetur,2, v,23,12,7,47,70,0 days 00:00:00.331846
graphql-java/graphql-java,2, v,40,6,12,2,42,0 days 00:00:00.294902
dotnetcore/CAP,1,v,22,4,10,30,52,0 days 00:00:00.111799
express-validator/express-validator,1,v,55,6,7,60,115,0 days 00:00:00.106525
tilt-dev/tilt,1,v,30,16,5,172,202,0 days 00:00:00.421373
hashicorp/serf,1,v,9,3,2,22,31,0 days 00:00:00.103334
bfenetworks/bfe,1,v,18,10,3,0,18,0 days 00:00:00.070564
mikaelbr/node-notifier,1,v,24,3,10,45,69,0 days 00:00:00.065869
missive/emoji-mart,1,v,20,4,7,40,60,0 days 00:00:00.062693
jackc/pgx,1,v,36,5,14,18,54,0 days 00:00:00.124554
jrnl-org/jrnl,2, v,13,3,4,24,37,0 days 00:00:00.093259
jaywcjlove/hotkeys,1,v,12,2,3,62,74,0 days 00:00:00.045387
serilog/serilog,1,v,19,3,7,13,32,0 days 00:00:00.101875
tensorflow/serving,2, r,25,5,10,27,52,0 days 00:00:00.484923
algolia/places,1,v,34,10,3,69,103,0 days 00:00:00.086848
jonls/redshift,2, v,17,3,7,2,19,0 days 00:00:00.047646
jonschlinkert/remarkable,2, v,9,5,2,13,22,0 days 00:00:00.037687
ppoffice/hexo-theme-icarus,2, v,22,2,7,9,31,0 days 00:00:00.039396
valor-software/ngx-bootstrap,2, v,31,11,7,81,112,0 days 00:00:00.167955
johnkerl/miller,2, v,29,15,8,23,52,0 days 00:00:00.426405
mwouts/jupytext,3, v. v,20,5,6,75,95,0 days 00:00:00.149371
kaorun343/vue-property-decorator,1,v,24,4,5,16,40,0 days 00:00:00.031717
ly525/luban-h5,1,v,18,6,2,14,32,0 days 00:00:00.050040
weaveworks/scope,2, v,31,15,5,30,61,0 days 00:00:00.331354
MinecraftForge/MinecraftForge,2, v,59,22,13,10,69,0 days 00:00:00.594446
angular-ui/ui-grid,1,v,24,7,7,86,110,0 days 00:00:00.304164
log4js-node/log4js-node,1,v,32,9,7,90,122,0 days 00:00:00.149591
go-acme/lego,1,v,34,12,7,17,51,0 days 00:00:00.083526
gorakhargosh/watchdog,1,v,12,2,6,35,47,0 days 00:00:00.083890
tjanczuk/edge,1,v,11,2,4,23,34,0 days 00:00:00.048912
django/channels,1,,20,7,7,44,64,0 days 00:00:00.082449
PyGithub/PyGithub,2, v,62,31,6,23,85,0 days 00:00:00.148954
devicons/devicon,1,v,17,4,5,4,21,0 days 00:00:00.170602
i-tu/Hasklig,2, v,12,3,3,0,12,0 days 00:00:00.170239
alibaba/transmittable-thread-local,2, v,18,5,8,31,49,0 days 00:00:00.171669
leongersen/noUiSlider,1,,45,7,13,58,103,0 days 00:00:00.180147
tzapu/WiFiManager,2, v,16,5,3,0,16,0 days 00:00:00.138130
ExactTarget/fuelux,1,,25,9,5,59,84,0 days 00:00:00.310277
graphql-dotnet/graphql-dotnet,2, v,42,12,6,45,87,0 days 00:00:00.121619
kartik-v/bootstrap-fileinput,1,v,26,6,3,61,87,0 days 00:00:00.083309
containers/buildah,3, V v,42,18,3,70,112,0 days 00:00:00.432094
release-it/release-it,1,,84,18,5,176,260,0 days 00:00:00.169377
go-task/task,1,v,26,7,6,26,52,0 days 00:00:00.120024
sachinchoolur/lightGallery,2, v,16,2,4,66,82,0 days 00:00:00.072053
nodegit/nodegit,1,v,27,8,10,67,94,0 days 00:00:00.209478
nhn/tui.image-editor,2, v,21,5,7,17,38,0 days 00:00:00.046246
wangyu-/udp2raw,1,,38,17,2,0,38,0 days 00:00:00.043577
vrana/adminer,1,v,17,4,11,35,52,0 days 00:00:00.138719
crossplane/crossplane,1,v,23,11,3,34,57,0 days 00:00:00.339852
lancedikson/bowser,2, v,26,8,8,33,59,0 days 00:00:00.062495
vuejs/v2.vuejs.org,1,v,8,2,3,9,17,0 days 00:00:00.027217
phan/phan,1,,33,12,10,127,160,0 days 00:00:00.463740
share/sharedb,1,v,23,5,4,111,134,0 days 00:00:00.113636
timolins/react-hot-toast,1,v,7,2,2,5,12,0 days 00:00:00.035888
ai/size-limit,1,,45,9,2,101,146,0 days 00:00:00.112512
reactchartjs/react-chartjs-2,3, v. v,24,2,2,51,75,0 days 00:00:00.045268
msiemens/tinydb,2, v,34,5,11,26,60,0 days 00:00:00.051078
arkime/arkime,1,v,32,2,16,70,102,0 days 00:00:00.243655
expressjs/body-parser,1,,21,2,8,47,68,0 days 00:00:00.066213
jvm-profiling-tools/async-profiler,1,v,14,2,9,9,23,0 days 00:00:00.051262
openpgpjs/openpgpjs,1,v,40,10,9,109,149,0 days 00:00:00.189196
jarun/buku,2, v,36,15,6,3,39,0 days 00:00:00.126141
journeyapps/zxing-android-embedded,1,v,15,2,10,7,22,0 days 00:00:00.094441
onionshare/onionshare,2, v,18,5,11,9,27,0 days 00:00:00.399474
minbrowser/min,2, v,26,4,8,31,57,0 days 00:00:00.121832
nhn/tui.chart,2, v,38,17,5,60,98,0 days 00:00:00.166102
uber/prototool,1,v,18,9,2,2,20,0 days 00:00:00.047695
laravel-mix/laravel-mix,1,v,27,16,2,105,132,0 days 00:00:00.148009
Mailtrain-org/mailtrain,1,v,25,9,2,10,35,0 days 00:00:00.118587
istanbuljs/nyc,1,v,58,15,2,56,114,0 days 00:00:00.088298
zhaojun1998/zfile,1,,32,8,3,11,43,0 days 00:00:00.074585
wiremock/wiremock,2, release-,55,17,15,28,83,0 days 00:00:00.156509
kedacore/keda,1,v,14,3,4,3,17,0 days 00:00:00.189082
timber/timber,2, v,32,10,14,96,128,0 days 00:00:00.357991
material-shell/material-shell,2, v,11,5,2,0,11,0 days 00:00:00.158411
uNetworking/uWebSockets.js,1,v,59,32,3,6,65,0 days 00:00:00.188417
rauchg/slackin,1,,14,2,2,26,40,0 days 00:00:00.050333
panjf2000/gnet,1,v,8,2,4,35,43,0 days 00:00:00.086009
pedroslopez/whatsapp-web.js,1,v,18,5,2,39,57,0 days 00:00:00.045932
johannesjo/super-productivity,1,v,58,45,3,296,354,0 days 00:00:00.729245
reactjs/react-rails,2, v,24,7,7,31,55,0 days 00:00:00.087364
fengyuanchen/viewerjs,1,v,21,4,5,28,49,0 days 00:00:00.044070
Angel-ML/angel,2,Release- v,14,2,6,4,18,0 days 00:00:00.173313
LonamiWebs/Telethon,1,v,44,21,4,91,135,0 days 00:00:00.157966
docker/machine,2, v,16,2,8,16,32,0 days 00:00:00.233952
roadrunner-server/roadrunner,2, v,22,6,7,81,103,0 days 00:00:00.236466
ponylang/ponyc,2, release-,51,31,9,56,107,0 days 00:00:00.512592
sghall/react-move,1,v,28,8,4,21,49,0 days 00:00:00.040665
chainer/chainer,1,v,60,44,3,18,78,0 days 00:00:02.309605
mobxjs/mobx-state-tree,2, v,38,21,6,64,102,0 days 00:00:00.145913
hajimehoshi/ebiten,1,v,17,2,13,66,83,0 days 00:00:00.409258
0x7c13/Notepads,1,v,14,3,2,42,56,0 days 00:00:00.068924
SigmaHQ/sigma,1,,19,6,6,10,29,0 days 00:00:00.850648
ocrmypdf/OCRmyPDF,1,v,63,26,7,115,178,0 days 00:00:00.209554
zo0r/react-native-push-notification,2, v,16,5,2,19,35,0 days 00:00:00.052741
boto/boto,2, v,50,25,9,29,79,0 days 00:00:00.489832
linkedin/css-blocks,2, v,17,6,4,22,39,0 days 00:00:00.102084
Squirrel/Squirrel.Windows,1,,17,5,6,48,65,0 days 00:00:00.081342
baconjs/bacon.js,1,,9,2,2,200,209,0 days 00:00:00.338316
mRemoteNG/mRemoteNG,2, v,17,4,7,23,40,0 days 00:00:00.348102
appleboy/gorush,2, v,16,6,7,15,31,0 days 00:00:00.053624
kpdecker/jsdiff,1,v,15,2,8,24,39,0 days 00:00:00.037009
ramboxapp/community-edition,1,,7,2,3,36,43,0 days 00:00:00.073641
dylanaraps/pywal,1,,17,8,2,65,82,0 days 00:00:00.062814
rancher/os,1,v,15,3,6,43,58,0 days 00:00:00.164598
opencart/opencart,1,,11,3,4,24,35,0 days 00:00:00.811428
automl/auto-sklearn,3, v. v,12,2,6,21,33,0 days 00:00:00.134145
vmware-tanzu/velero,1,v,17,2,8,43,60,0 days 00:00:00.200919
aws/aws-sdk-php,1,,234,16,2,1228,1462,0 days 00:00:02.807015
optuna/optuna,1,v,36,27,2,4,40,0 days 00:00:00.738536
feross/simple-peer,1,v,50,9,6,71,121,0 days 00:00:00.095505
mautic/mautic,1,,30,6,13,59,89,0 days 00:00:01.712615
Cyan4973/xxHash,2,r v,12,3,4,11,23,0 days 00:00:00.076129
PHPOffice/PHPWord,1,,12,3,7,8,20,0 days 00:00:00.137399
gocd/gocd,1,,69,47,4,2,71,0 days 00:00:01.104444
elasticsearch-dump/elasticsearch-dump,2, v,113,12,2,137,250,0 days 00:00:00.298838
Radarr/Radarr,2, v,99,43,13,13,112,0 days 00:00:00.698819
i18next/i18next,2, v,91,11,5,222,313,0 days 00:00:00.220801
jackocnr/intl-tel-input,2, v,62,17,5,262,324,0 days 00:00:00.255472
FreeRDP/FreeRDP,1,,9,2,4,8,17,0 days 00:00:01.117838
albertlauncher/albert,1,v,17,9,5,64,81,0 days 00:00:00.088945
doccano/doccano,1,v,8,2,3,19,27,0 days 00:00:00.173613
yocontra/react-responsive,1,v,8,2,2,28,36,0 days 00:00:00.026366
amoffat/sh,1,,34,9,4,17,51,0 days 00:00:00.081456
StackExchange/blackbox,1,v,18,3,8,0,18,0 days 00:00:00.037767
go-resty/resty,1,v,34,5,10,7,41,0 days 00:00:00.040419
react-native-video/react-native-video,2, v,24,8,6,49,73,0 days 00:00:00.089133
yagop/node-telegram-bot-api,1,v,26,5,4,13,39,0 days 00:00:00.052078
medialize/URI.js,2,v. v,20,4,8,54,74,0 days 00:00:00.066423
symfony/translation,1,v,26,4,21,462,488,0 days 00:00:00.571085
DIYgod/APlayer,2, v,6,2,2,15,21,0 days 00:00:00.030866
99designs/aws-vault,1,v,34,6,9,32,66,0 days 00:00:00.210284
thephpleague/oauth2-server,1,,25,3,10,72,97,0 days 00:00:00.169589
invoiceninja/invoiceninja,1,v,41,20,5,387,428,0 days 00:00:01.616588
simonw/datasette,1,,55,31,6,39,94,0 days 00:00:00.137140
securego/gosec,2, v,16,2,8,8,24,0 days 00:00:00.052299
ArthurHub/Android-Image-Cropper,1,,9,2,6,23,32,0 days 00:00:00.039548
bpmn-io/bpmn-js,2, v,75,23,3,155,230,0 days 00:00:00.261286
software-mansion/react-native-reanimated,1,,23,5,2,19,42,0 days 00:00:00.233527
NixOS/nix,1,,37,4,23,53,90,0 days 00:00:00.882674
faker-js/faker,1,v,22,8,7,26,48,0 days 00:00:00.134863
centrifugal/centrifugo,1,v,24,5,8,57,81,0 days 00:00:00.093508
garris/BackstopJS,2, v,25,5,5,106,131,0 days 00:00:00.112076
pahen/madge,2, v,30,4,5,29,59,0 days 00:00:00.041777
gruntwork-io/terratest,1,v,39,5,4,296,335,0 days 00:00:00.456579
chrismaltby/gb-studio,2, v,6,3,2,6,12,0 days 00:00:00.219288
marshmallow-code/marshmallow,1,,48,14,9,77,125,0 days 00:00:00.321395
react-native-svg/react-native-svg,2, v,45,13,6,164,209,0 days 00:00:00.300851
tindy2013/subconverter,1,v,7,3,2,28,35,0 days 00:00:00.045491
jenssegers/laravel-mongodb,2, v,19,3,7,91,110,0 days 00:00:00.203704
mcollina/autocannon,1,v,52,6,5,43,95,0 days 00:00:00.062587
uber/cadence,1,v,22,10,6,55,77,0 days 00:00:00.328283
crater-invoice/crater,1,,11,4,4,19,30,0 days 00:00:00.078026
flot/flot,2, v,16,4,6,35,51,0 days 00:00:00.070586
snipe/snipe-it,3, V v,30,12,13,130,160,0 days 00:00:00.737106
SocketCluster/socketcluster,3, v. v,17,3,3,26,43,0 days 00:00:00.068699
PaddlePaddle/Paddle-Lite,3, release/ v,15,4,7,6,21,0 days 00:00:00.524029
wojtekmaj/react-pdf,1,v,27,8,6,36,63,0 days 00:00:00.079882
burnash/gspread,2, v,19,7,7,21,40,0 days 00:00:00.068550
fabiospampinato/cash,1,,16,4,4,36,52,0 days 00:00:00.053664
reactiveui/refit,2, v,13,2,6,39,52,0 days 00:00:00.130514
jazzband/pip-tools,1,,45,15,10,49,94,0 days 00:00:00.129897
heroiclabs/nakama,1,v,38,11,5,29,67,0 days 00:00:00.086120
google/error-prone,1,v,15,2,5,34,49,0 days 00:00:00.295859
rest-assured/rest-assured,1,rest-assured-,32,6,15,40,72,0 days 00:00:00.128906
moroshko/react-autosuggest,1,v,41,3,3,54,95,0 days 00:00:00.062808
platformio/platformio-core,3, v. v,43,22,13,72,115,0 days 00:00:00.309111
twitchtv/twirp,1,v,18,8,6,10,28,0 days 00:00:00.045654
gruntwork-io/terragrunt,1,v,37,7,5,337,374,0 days 00:00:00.291643
perkeep/perkeep,1,,11,4,5,0,11,0 days 00:00:00.408522
neuecc/UniRx,1,,18,8,4,7,25,0 days 00:00:00.063868
concourse/concourse,1,v,134,104,4,81,215,0 days 00:00:01.992420
Unleash/unleash,2, v,34,15,5,132,166,0 days 00:00:00.321648
davidjbradshaw/iframe-resizer,2, v,26,9,4,96,122,0 days 00:00:00.100546
kulshekhar/ts-jest,2, v,30,13,6,88,118,0 days 00:00:00.345598
mitchellh/mapstructure,1,v,6,2,3,11,17,0 days 00:00:00.027913
mahmoud/boltons,1,,24,8,8,21,45,0 days 00:00:00.205494
postmanlabs/newman,3, v. v,26,8,6,80,106,0 days 00:00:00.376061
react-native-device-info/react-native-device-info,1,v,57,8,2,114,171,0 days 00:00:00.126185
voidcosmos/npkill,1,v,8,5,2,19,27,0 days 00:00:00.034660
vmware-tanzu/octant,1,v,25,15,3,15,40,0 days 00:00:00.343175
deepmipt/DeepPavlov,1,,17,4,3,28,45,0 days 00:00:00.155255
Financial-Times/polyfill-service,2, v,87,36,5,87,174,0 days 00:00:00.261216
gevent/gevent,2, v,19,4,12,35,54,0 days 00:00:00.358309
HMBSbige/ShadowsocksR-Windows,1,,28,4,10,127,155,0 days 00:00:00.143033
redux-observable/redux-observable,2, v,23,9,5,8,31,0 days 00:00:00.043311
mattn/go-sqlite3,1,v,16,2,6,19,35,0 days 00:00:00.065009
kelseyhightower/confd,1,v,15,3,8,7,22,0 days 00:00:00.058778
gcanti/fp-ts,1,,38,19,7,115,153,0 days 00:00:00.172864
taigaio/taiga-back,1,,24,7,8,74,98,0 days 00:00:00.334987
UKPLab/sentence-transformers,1,v,10,3,5,20,30,0 days 00:00:00.063714
metalsmith/metalsmith,2, v,24,4,2,60,84,0 days 00:00:00.046320
carla-simulator/carla,1,,9,4,3,38,47,0 days 00:00:00.386934
jsx-eslint/eslint-plugin-react,1,v,81,38,6,88,169,0 days 00:00:00.398522
hybridgroup/gobot,3, v. v,29,10,11,16,45,0 days 00:00:00.161956
colinhacks/zod,2, v,20,10,2,23,43,0 days 00:00:00.097065
remix-run/history,1,v,38,10,4,40,78,0 days 00:00:00.170964
pentaho/pentaho-kettle,1,,31,3,11,37,68,0 days 00:00:01.128229
rebassjs/rebass,1,v,11,2,4,42,53,0 days 00:00:00.097514
BeyondDimension/SteamTools,1,,10,5,3,28,38,0 days 00:00:00.171200
yjs/yjs,1,v,19,2,4,151,170,0 days 00:00:00.149275
beautify-web/js-beautify,1,v,13,3,7,74,87,0 days 00:00:00.189960
tailscale/tailscale,1,v,19,6,2,54,73,0 days 00:00:00.263828
paramiko/paramiko,3, release- v,23,3,13,152,175,0 days 00:00:00.230075
theonedev/onedev,2, v,26,13,2,131,157,0 days 00:00:00.297249
go-swagger/go-swagger,2, v,29,8,11,26,55,0 days 00:00:00.180832
kubernetes/kompose,1,v,34,17,5,3,37,0 days 00:00:00.111866
signalapp/Signal-Server,1,v,215,20,2,18,233,0 days 00:00:00.289375
react-native-image-picker/react-native-image-picker,2, v,37,2,3,86,123,0 days 00:00:00.071098
99designs/gqlgen,2, v,16,7,6,35,51,0 days 00:00:00.279202
swagger-api/swagger-editor,3, v/ v,27,2,8,364,391,0 days 00:00:00.514780
chaijs/chai,2, v,30,8,9,48,78,0 days 00:00:00.102960
konvajs/konva,1,,41,11,7,131,172,0 days 00:00:00.259490
symfony/http-kernel,1,v,26,4,21,489,515,0 days 00:00:00.742818
retejs/rete,2, v,12,3,2,35,47,0 days 00:00:00.040194
akveo/nebular,1,v,23,6,4,23,46,0 days 00:00:00.124751
go-vgo/robotgo,2, v,21,3,7,24,45,0 days 00:00:00.073316
NginxProxyManager/nginx-proxy-manager,2, v,10,3,2,48,58,0 days 00:00:00.070517
secdev/scapy,1,v,80,8,8,432,512,0 days 00:00:00.681243
HangfireIO/Hangfire,2,v. v,13,4,4,92,105,0 days 00:00:00.293421
streamlink/streamlink,1,,30,9,7,17,47,0 days 00:00:00.351746
PrestaShop/PrestaShop,1,,30,16,4,83,113,0 days 00:00:04.683909
twigphp/Twig,1,v,66,29,20,139,205,0 days 00:00:00.370304
metricsgraphics/metrics-graphics,3,V v v.,25,12,4,10,35,0 days 00:00:00.083826
doctrine/cache,2, v,17,2,7,27,44,0 days 00:00:00.058832
ckeditor/ckeditor5,2, v,48,30,3,6,54,0 days 00:00:03.267695
react-cosmos/react-cosmos,2, v,33,6,6,41,74,0 days 00:00:00.126675
InsertKoinIO/koin,1,,13,5,6,33,46,0 days 00:00:00.130973
trustedsec/social-engineer-toolkit,1,,17,3,8,87,104,0 days 00:00:00.881436
altair-viz/altair,2, v,13,3,7,8,21,0 days 00:00:00.186736
openspug/spug,2,V v,8,2,3,34,42,0 days 00:00:00.184359
webpack/webpack-dev-server,1,v,42,14,9,70,112,0 days 00:00:00.154948
gogf/gf,1,v,14,2,4,106,120,0 days 00:00:00.312247
cryptomator/cryptomator,1,,18,7,6,73,91,0 days 00:00:00.336483
webdriverio/webdriverio,1,v,91,45,11,415,506,0 days 00:00:00.970567
sosedoff/pgweb,1,v,11,6,3,31,42,0 days 00:00:00.065993
mopidy/mopidy,1,v,29,6,16,38,67,0 days 00:00:00.452486
sandboxie-plus/Sandboxie,2, v,11,2,4,58,69,0 days 00:00:00.108686
Sonarr/Sonarr,1,v,44,12,4,8,52,0 days 00:00:00.521669
symfony/debug,1,v,16,2,13,354,370,0 days 00:00:00.244447
winsw/winsw,1,v,21,4,10,10,31,0 days 00:00:00.058624
i18next/react-i18next,2, v,84,15,2,164,248,0 days 00:00:00.177236
davemorrissey/subsampling-scale-image-view,1,v,13,3,4,8,21,0 days 00:00:00.027777
numba/numba,2, v,54,9,8,51,105,0 days 00:00:01.579744
QuantConnect/Lean,2, v,1917,18,4,10,1927,0 days 00:00:05.103737
FluentValidation/FluentValidation,1,,49,11,18,60,109,0 days 00:00:00.144161
AppImage/AppImageKit,1,,13,2,8,0,13,0 days 00:00:00.121468
rocksdanister/lively,1,v,18,6,2,29,47,0 days 00:00:00.037473
facebook/litho,1,v,41,22,2,157,198,0 days 00:00:01.116541
xo/usql,1,v,10,4,3,22,32,0 days 00:00:00.046985
ngrx/platform,2, v,35,16,5,25,60,0 days 00:00:00.111287
pennersr/django-allauth,1,,42,11,18,13,55,0 days 00:00:00.187119
PointCloudLibrary/pcl,1,pcl-,13,2,8,12,25,0 days 00:00:01.368907
sveltejs/sapper,1,v,29,16,4,149,178,0 days 00:00:00.146083
smartystreets/goconvey,2, v,7,3,3,20,27,0 days 00:00:00.311494
graphql-python/graphene,2,v. v,16,7,5,29,45,0 days 00:00:00.096718
pytube/pytube,2, v,31,10,7,78,109,0 days 00:00:00.100090
OWASP/Amass,2, v,37,14,5,123,160,0 days 00:00:00.138510
lz4/lz4,2,r v,18,10,2,11,29,0 days 00:00:00.300725
java-native-access/jna,2, v,26,3,18,32,58,0 days 00:00:00.243130
es-shims/es5-shim,1,v,19,5,4,77,96,0 days 00:00:00.073504
marionettejs/backbone.marionette,1,v,32,12,9,93,125,0 days 00:00:00.208941
symfony/routing,1,v,26,2,21,441,467,0 days 00:00:00.523140
metafizzy/flickity,1,v,10,2,5,24,34,0 days 00:00:00.037351
ljharb/qs,1,v,25,3,7,49,74,0 days 00:00:00.065036
google/android-classyshark,1,,15,7,2,0,15,0 days 00:00:00.028304
nopSolutions/nopCommerce,1,release-,29,4,20,6,35,0 days 00:00:00.846230
AmruthPillai/Reactive-Resume,1,v,7,4,2,24,31,0 days 00:00:00.166325
Zettlr/Zettlr,3, v. v,28,12,6,49,77,0 days 00:00:00.413640
mamedev/mame,1,mame,124,88,11,0,124,0 days 00:00:05.381041
apache/cassandra,1,cassandra-,23,7,13,183,206,0 days 00:00:01.765707
gitkraken/vscode-gitlens,2, v,45,28,4,91,136,0 days 00:00:00.257228
jazzband/django-debug-toolbar,2, v,25,3,15,24,49,0 days 00:00:00.297845
jemalloc/jemalloc,1,,22,2,13,24,46,0 days 00:00:00.214858
encode/starlette,1,,19,2,4,94,113,0 days 00:00:00.086653
raineorshine/npm-check-updates,2, v,56,6,4,194,250,0 days 00:00:00.193239
ThreeMammals/Ocelot,1,,31,5,3,110,141,0 days 00:00:00.102469
mqttjs/MQTT.js,2, v,42,8,6,109,151,0 days 00:00:00.123134
symfony/css-selector,1,v,26,3,10,434,460,0 days 00:00:00.366661
developit/microbundle,2, v,15,5,5,24,39,0 days 00:00:00.055741
hrydgard/ppsspp,1,v,20,3,14,46,66,0 days 00:00:01.965114
deepstreamIO/deepstream.io,2, v,25,5,5,98,123,0 days 00:00:00.230126
DevinVinson/WordPress-Plugin-Boilerplate,1,,9,4,2,5,14,0 days 00:00:00.031095
xmrig/xmrig,1,v,46,34,7,73,119,0 days 00:00:00.190346
Turfjs/turf,2, v,23,10,3,65,88,0 days 00:00:00.219292
final-form/react-final-form,2,v. v,23,7,2,47,70,0 days 00:00:00.040795
symfony/process,1,v,26,4,19,450,476,0 days 00:00:00.500507
FullHuman/purgecss,2, v,23,8,7,20,43,0 days 00:00:00.080227
projectstorm/react-diagrams,2, v,16,4,5,23,39,0 days 00:00:00.058294
ffuf/ffuf,1,v,18,2,4,6,24,0 days 00:00:00.030021
wallabag/wallabag,1,,20,5,10,40,60,0 days 00:00:00.584513
jsplumb/jsplumb,1,,28,3,14,188,216,0 days 00:00:00.445255
symfony/var-dumper,1,v,20,4,15,355,375,0 days 00:00:00.446150
abel533/Mapper,1,,18,6,4,33,51,0 days 00:00:00.051545
readthedocs/readthedocs.org,1,,76,52,5,152,228,0 days 00:00:01.311665
trentm/node-bunyan,1,,33,4,4,81,114,0 days 00:00:00.090475
rr-debugger/rr,1,,28,9,14,6,34,0 days 00:00:00.304126
taskflow/taskflow,1,v,13,3,8,1,14,0 days 00:00:00.106281
monero-project/monero,1,v,19,7,7,34,53,0 days 00:00:00.721727
verlok/vanilla-lazyload,2, v,81,29,5,77,158,0 days 00:00:00.142565
Humanizr/Humanizer,3, V v,16,8,4,49,65,0 days 00:00:00.145273
barry-ran/QtScrcpy,1,v,9,3,2,15,24,0 days 00:00:00.041581
reactiveui/ReactiveUI,2, v,41,16,7,181,222,0 days 00:00:00.862178
brunch/brunch,1,,24,10,7,107,131,0 days 00:00:00.262276
TrinityCore/TrinityCore,1,TDB,74,41,22,6,80,0 days 00:00:03.384580
cssinjs/jss,2, v,60,20,8,86,146,0 days 00:00:00.161325
gobuffalo/buffalo,2, v,15,2,7,107,122,0 days 00:00:00.200937
mongodb/mongo-go-driver,2, v,13,3,7,60,73,0 days 00:00:00.126559
tgalal/yowsup,1,v,8,3,4,20,28,0 days 00:00:00.077102
twpayne/chezmoi,1,v,27,15,4,106,133,0 days 00:00:00.204300
microsoft/azuredatastudio,2, v,40,25,2,89,129,0 days 00:00:00.709286
transmission/transmission,1,,99,55,12,1,100,0 days 00:00:00.860233
kazupon/vue-i18n,1,v,64,18,3,83,147,0 days 00:00:00.136183
infracost/infracost,2, v,10,5,3,62,72,0 days 00:00:00.123462
SirVer/ultisnips,1,,11,2,7,0,11,0 days 00:00:00.091604
NLPchina/elasticsearch-sql,1,,46,4,4,144,190,0 days 00:00:00.105746
ActivityWatch/activitywatch,1,v,8,2,3,11,19,0 days 00:00:00.047022
jupyterhub/jupyterhub,1,,19,2,11,20,39,0 days 00:00:00.361679
lucas-clemente/quic-go,2,v. v,24,5,10,33,57,0 days 00:00:00.412742
aheckmann/gm,2, v,31,5,7,35,66,0 days 00:00:00.048954
qemu/qemu,2,release_ v,48,2,42,86,134,0 days 00:00:08.748766
lcobucci/jwt,1,,11,2,4,34,45,0 days 00:00:00.094359
hugapi/hug,1,,18,10,5,44,62,0 days 00:00:00.145166
open-policy-agent/opa,1,v,40,22,6,80,120,0 days 00:00:00.273424
grpc/grpc-web,1,,7,4,2,9,16,0 days 00:00:00.061104
gregberge/loadable-components,1,v,30,5,3,35,65,0 days 00:00:00.047218
xojs/xo,1,v,43,3,7,43,86,0 days 00:00:00.057099
juice-shop/juice-shop,2, v,91,56,8,101,192,0 days 00:00:01.201459
visgl/react-map-gl,2, v,22,3,8,143,165,0 days 00:00:00.137446
migueldeicaza/gui.cs,1,v,13,2,3,9,22,0 days 00:00:00.156445
electron/fiddle,2, v,29,12,3,22,51,0 days 00:00:00.200370
flyway/flyway,1,flyway-,40,7,13,101,141,0 days 00:00:00.223903
cockpit-project/cockpit,2, v,314,275,6,1,315,0 days 00:00:01.750346
jaredpalmer/tsdx,1,v,13,4,3,40,53,0 days 00:00:00.050125
Laravel-Lang/lang,1,,20,9,4,174,194,0 days 00:00:00.589889
aws/aws-sdk-js,1,v,1089,18,4,301,1390,0 days 00:00:02.335100
eclipse/che,1,,100,85,2,126,226,0 days 00:00:00.829602
QUANTAXIS/QUANTAXIS,2, V,15,3,4,44,59,0 days 00:00:00.453091
svgdotjs/svg.js,1,,50,5,5,48,98,0 days 00:00:00.103096
josdejong/jsoneditor,1,v,71,21,5,125,196,0 days 00:00:00.146285
grpc/grpc-java,1,v,52,22,4,58,110,0 days 00:00:00.413257
react-native-camera/react-native-camera,1,v,84,7,3,96,180,0 days 00:00:00.143499
stylelint/stylelint,2, v,97,72,4,88,185,0 days 00:00:00.488381
snapappointments/bootstrap-select,2, v,13,2,5,52,65,0 days 00:00:00.115646
sindresorhus/pageres,2, v,24,2,3,23,47,0 days 00:00:00.037912
pockethub/PocketHub,2, v,11,5,3,9,20,0 days 00:00:00.157923
meliorence/react-native-snap-carousel,2,V v,22,10,2,29,51,0 days 00:00:00.037288
Sylius/Sylius,1,v,30,4,17,151,181,0 days 00:00:02.078962
iterative/dvc,1,,92,63,3,258,350,0 days 00:00:00.780075
TarsCloud/Tars,2, v,15,2,4,32,47,0 days 00:00:00.064391
senchalabs/connect,1,,52,17,10,174,226,0 days 00:00:00.361368
BookStackApp/BookStack,3, v. v,36,10,9,113,149,0 days 00:00:00.268660
jhen0409/react-native-debugger,1,v,12,3,4,74,86,0 days 00:00:00.066019
FormidableLabs/victory,1,v,65,24,5,156,221,0 days 00:00:00.635884
apidoc/apidoc,1,,27,5,6,19,46,0 days 00:00:00.056201
lvgl/lvgl,2, v,26,10,7,20,46,0 days 00:00:00.572224
Automattic/kue,2, v,10,2,6,47,57,0 days 00:00:00.066456
argoproj/argo-cd,1,v,25,9,4,115,140,0 days 00:00:00.326185
botpress/botpress,2, v,88,53,4,234,322,0 days 00:00:01.114721
vnotex/vnote,2, v,47,28,3,13,60,0 days 00:00:00.203952
upx/upx,1,v,31,4,18,0,31,0 days 00:00:00.175514
r-spacex/SpaceX-API,2, v,15,9,3,8,23,0 days 00:00:00.101405
pinojs/pino,2, v,90,20,2,150,240,0 days 00:00:00.203186
dingo/api,2, v,16,5,5,41,57,0 days 00:00:00.093889
squizlabs/PHP_CodeSniffer,1,,19,5,12,51,70,0 days 00:00:00.400796
FormidableLabs/spectacle,2, v,35,3,8,77,112,0 days 00:00:00.121069
uncss/uncss,1,,9,2,5,9,18,0 days 00:00:00.040620
reactjs/react-transition-group,1,v,19,5,6,19,38,0 days 00:00:00.040074
Atmosphere-NX/Atmosphere,1,,18,7,6,48,66,0 days 00:00:00.303043
exceljs/exceljs,2, v,41,22,4,180,221,0 days 00:00:00.323065
deployphp/deployer,1,v,20,5,8,47,67,0 days 00:00:00.212175
callstack/react-native-paper,2, v,53,23,4,61,114,0 days 00:00:00.122922
docmirror/dev-sidecar,2, v,7,3,2,16,23,0 days 00:00:00.041218
mongodb/node-mongodb-native,3,v. v V,25,4,18,387,412,0 days 00:00:00.875221
coredns/coredns,1,v,20,6,7,42,62,0 days 00:00:00.292653
catboost/catboost,3, v. v,25,7,3,57,82,0 days 00:00:01.672788
bulletphysics/bullet3,1,,18,3,9,6,24,0 days 00:00:00.512963
boardgameio/boardgame.io,1,v,39,20,2,111,150,0 days 00:00:00.142336
crimx/ext-saladict,3, V v,59,34,5,139,198,0 days 00:00:00.343111
javascript-obfuscator/javascript-obfuscator,1,,63,27,2,122,185,0 days 00:00:00.180902
coleifer/peewee,1,,35,8,13,139,174,0 days 00:00:00.259307
direnv/direnv,2, v,33,2,15,42,75,0 days 00:00:00.151210
ydataai/pandas-profiling,2,v. v,20,7,7,14,34,0 days 00:00:00.071931
react-dropzone/react-dropzone,2, v,55,5,3,120,175,0 days 00:00:00.088126
Gallopsled/pwntools,1,,26,5,8,35,61,0 days 00:00:00.256155
paulmillr/chokidar,1,,28,8,10,70,98,0 days 00:00:00.119229
ginuerzh/gost,2, v,21,4,6,11,32,0 days 00:00:00.038499
pyinstaller/pyinstaller,2, v,28,5,19,6,34,0 days 00:00:00.496679
helmetjs/helmet,1,v,51,2,6,34,85,0 days 00:00:00.078382
callstack/linaria,1,v,14,2,2,24,38,0 days 00:00:00.051949
inversify/InversifyJS,2, v,25,4,6,22,47,0 days 00:00:00.092605
symfony/console,1,v,26,4,21,466,492,0 days 00:00:00.509841
thumbor/thumbor,1,,61,12,9,178,239,0 days 00:00:00.206339
sinonjs/sinon,2, v,57,18,16,121,178,0 days 00:00:00.374241
dromara/Sa-Token,1,v,23,16,2,1,24,0 days 00:00:00.134812
fkhadra/react-toastify,1,v,33,10,7,60,93,0 days 00:00:00.094692
sonic-pi-net/sonic-pi,1,v,16,5,7,9,25,0 days 00:00:00.605818
aws/chalice,1,,38,15,7,43,81,0 days 00:00:00.232344
webtorrent/webtorrent-desktop,1,v,25,17,5,13,38,0 days 00:00:00.152685
react-page/react-page,2, v,58,9,4,214,272,0 days 00:00:00.211727
antvis/G6,1,,9,2,2,64,73,0 days 00:00:00.361660
facebookresearch/ParlAI,2, v,10,5,2,10,20,0 days 00:00:00.220058
encode/httpx,1,,23,7,3,47,70,0 days 00:00:00.101961
tweepy/tweepy,2, v,40,16,15,4,44,0 days 00:00:00.201076
PrefectHQ/prefect,1,,17,5,6,102,119,0 days 00:00:00.910215
remarkjs/react-markdown,2, v,22,2,6,46,68,0 days 00:00:00.047808
golang-migrate/migrate,1,v,24,6,7,25,49,0 days 00:00:00.078471
GoogleChromeLabs/comlink,1,v,15,6,4,23,38,0 days 00:00:00.076647
gregberge/svgr,1,v,36,6,4,19,55,0 days 00:00:00.062507
zerotier/ZeroTierOne,1,,15,3,5,68,83,0 days 00:00:00.314290
ultralytics/yolov3,1,v,12,6,3,0,12,0 days 00:00:00.124821
cert-manager/cert-manager,1,v,25,3,3,49,74,0 days 00:00:00.601065
piskelapp/piskel,1,v,14,2,9,16,30,0 days 00:00:00.102352
mapeditor/tiled,1,v,27,3,19,56,83,0 days 00:00:00.364364
tweenjs/tween.js,3, r v,30,4,10,23,53,0 days 00:00:00.057448
caprover/caprover,2,V v,12,6,5,17,29,0 days 00:00:00.187492
pyodide/pyodide,2, v,20,9,6,25,45,0 days 00:00:00.213385
aws/serverless-application-model,2, v,42,10,5,9,51,0 days 00:00:00.109437
Automattic/node-canvas,2, v,30,6,10,88,118,0 days 00:00:00.128414
cefsharp/CefSharp,1,v,27,4,10,70,97,0 days 00:00:00.499513
google/go-github,1,v,59,10,6,35,94,0 days 00:00:00.117049
spotDL/spotify-downloader,1,v,14,2,4,38,52,0 days 00:00:00.172292
jprichardson/node-fs-extra,2, v,43,7,7,42,85,0 days 00:00:00.081600
shipshapecode/tether,1,v,13,2,3,60,73,0 days 00:00:00.077129
Shopify/sarama,1,v,34,10,15,18,52,0 days 00:00:00.171673
wkentaro/labelme,1,v,50,15,7,125,175,0 days 00:00:00.140926
MarshallOfSound/Google-Play-Music-Desktop-Player-UNOFFICIAL-,2, v,26,15,3,32,58,0 days 00:00:00.094811
restsharp/RestSharp,2, v,30,10,7,29,59,0 days 00:00:00.119652
nodejs/node-gyp,2, v,37,2,15,98,135,0 days 00:00:00.105490
doctrine/dbal,2, v,18,2,14,79,97,0 days 00:00:00.773866
jwtk/jjwt,1,,11,3,6,15,26,0 days 00:00:00.042963
cesanta/mongoose,1,,43,11,21,1,44,0 days 00:00:00.292421
pytest-dev/pytest,1,,42,10,17,122,164,0 days 00:00:01.015793
rq/rq,2, v,24,2,15,44,68,0 days 00:00:00.107234
giampaolo/psutil,1,release-,32,8,17,52,84,0 days 00:00:00.423931
OnsenUI/OnsenUI,1,,20,6,8,68,88,0 days 00:00:00.607346
projectdiscovery/nuclei,2,v. v,10,2,6,43,53,0 days 00:00:00.177128
panjf2000/ants,1,v,9,2,2,15,24,0 days 00:00:00.037802
libretro/RetroArch,2, v,15,3,7,77,92,0 days 00:00:03.545971
Nozbe/WatermelonDB,1,v,19,5,6,17,36,0 days 00:00:00.213652
cytoscape/cytoscape.js,1,v,29,10,12,198,227,0 days 00:00:00.473003
sebastianbergmann/php-code-coverage,1,,23,2,13,138,161,0 days 00:00:00.201174
protobufjs/protobuf.js,2, v,23,7,5,55,78,0 days 00:00:00.087421
dat-ecosystem-archive/dat,1,v,43,9,5,64,107,0 days 00:00:00.138688
agenda/agenda,2, v,20,2,8,65,85,0 days 00:00:00.068869
benoitc/gunicorn,1,,31,12,14,51,82,0 days 00:00:00.172923
coil-kt/coil,1,,15,5,6,12,27,0 days 00:00:00.070337
pre-commit/pre-commit,1,v,60,25,8,111,171,0 days 00:00:00.180585
MahApps/MahApps.Metro,1,,21,5,11,33,54,0 days 00:00:00.381975
borgbackup/borg,1,,22,12,5,36,58,0 days 00:00:00.584145
jopohl/urh,1,v,17,6,6,74,91,0 days 00:00:00.256909
libgit2/libgit2,1,v,29,7,16,48,77,0 days 00:00:01.063885
hediet/vscode-drawio,1,v,10,4,2,13,23,0 days 00:00:00.029585
tidwall/tile38,1,,27,6,7,59,86,0 days 00:00:00.089445
vector-im/element-web,1,v,27,9,9,172,199,0 days 00:00:00.799408
NG-ZORRO/ng-zorro-antd,1,,41,28,5,65,106,0 days 00:00:00.156122
OpenFeign/feign,3, release- v,72,12,8,54,126,0 days 00:00:00.112487
resilience4j/resilience4j,3, v. v,22,4,8,15,37,0 days 00:00:00.084229
happyfish100/fastdfs,1,V,16,5,4,0,16,0 days 00:00:00.031083
devhubapp/devhub,2, v,55,25,3,61,116,0 days 00:00:00.368492
electron/electron-packager,1,v,53,9,6,42,95,0 days 00:00:00.089593
HabitRPG/habitica,2, v,351,105,2,612,963,0 days 00:00:02.552287
symfony/event-dispatcher,1,v,26,4,17,436,462,0 days 00:00:00.305584
Koenkk/zigbee2mqtt,1,,28,16,5,33,61,0 days 00:00:00.269568
google/or-tools,1,v,32,7,8,3,35,0 days 00:00:00.671693
VulcanJS/Vulcan,2, v,22,10,6,45,67,0 days 00:00:00.401818
symfony/http-foundation,1,v,26,4,20,464,490,0 days 00:00:00.632327
Stuk/jszip,1,v,19,5,7,14,33,0 days 00:00:00.092667
dotnet/machinelearning,1,v,18,12,4,5,23,0 days 00:00:00.162731
sahat/satellizer,1,,14,7,4,41,55,0 days 00:00:00.110951
airbnb/epoxy,1,,41,4,4,22,63,0 days 00:00:00.040723
ng-bootstrap/ng-bootstrap,1,,27,12,6,49,76,0 days 00:00:00.127585
symfony/finder,1,v,26,4,16,440,466,0 days 00:00:00.457280
doitsujin/dxvk,1,v,40,30,5,32,72,0 days 00:00:00.285435
ag-grid/ag-grid,2, v,87,57,5,103,190,0 days 00:00:01.711037
Jguer/yay,1,v,49,19,9,26,75,0 days 00:00:00.494983
grommet/grommet,2, v,41,18,7,76,117,0 days 00:00:00.616225
pypa/pip,1,,36,2,27,73,109,0 days 00:00:00.973710
mjmlio/mjml,3, V v,25,8,10,50,75,0 days 00:00:00.178804
zalmoxisus/redux-devtools-extension,2, v,27,15,2,43,70,0 days 00:00:00.069349
mediaelement/mediaelement,1,,32,8,11,117,149,0 days 00:00:00.292303
grpc-ecosystem/grpc-gateway,1,v,28,7,7,43,71,0 days 00:00:00.129124
automerge/automerge,1,v,13,3,6,20,33,0 days 00:00:00.057717
google/cadvisor,2, v,45,19,15,71,116,0 days 00:00:00.340511
firefly-iii/firefly-iii,1,,41,18,8,201,242,0 days 00:00:01.165832
Tencent/APIJSON,1,,37,18,7,51,88,0 days 00:00:00.180674
JustArchiNET/ArchiSteamFarm,1,,167,83,9,431,598,0 days 00:00:01.040609
abpframework/abp,2, v,43,31,3,60,103,0 days 00:00:01.580592
fabric/fabric,1,,26,4,18,97,123,0 days 00:00:00.454336
powerline/powerline,1,,13,3,7,10,23,0 days 00:00:00.273746
authelia/authelia,1,v,55,33,5,114,169,0 days 00:00:00.238472
verdaccio/verdaccio,1,v,64,21,8,148,212,0 days 00:00:00.510246
RaRe-Technologies/gensim,1,,23,6,11,36,59,0 days 00:00:00.290872
flipped-aurora/gin-vue-admin,3,V v v.,7,2,2,21,28,0 days 00:00:00.123950
txthinking/brook,1,v,43,9,4,0,43,0 days 00:00:00.041007
mdx-js/mdx,2, v,26,8,2,140,166,0 days 00:00:00.140085
getgrav/grav,1,,13,3,8,170,183,0 days 00:00:00.559132
timescale/timescaledb,1,,28,7,8,33,61,0 days 00:00:00.360299
qutebrowser/qutebrowser,1,v,32,4,16,49,81,0 days 00:00:01.524945
bcicen/ctop,2, v,5,2,2,11,16,0 days 00:00:00.033565
termux/termux-app,1,v,89,20,7,0,89,0 days 00:00:00.112764
gionkunz/chartist-js,1,v,11,5,4,47,58,0 days 00:00:00.057622
python/mypy,1,v,59,22,8,7,66,0 days 00:00:00.577223
WerWolv/ImHex,1,v,19,14,2,12,31,0 days 00:00:00.214608
http-party/node-http-proxy,2, v,27,4,8,70,97,0 days 00:00:00.091741
DIYgod/DPlayer,2, v,21,2,4,21,42,0 days 00:00:00.070629
keybase/client,2, v,29,21,4,65,94,0 days 00:00:02.428403
arduino/Arduino,1,,26,3,12,46,72,0 days 00:00:00.429834
redux-form/redux-form,1,v,46,11,7,141,187,0 days 00:00:00.167957
revel/revel,1,v,18,4,10,7,25,0 days 00:00:00.108058
xtermjs/xterm.js,1,,76,29,6,35,111,0 days 00:00:00.637263
wechaty/wechaty,1,v,15,4,7,8,23,0 days 00:00:00.389516
Semantic-Org/Semantic-UI-React,1,v,93,32,5,211,304,0 days 00:00:00.311288
charmbracelet/bubbletea,1,v,20,4,3,27,47,0 days 00:00:00.048228
mockito/mockito,1,v,58,16,6,409,467,0 days 00:00:00.718057
showdownjs/showdown,2, v,14,3,5,42,56,0 days 00:00:00.064494
moment/luxon,1,,37,2,4,69,106,0 days 00:00:00.090765
OptimalBits/bull,2, v,49,7,10,84,133,0 days 00:00:00.150365
thephpleague/flysystem,1,,13,2,4,175,188,0 days 00:00:00.188956
uuidjs/uuid,1,v,16,4,6,21,37,0 days 00:00:00.036933
pyecharts/pyecharts,1,v,14,3,5,29,43,0 days 00:00:00.308107
liriliri/eruda,1,v,15,2,5,40,55,0 days 00:00:00.064871
josdejong/mathjs,1,v,109,64,2,118,227,0 days 00:00:00.410209
MaterialDesignInXAML/MaterialDesignInXamlToolkit,2, v,21,5,12,12,33,0 days 00:00:00.323428
tensorflow/tensor2tensor,3, v. v,15,5,4,61,76,0 days 00:00:00.298237
Budibase/budibase,1,v,10,5,2,479,489,0 days 00:00:01.636808
11ty/eleventy,1,v,13,2,6,41,54,0 days 00:00:00.101373
gaearon/react-hot-loader,2, v,25,7,4,107,132,0 days 00:00:00.141155
aquasecurity/trivy,1,v,28,13,2,59,87,0 days 00:00:00.102179
visionmedia/supertest,2, v,29,2,9,29,58,0 days 00:00:00.040180
rt2zz/redux-persist,1,v,36,4,4,76,112,0 days 00:00:00.069886
scylladb/scylla,1,scylla-,33,11,10,130,163,0 days 00:00:02.460659
oliver-moran/jimp,2, v,15,2,2,71,86,0 days 00:00:00.078322
systemjs/systemjs,2, v,40,8,3,187,227,0 days 00:00:00.210059
foambubble/foam,1,v,17,8,2,44,61,0 days 00:00:00.060185
casbin/casbin,1,v,68,10,5,118,186,0 days 00:00:00.111197
carloscuesta/gitmoji,1,v,13,4,2,5,18,0 days 00:00:00.044661
lra/mackup,1,,8,4,3,53,61,0 days 00:00:00.160472
webpack-contrib/webpack-bundle-analyzer,1,v,32,6,6,34,66,0 days 00:00:00.047081
aurelia/framework,1,,23,2,5,32,55,0 days 00:00:00.055700
keycloak/keycloak,1,,16,2,7,21,37,0 days 00:00:00.823005
ramsey/uuid,1,,26,4,12,37,63,0 days 00:00:00.077641
roots/sage,2, v,27,7,10,35,62,0 days 00:00:00.150232
ben-manes/caffeine,2, v,16,3,6,45,61,0 days 00:00:00.087435
Miserlou/Zappa,2, v,50,30,3,71,121,0 days 00:00:00.229609
mikepenz/MaterialDrawer,1,v,35,9,7,166,201,0 days 00:00:00.194525
karma-runner/karma,2, v,35,8,10,198,233,0 days 00:00:00.314521
LuckSiege/PictureSelector,2,v. v,12,5,5,91,103,0 days 00:00:00.181768
microsoft/nni,1,v,27,9,2,16,43,0 days 00:00:00.198379
NodeBB/NodeBB,1,v,30,2,17,93,123,0 days 00:00:01.373410
AdguardTeam/AdGuardHome,1,v,19,6,4,31,50,0 days 00:00:00.298156
apexcharts/apexcharts.js,2, v,32,9,3,54,86,0 days 00:00:00.136100
mifi/lossless-cut,1,v,70,29,8,67,137,0 days 00:00:00.132232
spicetify/spicetify-cli,2,v. v,23,9,4,52,75,0 days 00:00:00.057256
sindresorhus/got,1,v,70,18,8,71,141,0 days 00:00:00.110911
rjsf-team/react-jsonschema-form,1,v,71,15,6,52,123,0 days 00:00:00.219284
rizinorg/cutter,1,v,14,6,5,16,30,0 days 00:00:00.122083
hotwired/stimulus,1,v,12,5,4,14,26,0 days 00:00:00.064614
bettercap/bettercap,1,v,33,21,5,10,43,0 days 00:00:00.121296
d2-projects/d2-admin,2, v,25,6,4,62,87,0 days 00:00:00.277584
thingsboard/thingsboard,1,v,15,2,7,33,48,0 days 00:00:00.603735
cloudwu/skynet,1,v,15,7,6,18,33,0 days 00:00:00.103661
OpenAPITools/openapi-generator,2, v,16,2,11,38,54,0 days 00:00:01.127671
conventional-changelog/commitlint,1,v,47,14,5,89,136,0 days 00:00:00.154057
pagehelper/Mybatis-PageHelper,1,v,18,5,6,42,60,0 days 00:00:00.055634
nock/nock,2, v,125,15,5,181,306,0 days 00:00:00.531484
wenzhixin/bootstrap-table,1,,18,3,9,39,57,0 days 00:00:00.248408
graphile/postgraphile,1,v,35,3,7,60,95,0 days 00:00:00.279596
slimphp/Slim,1,,40,6,21,55,95,0 days 00:00:00.307961
PHPOffice/PhpSpreadsheet,1,,24,6,7,10,34,0 days 00:00:00.203322
mail-in-a-box/mailinabox,1,v,45,13,11,0,45,0 days 00:00:00.111477
micro/micro,2, v,62,36,2,37,99,0 days 00:00:00.325882
video-dev/hls.js,1,v,16,2,9,185,201,0 days 00:00:00.695019
ajv-validator/ajv,2, v,71,26,4,89,160,0 days 00:00:00.268965
argoproj/argo-workflows,2, v,23,7,9,102,125,0 days 00:00:00.420043
allenai/allennlp,2, v,24,4,5,23,47,0 days 00:00:00.160743
SFTtech/openage,1,v,5,2,2,4,9,0 days 00:00:00.259709
davisking/dlib,1,v,55,12,13,0,55,0 days 00:00:00.575947
FriendsOfPHP/PHP-CS-Fixer,1,v,48,26,15,148,196,0 days 00:00:00.547872
keeweb/keeweb,1,v,25,10,9,103,128,0 days 00:00:00.225081
stylus/stylus,1,,53,28,10,115,168,0 days 00:00:00.243583
jonas/tig,1,tig-,27,6,19,22,49,0 days 00:00:00.185906
ent/ent,1,v,10,2,4,21,31,0 days 00:00:00.098979
baidu/amis,1,,9,5,2,37,46,0 days 00:00:00.398934
dgraph-io/badger,1,v,14,3,6,20,34,0 days 00:00:00.212949
Kotlin/kotlinx.coroutines,1,,24,11,6,38,62,0 days 00:00:00.152004
GoogleChrome/workbox,1,v,24,9,7,38,62,0 days 00:00:00.107142
javve/list.js,2, v,11,3,5,10,21,0 days 00:00:00.049888
summernote/summernote,1,v,8,2,2,52,60,0 days 00:00:00.177282
nats-io/nats-server,1,v,17,2,12,49,66,0 days 00:00:00.602991
browserslist/browserslist,1,,49,10,5,119,168,0 days 00:00:00.116774
wbkd/react-flow,2, v,56,27,2,118,174,0 days 00:00:00.293967
fengyuanchen/cropperjs,1,v,14,6,3,40,54,0 days 00:00:00.063756
lingochamp/FileDownloader,1,v,11,2,2,56,67,0 days 00:00:00.053394
Rapptz/discord.py,1,v,24,11,6,41,65,0 days 00:00:00.168745
tymondesigns/jwt-auth,1,,6,2,2,29,35,0 days 00:00:00.115702
polybar/polybar,1,,20,5,7,84,104,0 days 00:00:00.127088
go-playground/validator,1,v,94,12,6,59,153,0 days 00:00:00.101669
networkx/networkx,1,networkx-,37,7,25,10,47,0 days 00:00:00.576393
spatie/laravel-permission,1,,87,18,4,71,158,0 days 00:00:00.118454
ionic-team/stencil,1,v,53,33,2,189,242,0 days 00:00:00.514718
GoogleContainerTools/kaniko,1,v,33,14,4,4,37,0 days 00:00:00.123518
rqlite/rqlite,1,v,56,35,4,39,95,0 days 00:00:00.195948
swaywm/sway,1,,22,5,8,7,29,0 days 00:00:00.533474
akiran/react-slick,2, v,13,3,5,27,40,0 days 00:00:00.083238
restify/node-restify,2, v,44,11,7,96,140,0 days 00:00:00.221496
thanos-io/thanos,1,v,26,7,2,17,43,0 days 00:00:00.192772
VSCodeVim/Vim,2, v,38,18,6,187,225,0 days 00:00:00.629787
avwo/whistle,1,v,31,11,10,342,373,0 days 00:00:00.663128
dbcli/mycli,1,v,26,8,9,20,46,0 days 00:00:00.206031
luin/ioredis,2, v,54,9,4,132,186,0 days 00:00:00.160979
dbcli/pgcli,2, v,39,12,9,47,86,0 days 00:00:00.392466
TypeStrong/ts-node,1,v,52,3,7,83,135,0 days 00:00:00.085067
styleguidist/react-styleguidist,2, v,47,16,3,215,262,0 days 00:00:00.194053
okonet/lint-staged,2, v,44,3,3,145,189,0 days 00:00:00.141927
redis/redis-py,2, v,15,2,9,49,64,0 days 00:00:00.159785
netbox-community/netbox,2, v,24,6,13,173,197,0 days 00:00:00.575274
reactstrap/reactstrap,2, v,61,12,6,54,115,0 days 00:00:00.093207
shipshapecode/shepherd,1,v,46,8,7,73,119,0 days 00:00:00.142229
aws/aws-cli,1,,46,18,9,1642,1688,0 days 00:00:03.994165
PrismJS/prism,2, v,29,8,11,11,40,0 days 00:00:00.222166
ansible/awx,1,,36,18,2,20,56,0 days 00:00:02.008719
pagekit/vue-resource,1,,12,2,3,41,53,0 days 00:00:00.036890
debug-js/debug,1,,22,2,6,47,69,0 days 00:00:00.046484
jantimon/html-webpack-plugin,2, v,47,6,6,36,83,0 days 00:00:00.065202
aspnetboilerplate/aspnetboilerplate,3, v. v,91,42,5,125,216,0 days 00:00:00.466256
mailhog/MailHog,2, v,10,3,2,16,26,0 days 00:00:00.024126
plouc/nivo,1,v,67,26,7,45,112,0 days 00:00:00.145573
vercel/micro,2, v,21,9,3,34,55,0 days 00:00:00.045854
react-static/react-static,1,v,28,10,5,162,190,0 days 00:00:00.157528
samuelcolvin/pydantic,2,V v,42,18,6,37,79,0 days 00:00:00.108440
SpacehuhnTech/esp8266_deauther,3, v. v,10,4,3,3,13,0 days 00:00:00.138550
spencermountain/compromise,2, v,70,23,8,148,218,0 days 00:00:00.309651
milvus-io/milvus,1,v,9,3,3,15,24,0 days 00:00:01.093899
ant-design/ant-design-mobile,2, v,28,16,4,107,135,0 days 00:00:00.480258
typesense/typesense,2, v,16,4,5,8,24,0 days 00:00:00.076334
tinygo-org/tinygo,1,v,23,9,3,4,27,0 days 00:00:00.161644
nhn/tui.calendar,1,v,21,6,2,42,63,0 days 00:00:00.111571
zricethezav/gitleaks,1,v,60,8,4,62,122,0 days 00:00:00.082371
bitwarden/server,2, v,49,29,4,58,107,0 days 00:00:00.198190
h2o/h2o,1,v,12,3,2,32,44,0 days 00:00:00.362109
coryhouse/react-slingshot,2, v,8,2,2,7,15,0 days 00:00:00.038552
git-lfs/git-lfs,2, v,29,3,18,60,89,0 days 00:00:00.803766
FredrikNoren/ungit,2, v,16,6,6,126,142,0 days 00:00:00.380307
w7corp/easywechat,1,,47,4,4,241,288,0 days 00:00:00.271967
kubernetes-sigs/kind,2, v,14,2,6,10,24,0 days 00:00:00.310354
jesseduffield/lazydocker,1,v,18,7,4,27,45,0 days 00:00:00.048090
immerjs/immer,2, v,35,14,2,94,129,0 days 00:00:00.110051
tj/commander.js,2, v,50,9,12,38,88,0 days 00:00:00.114202
doczjs/docz,1,v,19,11,5,66,85,0 days 00:00:00.125816
labstack/echo,2, v,20,2,9,75,95,0 days 00:00:00.106360
vuejs/devtools,1,v,10,3,4,36,46,0 days 00:00:00.103638
squidfunk/mkdocs-material,1,,52,21,4,192,244,0 days 00:00:00.453632
halo-dev/halo,1,v,10,2,5,42,52,0 days 00:00:00.116423
vega/vega,1,v,45,19,13,73,118,0 days 00:00:00.379251
alibaba/nacos,2, v,16,9,6,15,31,0 days 00:00:00.314938
lovell/sharp,1,v,30,3,16,88,118,0 days 00:00:00.092683
dask/dask,1,,97,53,9,141,238,0 days 00:00:00.736637
react-native-elements/react-native-elements,2, v,30,13,5,52,82,0 days 00:00:00.209161
reduxjs/react-redux,1,v,26,10,4,59,85,0 days 00:00:00.080809
seata/seata,3, V v,15,2,3,18,33,0 days 00:00:00.177158
frida/frida,1,,54,14,6,579,633,0 days 00:00:00.717190
files-community/Files,1,v,23,18,4,38,61,0 days 00:00:00.299933
redux-saga/redux-saga,2, v,18,8,5,40,58,0 days 00:00:00.243534
ramda/ramda,2, v,28,12,9,26,54,0 days 00:00:00.165012
visgl/deck.gl,2, v,32,6,11,250,282,0 days 00:00:00.385460
frappe/erpnext,2, v,153,125,7,763,916,0 days 00:00:03.658942
sampotts/plyr,1,v,16,3,7,195,211,0 days 00:00:00.261934
feathericons/feather,1,v,39,6,2,12,51,0 days 00:00:00.037130
guzzle/guzzle,2, v,37,14,13,96,133,0 days 00:00:00.227567
httpie/httpie,1,,19,2,12,28,47,0 days 00:00:00.085904
swagger-api/swagger-ui,3, v/ v,69,34,10,189,258,0 days 00:00:00.340142
openfaas/faas,2, v,18,8,6,110,128,0 days 00:00:00.109992
github/hub,1,v,29,11,8,59,88,0 days 00:00:00.305970
angular/components,1,,31,13,7,128,159,0 days 00:00:00.846190
facebook/draft-js,2, v,11,6,3,16,27,0 days 00:00:00.278454
usablica/intro.js,2, v,29,4,13,12,41,0 days 00:00:00.078537
paularmstrong/normalizr,2, v,16,3,4,18,34,0 days 00:00:00.035845
fabricjs/fabric.js,2, v,34,2,11,69,103,0 days 00:00:00.393060
vercel/pkg,1,,15,5,4,42,57,0 days 00:00:00.065971
sirupsen/logrus,2, v,20,6,7,35,55,0 days 00:00:00.078312
docsifyjs/docsify,1,v,44,8,6,147,191,0 days 00:00:00.140215
localForage/localForage,1,,19,4,4,43,62,0 days 00:00:00.069451
michalsnik/aos,2, v,11,2,3,24,35,0 days 00:00:00.023289
mochajs/mocha,2, v,65,26,14,110,175,0 days 00:00:00.301441
helm/helm,2, v,32,5,12,68,100,0 days 00:00:00.662048
react-bootstrap/react-bootstrap,2, v,44,17,10,108,152,0 days 00:00:00.284636
uglide/RedisDesktopManager,1,,33,14,4,38,71,0 days 00:00:00.104827
vuejs/vuepress,1,v,24,10,4,50,74,0 days 00:00:00.205010
avajs/ava,1,v,54,21,4,23,77,0 days 00:00:00.112864
python-poetry/poetry,1,,14,10,3,63,77,0 days 00:00:00.129869
postcss/autoprefixer,1,,53,16,9,133,186,0 days 00:00:00.280298
petkaantonov/bluebird,1,v,24,6,7,115,139,0 days 00:00:00.163979
electron-react-boilerplate/electron-react-boilerplate,1,v,32,5,7,31,63,0 days 00:00:00.081310
Seldaek/monolog,1,,36,7,18,26,62,0 days 00:00:00.149288
necolas/react-native-web,1,,17,6,5,242,259,0 days 00:00:00.193623
validatorjs/validator.js,2, v,107,32,8,43,150,0 days 00:00:00.149108
eslint/eslint,1,v,164,145,3,103,267,0 days 00:00:00.642158
schollz/croc,1,v,31,10,5,106,137,0 days 00:00:00.118418
rollup/rollup,1,v,169,49,3,411,580,0 days 00:00:00.740667
freebsd/freebsd-src,1,release/,62,3,58,16,78,0 days 00:00:20.821943
parse-community/parse-server,1,,34,11,11,111,145,0 days 00:00:00.255692
felixrieseberg/windows95,1,v,11,2,5,3,14,0 days 00:00:00.018468
benweet/stackedit,1,v,23,7,3,104,127,0 days 00:00:00.110374
alibaba/Sentinel,2, v,8,2,3,16,24,0 days 00:00:00.053714
ShareX/ShareX,1,v,50,24,11,22,72,0 days 00:00:00.475692
segmentio/nightmare,1,,21,4,3,67,88,0 days 00:00:00.075938
afollestad/material-dialogs,3, v. v,20,6,3,98,118,0 days 00:00:00.117505
apache/skywalking,1,v,20,4,6,11,31,0 days 00:00:00.353279
winstonjs/winston,2, v,24,4,10,62,86,0 days 00:00:00.095922
signalapp/Signal-Android,3, v. v,180,145,3,860,1040,0 days 00:00:01.737698
vuejs/vue-router,1,v,19,8,5,59,78,0 days 00:00:00.239048
TeamNewPipe/NewPipe,2, v,17,3,10,100,117,0 days 00:00:00.664962
youzan/vant,1,v,33,13,6,377,410,0 days 00:00:00.753629
zhongyang219/TrafficMonitor,1,V,18,8,6,4,22,0 days 00:00:00.046548
osquery/osquery,2, v,39,11,12,80,119,0 days 00:00:00.429246
marmelab/react-admin,1,v,46,32,4,168,214,0 days 00:00:00.912284
reduxjs/reselect,1,v,11,5,4,14,25,0 days 00:00:00.042095
python-telegram-bot/python-telegram-bot,3, V v,49,19,6,39,88,0 days 00:00:00.141550
celery/celery,2, v,22,3,17,143,165,0 days 00:00:00.831966
vadimdemedes/ink,1,v,16,3,4,23,39,0 days 00:00:00.036850
sideway/joi,2, v,92,20,6,135,227,0 days 00:00:00.201833
graphql/graphql-js,2, v,34,8,10,88,122,0 days 00:00:00.325864
emberjs/ember.js,1,v,68,19,4,184,252,0 days 00:00:01.875311
vnpy/vnpy,2, v,22,6,7,28,50,0 days 00:00:00.294259
pbatard/rufus,1,v,42,8,15,28,70,0 days 00:00:00.109101
mingrammer/diagrams,1,v,20,9,3,16,36,0 days 00:00:00.035953
Baseflow/PhotoView,2, v,8,2,2,12,20,0 days 00:00:00.031388
jumpserver/jumpserver,2, v,31,23,5,103,134,0 days 00:00:00.507901
recharts/recharts,1,v,26,10,4,93,119,0 days 00:00:00.221666
urfave/cli,1,v,33,14,8,34,67,0 days 00:00:00.306158
PyTorchLightning/pytorch-lightning,1,,16,2,4,98,114,0 days 00:00:00.550333
websockets/ws,2, v,40,5,9,114,154,0 days 00:00:00.134305
iawia002/lux,2, v,15,4,4,59,74,0 days 00:00:00.056074
OpenZeppelin/openzeppelin-contracts,1,v,30,9,5,22,52,0 days 00:00:00.296029
locustio/locust,2, v,27,7,10,56,83,0 days 00:00:01.176858
eggjs/egg,1,,70,26,2,43,113,0 days 00:00:00.082974
lensapp/lens,1,v,19,5,6,56,75,0 days 00:00:00.196164
quii/learn-go-with-tests,2, v,22,3,4,27,49,0 days 00:00:00.074442
valyala/fasthttp,1,v,43,9,3,3,46,0 days 00:00:00.084994
svg/svgo,2, v,20,7,10,66,86,0 days 00:00:00.088645
NickeManarin/ScreenToGif,1,,37,9,7,43,80,0 days 00:00:00.080391
flameshot-org/flameshot,1,v,11,2,5,30,41,0 days 00:00:00.103130
SortableJS/Vue.Draggable,2,v. v,24,3,3,25,49,0 days 00:00:00.039771
telegramdesktop/tdesktop,1,v,34,9,7,542,576,0 days 00:00:01.010061
react-dnd/react-dnd,2, v,45,8,8,100,145,0 days 00:00:00.315986
TanStack/table,1,v,36,4,3,86,122,0 days 00:00:00.123945
mysqljs/mysql,1,v,28,5,9,26,54,0 days 00:00:00.095585
pubkey/rxdb,1,,58,41,2,55,113,0 days 00:00:00.375762
jsdom/jsdom,2, v,98,32,9,144,242,0 days 00:00:00.268085
linlinjava/litemall,1,v,19,10,2,3,22,0 days 00:00:00.066625
ai/nanoid,1,,12,4,2,73,85,0 days 00:00:00.194946
cookiecutter/cookiecutter,1,,14,4,8,15,29,0 days 00:00:00.165450
arendst/Tasmota,1,v,35,2,5,58,93,0 days 00:00:00.924273
eclipse-theia/theia,2, v,43,37,2,33,76,0 days 00:00:00.340828
wekan/wekan,2, v,610,257,2,27,637,0 days 00:00:01.018614
restic/restic,1,v,13,2,7,18,31,0 days 00:00:00.386994
defunkt/jquery-pjax,2, v,12,4,2,15,27,0 days 00:00:00.033618
less/less.js,1,v,26,5,10,42,68,0 days 00:00:00.153689
brettwooldridge/HikariCP,1,HikariCP-,17,2,8,82,99,0 days 00:00:00.153910
freqtrade/freqtrade,1,,44,35,2,14,58,0 days 00:00:01.003704
facebook/fresco,1,v,35,14,13,12,47,0 days 00:00:00.263827
bazelbuild/bazel,1,,47,29,8,56,103,0 days 00:00:01.817365
zloirock/core-js,2, v,41,23,7,156,197,0 days 00:00:00.250756
badges/shields,1,,8,2,4,3,11,0 days 00:00:00.840318
jhipster/generator-jhipster,1,v,110,86,5,114,224,0 days 00:00:02.591624
handlebars-lang/handlebars.js,2, v,14,2,6,56,70,0 days 00:00:00.234405
dropzone/dropzone,1,v,32,5,5,83,115,0 days 00:00:00.078598
monicahq/monica,1,v,47,26,4,39,86,0 days 00:00:00.324697
responsively-org/responsively-app,1,v,18,14,3,10,28,0 days 00:00:00.081092
Tencent/tinker,1,v,7,2,2,46,53,0 days 00:00:00.052503
derailed/k9s,2, v,25,7,2,155,180,0 days 00:00:00.123115
nfl/react-helmet,1,,15,3,4,18,33,0 days 00:00:00.029068
grafana/k6,1,v,36,11,6,36,72,0 days 00:00:00.266208
hubotio/hubot,1,v,26,6,11,68,94,0 days 00:00:00.129258
framework7io/framework7,1,v,43,18,9,172,215,0 days 00:00:00.574115
plotly/dash,1,v,42,25,3,33,75,0 days 00:00:00.402517
handsontable/handsontable,2, v,62,24,14,117,179,0 days 00:00:00.569006
gchq/CyberChef,1,v,119,42,2,273,392,0 days 00:00:00.393400
aFarkas/lazysizes,1,,21,7,5,45,66,0 days 00:00:00.217915
matryer/xbar,2, v,9,5,2,5,14,0 days 00:00:00.044208
ionic-team/ionicons,2, v,21,3,8,51,72,0 days 00:00:00.054675
sanic-org/sanic,2, v,21,2,13,49,70,0 days 00:00:00.261977
trojan-gfw/trojan,1,v,24,8,4,19,43,0 days 00:00:00.035894
visionmedia/superagent,2, v,50,14,9,84,134,0 days 00:00:00.197141
grafana/loki,1,v,17,4,4,8,25,0 days 00:00:00.194097
notepad-plus-plus/notepad-plus-plus,2, v,42,7,11,159,201,0 days 00:00:00.436507
filebrowser/filebrowser,1,v,34,10,4,62,96,0 days 00:00:00.134717
youzan/vant-weapp,1,v,16,6,4,91,107,0 days 00:00:00.268604
mpv-player/mpv,1,v,34,10,8,46,80,0 days 00:00:02.866861
v2fly/v2ray-core,1,v,185,108,4,217,402,0 days 00:00:00.561044
nginx/nginx,1,release-,32,8,6,516,548,0 days 00:00:00.929677
oblador/react-native-vector-icons,1,v,37,3,6,42,79,0 days 00:00:00.051090
jaegertracing/jaeger,1,v,40,24,3,13,53,0 days 00:00:00.104622
knex/knex,2, v,25,2,16,146,171,0 days 00:00:00.208612
buger/goreplay,2, v,18,3,9,23,41,0 days 00:00:00.073897
ustbhuangyi/better-scroll,3, v. v,17,6,4,41,58,0 days 00:00:00.099894
semantic-release/semantic-release,2, v,62,5,2,206,268,0 days 00:00:00.166429
motdotla/dotenv,1,v,33,4,6,26,59,0 days 00:00:00.042087
briannesbitt/Carbon,1,,99,54,5,79,178,0 days 00:00:00.306050
nikic/PHP-Parser,1,v,24,5,9,41,65,0 days 00:00:00.080831
janl/mustache.js,2, v,20,3,8,23,43,0 days 00:00:00.054153
spotify/luigi,2, v,13,4,8,46,59,0 days 00:00:00.335028
wulkano/Kap,1,v,13,2,5,14,27,0 days 00:00:00.059560
auth0/node-jsonwebtoken,1,v,29,3,5,42,71,0 days 00:00:00.041388
jasmine/jasmine,1,v,28,4,17,29,57,0 days 00:00:00.182310
BabylonJS/Babylon.js,2, v,36,10,14,36,72,0 days 00:00:02.579352
huiyadanli/RevokeMsgPatcher,1,,15,2,2,0,15,0 days 00:00:00.019307
KaTeX/KaTeX,1,v,15,2,9,41,56,0 days 00:00:00.128016
facebook/yoga,2, v,19,5,8,23,42,0 days 00:00:00.131402
teambit/bit,1,v,18,6,5,121,139,0 days 00:00:00.320990
infernojs/inferno,2, v,38,18,5,160,198,0 days 00:00:00.437148
DapperLib/Dapper,1,,31,4,6,13,44,0 days 00:00:00.086438
radareorg/radare2,2, release-,42,22,6,43,85,0 days 00:00:01.533525
airbnb/react-sketchapp,2, v,20,9,5,27,47,0 days 00:00:00.057539
qbittorrent/qBittorrent,1,release-,24,4,16,145,169,0 days 00:00:00.959431
catchorg/Catch2,3,V v v.,24,6,6,62,86,0 days 00:00:00.406774
bower/bower,2, v,18,8,4,83,101,0 days 00:00:00.396732
fullcalendar/fullcalendar,1,v,44,14,17,72,116,0 days 00:00:00.330655
flatpickr/flatpickr,2, v,23,3,4,121,144,0 days 00:00:00.173298
ChainSafe/web3.js,2, v,25,15,5,54,79,0 days 00:00:00.178377
pouchdb/pouchdb,2, v,24,7,8,47,71,0 days 00:00:00.338543
icsharpcode/ILSpy,2, v,16,2,11,9,25,0 days 00:00:00.531298
Tencent/ncnn,1,,32,9,3,0,32,0 days 00:00:00.096837
matomo-org/matomo,1,,64,19,20,130,194,0 days 00:00:02.032863
gabime/spdlog,1,v,19,4,10,15,34,0 days 00:00:00.192780
nodemailer/nodemailer,1,v,47,6,7,170,217,0 days 00:00:00.265110
Tencent/vConsole,2, v,24,9,5,34,58,0 days 00:00:00.057628
riot/riot,1,v,44,6,7,155,199,0 days 00:00:00.297222
pqrs-org/Karabiner-Elements,1,v,28,10,5,0,28,0 days 00:00:00.301243
framer/motion,1,v,60,27,3,243,303,0 days 00:00:00.315949
mkdocs/mkdocs,1,,20,6,9,27,47,0 days 00:00:00.104761
node-red/node-red,2, v,26,3,18,99,125,0 days 00:00:00.342046
checkly/headless-recorder,1,v,8,3,2,10,18,0 days 00:00:00.019829
erusev/parsedown,2, v,17,3,4,51,68,0 days 00:00:00.117106
joke2k/faker,1,v,95,3,3,138,233,0 days 00:00:00.236974
krisk/Fuse,2, v,25,7,5,50,75,0 days 00:00:00.041267
hashcat/hashcat,1,v,17,3,9,8,25,0 days 00:00:00.562640
barryvdh/laravel-debugbar,2,V v,24,5,6,99,123,0 days 00:00:00.081249
kovidgoyal/kitty,1,v,25,8,9,58,83,0 days 00:00:01.162570
jarun/nnn,1,v,34,10,4,2,36,0 days 00:00:00.181292
iBotPeaches/Apktool,1,v,12,2,8,23,35,0 days 00:00:00.111593
Anuken/Mindustry,1,v,136,102,4,0,136,0 days 00:00:01.216864
chrislusf/seaweedfs,2, v,218,155,2,0,218,0 days 00:00:00.589252
fmtlib/fmt,2, v,23,2,13,16,39,0 days 00:00:00.398331
google/filament,1,v,23,13,5,70,93,0 days 00:00:00.252137
browserify/browserify,2, v,149,16,2,264,413,0 days 00:00:00.323738
infinitered/ignite,2, v,52,14,2,94,146,0 days 00:00:00.142508
be5invis/Iosevka,1,v,59,28,6,163,222,0 days 00:00:00.266469
uNetworking/uWebSockets,1,v,66,13,4,26,92,0 days 00:00:00.104814
gpujs/gpu.js,1,,21,4,2,55,76,0 days 00:00:00.077773
cocos2d/cocos2d-x,1,cocos2d-x-,20,2,8,17,37,0 days 00:00:02.787504
plotly/plotly.js,1,v,72,54,3,133,205,0 days 00:00:01.429413
koel/koel,1,v,18,6,6,38,56,0 days 00:00:00.117807
docker-slim/docker-slim,1,,38,3,9,17,55,0 days 00:00:00.054562
wting/autojump,1,release-v,31,2,5,22,53,0 days 00:00:00.058418
bootstrap-vue/bootstrap-vue,2, v,47,32,2,66,113,0 days 00:00:00.435163
markdown-it/markdown-it,1,,29,5,5,47,76,0 days 00:00:00.064796
infinitered/reactotron,1,v,46,22,3,40,86,0 days 00:00:00.098807
desktop/desktop,1,release-,22,6,8,136,158,0 days 00:00:01.891229
micropython/micropython,1,v,19,4,10,31,50,0 days 00:00:00.836403
hapijs/hapi,2, v,129,66,6,194,323,0 days 00:00:00.467514
vuejs/vue,2, v,15,4,7,145,160,0 days 00:00:00.425701
d3/d3,1,v,91,26,7,197,288,0 days 00:00:00.340527
axios/axios,2, v,27,8,8,30,57,0 days 00:00:00.080105
dogecoin/dogecoin,2, v,17,3,10,64,81,0 days 00:00:01.169467
facebook/react,2, v,36,7,14,58,94,0 days 00:00:01.239387
hashicorp/packer,2, v,21,5,15,82,103,0 days 00:00:01.321826
containers/podman,1,v,21,5,4,95,116,0 days 00:00:01.536936
vercel/next.js,2, v,33,8,7,122,155,0 days 00:00:00.930942
twbs/bootstrap,1,v,23,3,15,36,59,0 days 00:00:01.491925
RasaHQ/rasa,1,,33,15,7,233,266,0 days 00:00:02.093625
iluwatar/java-design-patterns,1,,19,3,13,0,19,0 days 00:00:00.271932
nvbn/thefuck,1,,79,33,7,4,83,0 days 00:00:00.107265
Genymobile/scrcpy,1,v,25,9,5,2,27,0 days 00:00:00.077828
microsoft/PowerToys,2, v,28,17,3,31,59,0 days 00:00:00.361854
typicode/json-server,2, v,17,2,6,106,123,0 days 00:00:00.052751
facebook/react-native,2, v,67,51,8,144,211,0 days 00:00:01.860627
hakimel/reveal.js,1,,27,2,19,11,38,0 days 00:00:00.167255
laravel/laravel,1,v,40,6,15,134,174,0 days 00:00:00.545423
gin-gonic/gin,1,v,13,3,8,13,26,0 days 00:00:00.087970
tensorflow/models,2,v. v,19,3,9,6,25,0 days 00:00:00.732673
pallets/flask,1,,16,5,10,25,41,0 days 00:00:00.283007
elastic/kibana,1,v,55,10,10,190,245,0 days 00:00:06.905109
reduxjs/redux,1,v,26,11,5,42,68,0 days 00:00:00.283634
gohugoio/hugo,1,v,93,72,10,101,194,0 days 00:00:00.602509
ant-design/ant-design,1,,79,64,4,329,408,0 days 00:00:01.544378
tailwindlabs/tailwindcss,1,v,21,9,8,127,148,0 days 00:00:00.285715
chartjs/Chart.js,2, v,21,7,10,31,52,0 days 00:00:00.243839
fatedier/frp,1,v,42,16,11,30,72,0 days 00:00:00.069449
electron/electron,1,v,113,60,16,595,708,0 days 00:00:02.738685
expressjs/express,1,,61,31,11,185,246,0 days 00:00:00.353370
mrdoob/three.js,1,r,132,97,5,0,132,0 days 00:00:02.752745
adam-p/markdown-here,1,v,15,6,6,34,49,0 days 00:00:00.052692
sveltejs/svelte,1,v,134,87,2,244,378,0 days 00:00:00.519441
shadowsocks/shadowsocks-windows,1,,13,3,7,49,62,0 days 00:00:00.083620
webpack/webpack,1,v,152,121,5,224,376,0 days 00:00:01.228991
socketio/socket.io,1,,30,2,12,118,148,0 days 00:00:00.178799
h5bp/html5-boilerplate,2, v,19,2,12,10,29,0 days 00:00:00.104807
azl397985856/leetcode,2, v,35,15,3,5,40,0 days 00:00:00.084720
microsoft/TypeScript,1,v,12,2,2,120,132,0 days 00:00:02.362318
coder/code-server,2, v,20,9,4,22,42,0 days 00:00:00.350032
protocolbuffers/protobuf,1,v,29,3,13,46,75,0 days 00:00:00.656242
apache/echarts,1,,29,5,14,64,93,0 days 00:00:00.606490
lodash/lodash,1,,48,35,3,59,107,0 days 00:00:00.780390
psf/requests,2, v,43,11,22,101,144,0 days 00:00:00.545769
moment/moment,1,,40,14,12,46,86,0 days 00:00:00.333771
tiangolo/fastapi,2, v,77,36,3,52,129,0 days 00:00:00.145816
junegunn/fzf,1,,27,8,13,76,103,0 days 00:00:00.131763
remix-run/react-router,1,v,39,17,10,76,115,0 days 00:00:00.521727
nestjs/nest,2, v,33,18,5,167,200,0 days 00:00:00.772576
juliangarnier/anime,2, v,8,2,5,6,14,0 days 00:00:00.043346
prettier/prettier,2, v,39,19,8,71,110,0 days 00:00:00.396434
ionic-team/ionic-framework,2, v,43,26,10,140,183,0 days 00:00:00.987928
ColorlibHQ/AdminLTE,2, v,13,2,5,47,60,0 days 00:00:00.250093
prometheus/prometheus,2, v,67,32,5,79,146,0 days 00:00:00.742033
caddyserver/caddy,1,v,14,2,10,49,63,0 days 00:00:00.224953
nuxt/nuxt.js,1,v,30,12,7,112,142,0 days 00:00:00.416182
atom/atom,2, v,271,217,2,104,375,0 days 00:00:02.688673
storybookjs/storybook,1,v,107,16,13,323,430,0 days 00:00:04.207612
strapi/strapi,1,v,16,7,2,79,95,0 days 00:00:01.398455
iamkun/dayjs,1,v,11,3,4,99,110,0 days 00:00:00.101969
grafana/grafana,2, v,46,7,9,181,227,0 days 00:00:02.497174
gogs/gogs,1,v,11,4,6,51,62,0 days 00:00:00.274936
vercel/hyper,2, v,18,9,6,43,61,0 days 00:00:00.177371
Dogfalo/materialize,2, v,17,9,3,20,37,0 days 00:00:00.194985
FiloSottile/mkcert,1,v,6,2,2,8,14,0 days 00:00:00.016826
impress/impress.js,1,,8,4,3,4,12,0 days 00:00:00.026375
facebook/jest,2, v,68,38,10,143,211,0 days 00:00:00.576294
PhilJay/MPAndroidChart,1,v,8,2,4,33,41,0 days 00:00:00.232958
ocornut/imgui,1,v,72,41,5,2,74,0 days 00:00:00.473861
babel/babel,1,v,90,55,8,606,696,0 days 00:00:01.481735
sahat/hackathon-starter,1,,8,2,4,6,14,0 days 00:00:00.117084
hexojs/hexo,1,,38,13,11,101,139,0 days 00:00:00.389928
airbnb/lottie-android,2,v. v,21,5,8,42,63,0 days 00:00:00.089272
v2ray/v2ray-core,1,v,168,95,3,182,350,0 days 00:00:00.883498
TryGhost/Ghost,2, v,170,125,6,318,488,0 days 00:00:01.370135
lerna/lerna,1,v,39,16,6,70,109,0 days 00:00:00.156433
koajs/koa,1,,43,9,9,44,87,0 days 00:00:00.080886
quilljs/quill,1,v,23,11,5,99,122,0 days 00:00:00.252557
videojs/video.js,2, v,70,26,13,220,290,0 days 00:00:00.353105
rclone/rclone,1,v,69,15,10,21,90,0 days 00:00:00.367640
gulpjs/gulp,2, v,6,2,3,13,19,0 days 00:00:00.061658
d2l-ai/d2l-zh,1,v,9,4,3,0,9,0 days 00:00:00.199821
bumptech/glide,1,v,21,6,11,15,36,0 days 00:00:00.143391
ant-design/ant-design-pro,2, v,18,4,6,12,30,0 days 00:00:00.124121
immutable-js/immutable-js,2, v,16,8,3,39,55,0 days 00:00:00.102572
shadowsocks/shadowsocks-android,1,v,24,4,8,156,180,0 days 00:00:00.195537
Blankj/AndroidUtilCode,1,,27,7,7,89,116,0 days 00:00:00.082285
vuetifyjs/vuetify,1,v,23,6,8,284,307,0 days 00:00:00.809491
nativefier/nativefier,2, v,56,19,5,90,146,0 days 00:00:00.100043
XX-net/XX-Net,1,,51,17,3,285,336,0 days 00:00:00.361444
nolimits4web/swiper,1,v,49,7,12,139,188,0 days 00:00:00.330874
carbon-app/carbon,1,,24,5,3,194,218,0 days 00:00:00.161433
microsoft/monaco-editor,2, v,28,6,8,36,64,0 days 00:00:00.162450
nlohmann/json,2, v,15,2,8,36,51,0 days 00:00:00.371581
ansible/ansible,2, v,26,4,13,174,200,0 days 00:00:04.256520
NervJS/taro,1,v,12,2,5,272,284,0 days 00:00:00.697583
date-fns/date-fns,2,v. v,77,25,7,42,119,0 days 00:00:00.139030
react-boilerplate/react-boilerplate,1,v,17,5,5,13,30,0 days 00:00:00.100602
streamich/react-use,1,v,134,35,2,117,251,0 days 00:00:00.348486
nocodb/nocodb,2, v,9,5,2,86,95,0 days 00:00:00.172764
beego/beego,1,v,16,3,10,24,40,0 days 00:00:00.235851
jashkenas/backbone,2, v,10,2,7,22,32,0 days 00:00:00.264472
openai/gym,2, v,15,5,2,34,49,0 days 00:00:00.093382
vuejs/vuex,1,v,21,4,7,24,45,0 days 00:00:00.076875
Dreamacro/clash,1,v,28,9,3,14,42,0 days 00:00:00.049281
photonstorm/phaser,2, v,39,20,10,59,98,0 days 00:00:01.297609
caolan/async,2, v,25,9,10,52,77,0 days 00:00:00.113712
certbot/certbot,1,v,68,54,2,31,99,0 days 00:00:00.661980
atlassian/react-beautiful-dnd,2, v,24,5,4,46,70,0 days 00:00:00.061832
jesseduffield/lazygit,2, v,33,19,5,151,184,0 days 00:00:00.210864
standard/standard,1,v,66,16,8,87,153,0 days 00:00:00.148065
square/leakcanary,1,v,14,4,9,10,24,0 days 00:00:00.291989
apolloconfig/apollo,2, v,19,2,9,16,35,0 days 00:00:00.144988
mitmproxy/mitmproxy,2, v,30,4,17,35,65,0 days 00:00:00.623668
istio/istio,1,,22,4,12,143,165,0 days 00:00:01.353293
typicode/husky,1,v,34,8,9,88,122,0 days 00:00:00.168289
airbnb/lottie-web,2,v. v,24,8,7,144,168,0 days 00:00:00.222979
denysdovhan/wtfjs,1,v,23,3,4,16,39,0 days 00:00:00.036266
ReactiveX/rxjs,1,,19,6,6,45,64,0 days 00:00:00.519121
request/request,1,v,73,27,5,71,144,0 days 00:00:00.166879
aria2/aria2,1,release-,53,19,18,87,140,0 days 00:00:00.296956
hashicorp/terraform,2, v,18,2,12,158,176,0 days 00:00:02.121775
github/fetch,1,v,21,6,7,19,40,0 days 00:00:00.048879
webtorrent/webtorrent,1,v,125,41,7,284,409,0 days 00:00:00.374850
cheeriojs/cheerio,2, v,22,6,6,30,52,0 days 00:00:00.068452
SortableJS/Sortable,1,,17,2,11,18,35,0 days 00:00:00.067944
Modernizr/Modernizr,1,v,20,4,10,23,43,0 days 00:00:00.153894
select2/select2,1,,9,2,5,27,36,0 days 00:00:00.241047
GitbookIO/gitbook,1,,22,13,2,68,90,0 days 00:00:00.135879
harness/drone,1,v,31,10,8,44,75,0 days 00:00:00.257194
docker/compose,2, v,41,12,15,67,108,0 days 00:00:00.576995
YMFE/yapi,2, v,9,2,2,68,77,0 days 00:00:00.280780
remy/nodemon,1,v,20,3,3,101,121,0 days 00:00:00.178270
Binaryify/NeteaseCloudMusicApi,2, v,52,10,5,102,154,0 days 00:00:00.290701
GoogleChrome/lighthouse,2, v,56,39,4,42,98,0 days 00:00:00.450663
akveo/ngx-admin,1,v,19,2,6,8,27,0 days 00:00:00.062955
CodeHubApp/CodeHub,1,,15,3,2,13,28,0 days 00:00:00.039464
ggreer/the_silver_searcher,1,,37,16,8,12,49,0 days 00:00:00.115999
bvaughn/react-virtualized,2, v,71,33,3,129,200,0 days 00:00:00.174816
sequelize/sequelize,2, v,137,36,9,334,471,0 days 00:00:00.986740
pmndrs/react-spring,1,v,22,9,2,150,172,0 days 00:00:00.221754
getsentry/sentry,2, v,102,81,9,294,396,0 days 00:00:02.939045
explosion/spaCy,2, v,28,14,11,72,100,0 days 00:00:00.934868
laravel/framework,2, v,163,143,12,630,793,0 days 00:00:02.282938
Automattic/mongoose,2, v,58,12,18,646,704,0 days 00:00:01.738197
kubernetes/kubernetes,1,v,45,20,19,329,374,0 days 00:00:09.797698
influxdata/influxdb,2, v,26,6,14,133,159,0 days 00:00:02.825126
elastic/elasticsearch,1,v,67,22,15,231,298,0 days 00:00:09.452494
