project,prefixes,prefixes_names,main_releases,rapid_releases,trad_releases,patches,releases,time
1adrianb/face-alignment,1,v,5,1,2,5,10,0 days 00:00:00.211972
expressjs/session,1,v,17,7,6,45,62,0 days 00:00:00.238595
stevenjoezhang/live2d-widget,1,v,8,5,2,9,17,0 days 00:00:00.089291
FaisalUmair/udemy-downloader-gui,1,v,9,4,2,12,21,0 days 00:00:00.371012
robinvdvleuten/vuex-persistedstate,1,v,21,9,7,14,35,0 days 00:00:00.420561
Yelp/dumb-init,1,v,8,4,3,14,22,0 days 00:00:00.087821
telegraf/telegraf,2, v,68,48,5,112,180,0 days 00:00:01.562452
botman/botman,2, v,17,9,6,44,61,0 days 00:00:00.547697
vuejs/apollo,2, v,5,1,2,8,13,0 days 00:00:00.231700
listen1/listen1_desktop,1,v,26,18,5,40,66,0 days 00:00:00.292853
bblanchon/ArduinoJson,1,v,42,20,11,56,98,0 days 00:00:02.897193
projectdiscovery/subfinder,2, v,10,5,4,24,34,0 days 00:00:00.310189
ecrmnn/collect.js,1,,35,24,5,154,189,0 days 00:00:01.089253
substack/tape,1,v,50,23,16,85,135,0 days 00:00:00.612867
go-yaml/yaml,1,v,6,2,3,10,16,0 days 00:00:00.415520
bchavez/Bogus,1,v,7,5,1,97,104,0 days 00:00:00.338817
VirusTotal/yara,1,v,17,1,12,16,33,0 days 00:00:05.177897
encode/apistar,1,,6,2,3,88,94,0 days 00:00:01.236647
eternnoir/pyTelegramBotAPI,1,,15,3,7,37,52,0 days 00:00:00.761689
joeyespo/grip,1,v,15,3,10,9,24,0 days 00:00:00.336464
matthewmueller/x-ray,1,,5,2,2,13,18,0 days 00:00:00.567352
jquense/react-big-calendar,1,v,37,18,12,77,114,0 days 00:00:06.814495
assaf/zombie,2, v,21,12,7,111,132,0 days 00:00:01.054142
lightbend/config,1,v,9,1,4,19,28,0 days 00:00:00.691531
graphql-editor/graphql-editor,2, v,19,15,1,127,146,0 days 00:00:01.782775
maaslalani/slides,1,v,8,4,1,8,16,0 days 00:00:00.182660
mindoc-org/mindoc,1,v,14,10,3,17,31,0 days 00:00:09.647136
Xhofe/alist,1,v,9,5,2,33,42,0 days 00:00:00.252591
shaka-project/shaka-player,1,v,18,2,10,119,137,0 days 00:00:09.807736
docker/docker-py,1,,40,7,11,63,103,0 days 00:00:02.392624
bytedance/IconPark,1,v,4,1,1,32,36,0 days 00:00:11.825823
neutralinojs/neutralinojs,1,v,26,18,4,4,30,0 days 00:00:05.867007
thephpleague/omnipay,2, v,12,4,5,18,30,0 days 00:00:00.577449
datreeio/datree,1,,14,11,2,93,107,0 days 00:00:00.258164
roots/bedrock,1,,21,3,12,82,103,0 days 00:00:00.259787
tijsverkoyen/CssToInlineStyles,1,,9,2,5,20,29,0 days 00:00:00.101676
Dman95/SASM,1,v,15,4,9,11,26,0 days 00:00:03.347795
kickstarter/android-oss,1,v,36,18,5,36,72,0 days 00:00:13.657583
golden-layout/golden-layout,2, v,7,1,3,25,32,0 days 00:00:01.458822
MikeMcl/bignumber.js,2, v,20,3,11,27,47,0 days 00:00:01.695134
OpenNMT/OpenNMT-py,2, v,15,6,8,14,29,0 days 00:00:06.286799
kyleconroy/sqlc,2, v,15,6,3,1,16,0 days 00:00:03.067119
Respect/Validation,1,,11,1,8,108,119,0 days 00:00:01.731007
lebab/lebab,1,v,14,8,2,28,42,0 days 00:00:00.380550
modulz/stitches,1,v,5,2,1,22,27,0 days 00:00:00.804186
vuejs/vetur,2, v,23,12,6,47,70,0 days 00:00:02.060156
nodeca/js-yaml,1,,23,2,18,51,74,0 days 00:00:02.222196
ml5js/ml5-library,3, V v,9,3,3,45,54,0 days 00:00:15.971862
chainer/chainer,1,v,60,47,3,18,78,0 days 00:00:13.246331
documentationjs/documentation,1,v,36,23,7,49,85,0 days 00:00:02.873199
capstone-engine/capstone,1,,5,2,2,9,14,0 days 00:00:22.518483
graphql-java/graphql-java,2, v,40,13,14,2,42,0 days 00:00:06.355343
doctrine/common,2, v,18,1,16,31,49,0 days 00:00:01.108503
tilt-dev/tilt,1,v,30,18,4,172,202,0 days 00:00:12.515047
google/ios-webkit-debug-proxy,2, v,9,2,5,9,18,0 days 00:00:00.196720
antonioru/beautiful-react-hooks,1,,5,2,1,6,11,0 days 00:00:00.275010
kalcaddle/KodExplorer,2, v,31,15,10,3,34,0 days 00:00:28.196760
sockeqwe/mosby,1,,7,3,2,8,15,0 days 00:00:00.962155
gzu-liyujiang/AndroidPicker,1,,11,3,5,45,56,0 days 00:00:01.117999
benbusby/whoogle-search,2, v,7,1,2,15,22,0 days 00:00:00.256273
tensorflow/serving,2, r,25,6,10,27,52,0 days 00:00:03.501508
pagekit/pagekit,1,,4,1,2,31,35,0 days 00:00:01.925363
berty/berty,1,v,390,387,1,579,969,0 days 00:00:16.698701
dinerojs/dinero.js,2, v,13,8,3,17,30,0 days 00:00:01.030443
dotnetcore/CAP,1,v,22,5,11,30,52,0 days 00:00:02.687450
express-validator/express-validator,1,v,55,29,15,60,115,0 days 00:00:02.281775
jackc/pgx,1,v,36,11,14,18,54,0 days 00:00:01.518424
expressjs/cors,1,v,11,3,5,23,34,0 days 00:00:00.097293
lutris/lutris,2, v,3,1,1,63,66,0 days 00:00:01.036515
hashicorp/serf,1,v,9,3,3,22,31,0 days 00:00:01.254743
mikaelbr/node-notifier,1,v,24,4,13,45,69,0 days 00:00:01.291042
nl8590687/ASRT_SpeechRecognition,1,v,10,4,4,4,14,0 days 00:00:04.795115
Lexikos/AutoHotkey_L,2,L v,56,48,2,146,202,0 days 00:00:09.950393
missive/emoji-mart,1,v,20,8,7,40,60,0 days 00:00:03.344707
jrnl-org/jrnl,2, v,13,2,5,24,37,0 days 00:00:00.504039
bfenetworks/bfe,1,v,18,10,3,0,18,0 days 00:00:04.066517
serilog/serilog,1,v,19,3,7,13,32,0 days 00:00:00.873623
jbaysolutions/vue-grid-layout,1,,5,1,1,29,34,0 days 00:00:01.295397
evernote/android-job,1,v,4,1,2,36,40,0 days 00:00:00.335768
SixLabors/ImageSharp,1,v,3,1,1,6,9,0 days 00:00:29.875708
angular-ui/ui-grid,1,v,24,10,11,86,110,0 days 00:00:05.305607
jaywcjlove/hotkeys,1,v,12,4,7,62,74,0 days 00:00:00.575373
jonls/redshift,2, v,17,6,7,2,19,0 days 00:00:01.040317
algolia/places,1,v,34,26,4,69,103,0 days 00:00:01.081171
gcanti/io-ts,1,,20,10,3,84,104,0 days 00:00:00.888542
log4js-node/log4js-node,1,v,32,19,9,90,122,0 days 00:00:01.503112
anishathalye/dotbot,1,v,20,6,11,28,48,0 days 00:00:00.164013
nathancahill/split,2, v,10,5,3,38,48,0 days 00:00:00.145667
mwouts/jupytext,3, v. v,20,10,7,75,95,0 days 00:00:03.791808
jonschlinkert/remarkable,2, v,9,6,2,13,22,0 days 00:00:00.655881
ppoffice/hexo-theme-icarus,2, v,22,9,9,9,31,0 days 00:00:01.066276
valor-software/ngx-bootstrap,2, v,31,15,9,81,112,0 days 00:00:07.290727
ly525/luban-h5,1,v,18,12,3,14,32,0 days 00:00:01.463808
chyroc/WechatSogou,1,v,8,1,3,15,23,0 days 00:00:00.325185
alan-turing-institute/sktime,1,v,10,1,4,14,24,0 days 00:00:05.844983
fatih/color,1,v,16,4,10,1,17,0 days 00:00:03.226446
kaorun343/vue-property-decorator,1,v,24,8,5,16,40,0 days 00:00:00.420363
arachnys/cabot,1,,6,4,1,33,39,0 days 00:00:00.645877
mixn/carbon-now-cli,2, v,5,2,1,7,12,0 days 00:00:00.394558
agentejo/cockpit,1,,8,1,5,27,35,0 days 00:00:03.440342
go-flutter-desktop/go-flutter,1,v,39,33,3,15,54,0 days 00:00:00.587795
MinecraftForge/MinecraftForge,2, v,59,33,13,10,69,0 days 00:00:27.998122
gorakhargosh/watchdog,1,v,12,2,6,35,47,0 days 00:00:00.613269
open-cli-tools/concurrently,2, v,27,7,14,18,45,0 days 00:00:00.943789
haifengl/smile,1,v,12,3,6,10,22,0 days 00:00:39.229370
bytedance/xgplayer,1,v,4,1,2,44,48,0 days 00:00:03.088692
Snapchat/KeyDB,1,v,6,1,2,16,22,0 days 00:00:04.443328
barryvdh/laravel-dompdf,1,v,10,1,8,24,34,0 days 00:00:00.074892
oauth2-proxy/oauth2-proxy,1,v,18,1,10,9,27,0 days 00:00:01.290489
go-acme/lego,1,v,34,15,7,17,51,0 days 00:00:09.561045
NVIDIA/TensorRT,2, v,27,17,2,6,33,0 days 00:00:20.726650
django/channels,1,,20,9,8,44,64,0 days 00:00:00.651887
devicons/devicon,1,v,17,6,5,4,21,0 days 00:00:10.075971
encode/uvicorn,1,,17,4,4,119,136,0 days 00:00:00.483453
leongersen/noUiSlider,1,,45,19,16,58,103,0 days 00:00:01.499706
PyGithub/PyGithub,2, v,62,40,9,23,85,0 days 00:00:11.445867
domlysz/BlenderGIS,2, v,3,1,1,0,3,0 days 00:00:00.272875
tjanczuk/edge,1,v,11,5,5,23,34,0 days 00:00:00.667319
alibaba/transmittable-thread-local,2, v,18,6,8,31,49,0 days 00:00:00.614114
tzapu/WiFiManager,2, v,16,10,3,0,16,0 days 00:00:00.152011
weaveworks/scope,2, v,31,17,5,30,61,0 days 00:00:40.703297
johnkerl/miller,2, v,29,15,8,23,52,0 days 00:00:44.382908
ExactTarget/fuelux,1,,25,10,6,59,84,0 days 00:00:17.828811
mher/flower,1,v,9,1,6,15,24,0 days 00:00:00.506574
containers/buildah,3, V v,42,22,3,70,112,0 days 00:00:27.611268
h6ah4i/android-advancedrecyclerview,1,,8,1,6,22,30,0 days 00:00:01.076374
substack/minimist,1,,6,2,2,20,26,0 days 00:00:00.047786
wasabeef/Blurry,1,,6,1,4,7,13,0 days 00:00:00.081528
arturbien/React95,1,v,13,7,3,6,19,0 days 00:00:05.303030
release-it/release-it,1,,84,66,12,176,260,0 days 00:00:01.261830
crowdsecurity/crowdsec,1,v,7,1,3,39,46,0 days 00:00:03.428443
crossplane/crossplane,1,v,23,11,3,34,57,0 days 00:00:05.642281
graphql-dotnet/graphql-dotnet,2, v,42,24,7,45,87,0 days 00:00:05.502679
kartik-v/bootstrap-fileinput,1,v,26,18,7,61,87,0 days 00:00:00.826917
vrana/adminer,1,v,17,4,11,35,52,0 days 00:00:01.490816
go-task/task,1,v,26,9,7,26,52,0 days 00:00:03.429876
sachinchoolur/lightGallery,2, v,16,4,8,66,82,0 days 00:00:05.012484
onionshare/onionshare,2, v,18,5,11,9,27,0 days 00:00:02.920221
phan/phan,1,,33,13,10,127,160,0 days 00:00:13.460292
rectorphp/rector,2, v,13,1,9,351,364,0 days 00:00:24.808428
bestiejs/benchmark.js,1,,5,2,2,19,24,0 days 00:00:00.404940
wangyu-/udp2raw,1,,38,31,2,0,38,0 days 00:00:01.011155
i-tu/Hasklig,2, v,12,5,4,0,12,0 days 00:00:27.441276
share/sharedb,1,v,23,7,9,111,134,0 days 00:00:00.688630
naver/billboard.js,1,,21,1,13,54,75,0 days 00:00:11.218772
standard-things/esm,1,,29,27,1,160,189,0 days 00:00:01.748348
nhn/tui.image-editor,2, v,21,7,12,17,38,0 days 00:00:07.762791
windicss/windicss,1,v,13,8,1,81,94,0 days 00:00:00.686974
reviewdog/reviewdog,2, v,6,1,4,21,27,0 days 00:00:00.442297
GoogleChrome/lighthouse-ci,1,v,9,1,5,24,33,0 days 00:00:03.439032
microsoft/Windows-driver-samples,1,,609,57,1,0,609,0 days 00:00:10.849735
arkime/arkime,1,v,32,2,17,70,102,0 days 00:00:09.482858
rmax/scrapy-redis,2, v,6,1,3,12,18,0 days 00:00:00.057804
ai/size-limit,1,,45,29,7,101,146,0 days 00:00:01.951716
lancedikson/bowser,2, v,26,11,8,33,59,0 days 00:00:01.512743
vuejs/v2.vuejs.org,1,v,8,4,3,9,17,0 days 00:00:00.666818
timolins/react-hot-toast,1,v,7,3,2,5,12,0 days 00:00:00.719775
hiroppy/fusuma,1,v,37,32,3,59,96,0 days 00:00:08.234641
snorkel-team/snorkel,1,v,4,1,2,11,15,0 days 00:00:09.598255
luraproject/lura,2, v,15,2,10,12,27,0 days 00:00:00.601628
msiemens/tinydb,2, v,34,10,16,26,60,0 days 00:00:00.633737
reactchartjs/react-chartjs-2,3, v. v,24,9,9,51,75,0 days 00:00:01.114903
laravel/socialite,1,v,18,2,9,62,80,0 days 00:00:01.130064
expressjs/body-parser,1,,21,9,8,47,68,0 days 00:00:00.359077
nodegit/nodegit,1,v,27,9,10,67,94,0 days 00:00:18.956499
jvm-profiling-tools/async-profiler,1,v,14,2,9,9,23,0 days 00:00:00.734683
jarun/buku,2, v,36,18,6,3,39,0 days 00:00:01.220954
reek/anti-adblock-killer,1,v,31,29,1,0,31,0 days 00:00:01.736724
journeyapps/zxing-android-embedded,1,v,15,4,9,7,22,0 days 00:00:00.831453
btraceio/btrace,3, release- v,5,1,2,34,39,0 days 00:00:01.524630
pypa/pipx,1,,15,7,5,36,51,0 days 00:00:00.327088
healthchecks/healthchecks,2, v,28,10,1,8,36,0 days 00:00:03.227457
laravel-mix/laravel-mix,1,v,27,19,3,105,132,0 days 00:00:01.212679
TommyLemon/Android-ZBLibrary,1,,21,13,4,4,25,0 days 00:00:02.714228
timber/timber,2, v,32,10,14,96,128,0 days 00:00:01.545915
spectreconsole/spectre.console,1,,44,38,1,3,47,0 days 00:00:03.179073
minbrowser/min,2, v,26,4,8,31,57,0 days 00:00:06.128754
Mailtrain-org/mailtrain,1,v,25,20,2,10,35,0 days 00:00:03.281074
istanbuljs/nyc,1,v,58,43,4,56,114,0 days 00:00:01.306689
uber/prototool,1,v,18,13,3,2,20,0 days 00:00:01.166825
espnet/espnet,1,v.,11,1,6,32,43,0 days 00:00:05.169894
SigmaHQ/sigma,1,,19,6,6,10,29,0 days 00:00:03.161299
lukeed/polka,1,v,5,2,2,9,14,0 days 00:00:00.090862
johannesjo/super-productivity,1,v,58,48,3,296,354,0 days 00:00:13.409619
json5/json5,1,v,10,1,7,8,18,0 days 00:00:00.320721
ZipArchive/ZipArchive,2, v,17,4,9,80,97,0 days 00:00:01.168448
wiremock/wiremock,2, release-,55,28,16,28,83,0 days 00:00:04.298052
kedacore/keda,1,v,14,3,4,3,17,0 days 00:00:02.862588
openpgpjs/openpgpjs,1,v,40,18,13,109,149,0 days 00:00:15.749264
panjf2000/gnet,1,v,8,2,5,35,43,0 days 00:00:00.548514
material-shell/material-shell,2, v,11,7,2,0,11,0 days 00:00:02.168115
zhaojun1998/zfile,1,,32,26,3,11,43,0 days 00:00:08.784603
rauchg/slackin,1,,14,8,3,26,40,0 days 00:00:00.139660
ponylang/ponyc,2, release-,51,31,9,56,107,0 days 00:00:06.034760
google/benchmark,1,v,8,2,5,9,17,0 days 00:00:00.503279
pedroslopez/whatsapp-web.js,1,v,18,8,3,39,57,0 days 00:00:01.030409
aws/aws-sdk-php,1,,234,217,7,1228,1462,0 days 00:01:30.125642
nhn/tui.chart,2, v,38,21,8,60,98,0 days 00:00:26.055933
docker/machine,2, v,16,2,8,16,32,0 days 00:00:06.304844
fengyuanchen/viewerjs,1,v,21,6,10,28,49,0 days 00:00:02.666436
roadrunner-server/roadrunner,2, v,22,7,7,81,103,0 days 00:00:01.415704
meetecho/janus-gateway,1,v,11,1,7,53,64,0 days 00:00:03.970300
reactjs/react-rails,2, v,24,9,9,31,55,0 days 00:00:06.949884
vitalets/x-editable,1,,6,4,1,9,15,0 days 00:00:00.474591
LonamiWebs/Telethon,1,v,44,26,4,91,135,0 days 00:00:03.010653
boto/boto,2, v,50,28,10,29,79,0 days 00:00:07.381728
go-admin-team/go-admin,1,v,6,1,3,27,33,0 days 00:00:06.558451
ServiceStack/ServiceStack,1,v,17,2,12,41,58,0 days 00:00:26.921309
hajimehoshi/ebiten,1,v,17,2,13,66,83,0 days 00:00:16.280557
glidejs/glide,1,v,8,1,5,25,33,0 days 00:00:00.609851
mobxjs/mobx-state-tree,2, v,38,28,7,64,102,0 days 00:00:04.673657
ocrmypdf/OCRmyPDF,1,v,63,40,7,115,178,0 days 00:00:02.959302
Angel-ML/angel,2,Release- v,14,2,6,4,18,0 days 00:00:28.070079
sghall/react-move,1,v,28,19,7,21,49,0 days 00:00:07.415100
0x7c13/Notepads,1,v,14,9,2,42,56,0 days 00:00:00.684711
hotoo/pinyin,1,,13,1,10,28,41,0 days 00:00:04.465722
electronicarts/EASTL,1,,14,1,8,31,45,0 days 00:00:02.355225
electerm/electerm,2, v,35,23,5,292,327,0 days 00:00:01.780491
wilsonpage/fastdom,2, v,8,5,2,23,31,0 days 00:00:00.086098
mautic/mautic,1,,30,6,13,59,89,0 days 00:00:47.683968
opencart/opencart,1,,11,4,5,24,35,0 days 00:00:20.548953
baconjs/bacon.js,1,,9,3,3,200,209,0 days 00:00:00.919342
doctrine/annotations,2, v,14,1,9,20,34,0 days 00:00:00.830125
sebastianbergmann/exporter,1,,7,2,4,12,19,0 days 00:00:00.098759
mbdavid/LiteDB,2,v. v,8,1,3,27,35,0 days 00:00:01.153073
kelektiv/node.bcrypt.js,2, v,11,1,9,39,50,0 days 00:00:00.181035
zendesk/android-floating-action-button,1,,11,9,1,4,15,0 days 00:00:00.144400
zo0r/react-native-push-notification,2, v,16,10,2,19,35,0 days 00:00:00.470114
houtianze/bypy,1,,5,1,2,69,74,0 days 00:00:00.175030
rs/zerolog,1,v,27,9,8,16,43,0 days 00:00:00.364008
optuna/optuna,1,v,36,27,2,4,40,0 days 00:00:05.090990
appleboy/gorush,2, v,16,6,8,15,31,0 days 00:00:01.692917
FreeRDP/FreeRDP,1,,9,2,4,8,17,0 days 00:00:05.726967
rancher/os,1,v,15,4,6,43,58,0 days 00:00:03.755841
kubeedge/kubeedge,1,v,14,1,10,11,25,0 days 00:00:48.528150
sebastianbergmann/environment,1,,11,1,6,27,38,0 days 00:00:00.115755
linkedin/css-blocks,2, v,17,9,4,22,39,0 days 00:00:02.583489
sindresorhus/caprine,2, v,70,49,3,43,113,0 days 00:00:02.725896
kpdecker/jsdiff,1,v,15,3,9,24,39,0 days 00:00:00.347098
conventional-changelog/standard-version,1,v,24,8,13,13,37,0 days 00:00:00.268932
the-benchmarker/web-frameworks,2, v,3,1,1,13,16,0 days 00:00:01.539503
Squirrel/Squirrel.Windows,1,,17,5,7,48,65,0 days 00:00:02.386011
mRemoteNG/mRemoteNG,2, v,17,9,7,23,40,0 days 00:00:11.914169
dylanaraps/pywal,1,,17,10,2,65,82,0 days 00:00:00.328610
isomorphic-git/isomorphic-git,1,v,96,86,3,238,334,0 days 00:00:05.436225
ramboxapp/community-edition,1,,7,3,3,36,43,0 days 00:00:07.237186
simeji/jid,2, v,7,4,1,14,21,0 days 00:00:00.061893
graphql/express-graphql,1,v,12,3,7,31,43,0 days 00:00:00.373904
uNetworking/uWebSockets.js,1,v,59,51,3,6,65,0 days 00:00:59.397060
Uberi/speech_recognition,1,,16,6,6,29,45,0 days 00:00:01.082625
apache/storm,2, v,11,1,9,26,37,0 days 00:00:16.204341
automl/auto-sklearn,3, v. v,12,2,6,21,33,0 days 00:00:15.125123
symfony/translation,1,v,26,4,21,462,488,0 days 00:00:01.028077
concourse/concourse,1,v,134,117,4,81,215,0 days 00:00:19.597539
Radarr/Radarr,2, v,99,64,14,13,112,0 days 00:00:27.474099
Cyan4973/xxHash,2,r v,12,4,4,11,23,0 days 00:00:00.398411
arc298/instagram-scraper,2, v,11,3,4,68,79,0 days 00:00:00.141966
katspaugh/wavesurfer.js,2, v,26,5,10,105,131,0 days 00:00:01.404593
PHPOffice/PHPWord,1,,12,3,7,8,20,0 days 00:00:02.237283
elasticsearch-dump/elasticsearch-dump,2, v,113,92,6,137,250,0 days 00:00:01.184337
node-formidable/formidable,2, v,12,8,3,33,45,0 days 00:00:00.142713
feross/simple-peer,1,v,50,34,10,71,121,0 days 00:00:00.709204
maxogden/menubar,1,v,18,4,8,47,65,0 days 00:00:00.384914
NixOS/nix,1,,37,5,23,53,90,0 days 00:00:07.317596
yugabyte/yugabyte-db,2, v,18,1,12,73,91,0 days 00:00:56.773943
doccano/doccano,1,v,8,2,3,19,27,0 days 00:00:01.741675
albertlauncher/albert,1,v,17,9,5,64,81,0 days 00:00:01.817233
dtm-labs/dtm,1,v,21,18,1,35,56,0 days 00:00:00.773150
jackocnr/intl-tel-input,2, v,62,41,10,262,324,0 days 00:00:02.904757
JetBrains/Exposed,1,,8,3,3,78,86,0 days 00:00:00.434457
amoffat/sh,1,,34,26,5,17,51,0 days 00:00:00.478932
StackExchange/blackbox,1,v,18,6,8,0,18,0 days 00:00:00.268226
react-native-video/react-native-video,2, v,24,13,7,49,73,0 days 00:00:01.283363
yocontra/react-responsive,1,v,8,2,4,28,36,0 days 00:00:00.993631
invoiceninja/invoiceninja,1,v,41,21,5,387,428,0 days 00:00:56.642656
Zizaco/entrust,1,,10,2,7,8,18,0 days 00:00:00.149815
vmware-tanzu/velero,1,v,17,2,8,43,60,0 days 00:00:30.980994
medialize/URI.js,2,v. v,20,7,11,54,74,0 days 00:00:00.829250
gitalk/gitalk,1,v,5,1,3,16,21,0 days 00:00:01.301324
go-resty/resty,1,v,34,14,10,7,41,0 days 00:00:00.857069
yagop/node-telegram-bot-api,1,v,26,14,6,13,39,0 days 00:00:00.640996
DIYgod/APlayer,2, v,6,3,2,15,21,0 days 00:00:00.439212
i18next/i18next,2, v,91,66,9,222,313,0 days 00:00:05.820240
shentao/vue-multiselect,2, v,5,2,1,20,25,0 days 00:00:01.159067
jiaaro/pydub,1,v,17,3,9,19,36,0 days 00:00:01.112059
gruntwork-io/terratest,1,v,39,21,9,296,335,0 days 00:00:00.960996
baskerville/bspwm,1,,9,5,1,15,24,0 days 00:00:00.351215
99designs/aws-vault,1,v,34,17,9,32,66,0 days 00:00:09.753212
thephpleague/oauth2-server,1,,25,3,11,72,97,0 days 00:00:01.083846
dataarts/dat.gui,2, v,6,1,2,18,24,0 days 00:00:00.257296
swaggo/swag,2,v. v,9,1,5,23,32,0 days 00:00:00.509942
redux-offline/redux-offline,2, v,7,1,4,9,16,0 days 00:00:00.302400
software-mansion/react-native-reanimated,1,,23,10,2,19,42,0 days 00:00:03.756040
bpmn-io/bpmn-js,2, v,75,46,7,155,230,0 days 00:00:05.649223
maxence-charriere/go-app,2, v,37,24,6,69,106,0 days 00:00:09.240315
securego/gosec,2, v,16,3,8,8,24,0 days 00:00:00.527994
ArthurHub/Android-Image-Cropper,1,,9,2,6,23,32,0 days 00:00:00.486056
fruitcake/laravel-cors,2,V v,16,5,10,33,49,0 days 00:00:00.162103
simonw/datasette,1,,55,43,6,39,94,0 days 00:00:02.689221
garris/BackstopJS,2, v,25,9,8,106,131,0 days 00:00:01.032472
RichardKnop/machinery,1,v,11,1,7,86,97,0 days 00:00:18.146075
chrismaltby/gb-studio,2, v,6,3,2,6,12,0 days 00:00:06.523039
electerious/Lychee,2, v,11,1,6,31,42,0 days 00:00:00.843380
marshmallow-code/marshmallow,1,,48,22,11,77,125,0 days 00:00:01.581682
dylang/npm-check,2, v,12,4,6,33,45,0 days 00:00:00.125824
snipe/snipe-it,3, V v,30,12,13,130,160,0 days 00:00:19.989910
react-native-svg/react-native-svg,2, v,45,30,7,164,209,0 days 00:00:03.427627
pahen/madge,2, v,30,13,11,29,59,0 days 00:00:00.399143
belluzj/fantasque-sans,2, v,5,1,2,10,15,0 days 00:00:01.068438
PaddlePaddle/Paddle-Lite,3, release/ v,15,4,7,6,21,0 days 00:00:18.639947
centrifugal/centrifugo,1,v,24,5,9,57,81,0 days 00:00:12.821369
baldurk/renderdoc,1,v,39,6,11,0,39,0 days 00:01:18.257102
xonsh/xonsh,1,,12,1,10,100,112,0 days 00:00:02.818236
jenssegers/laravel-mongodb,2, v,19,3,12,91,110,0 days 00:00:00.611316
Graylog2/graylog2-server,1,,25,1,20,124,149,0 days 00:00:27.261861
PrestaShop/PrestaShop,1,,30,14,3,83,113,0 days 00:00:55.967572
gsoft-inc/craco,1,v,32,24,2,27,59,0 days 00:00:01.277154
chancejs/chancejs,2, v,9,3,5,47,56,0 days 00:00:00.210867
faker-js/faker,1,v,22,10,9,26,48,0 days 00:00:28.547292
tindy2013/subconverter,1,v,7,3,2,28,35,0 days 00:00:01.360374
mcollina/autocannon,1,v,52,36,9,43,95,0 days 00:00:00.636323
thedevs-network/kutt,1,v,10,5,2,51,61,0 days 00:00:01.079951
filhodanuvem/gitql,2, v,10,2,6,8,18,0 days 00:00:00.317668
supertokens/supertokens-core,1,v,22,15,2,17,39,0 days 00:00:01.532625
cupy/cupy,1,v,56,48,1,6,62,0 days 00:00:10.685789
SocketCluster/socketcluster,3, v. v,17,13,3,26,43,0 days 00:00:00.246304
hashicorp/raft,1,v,5,1,3,15,20,0 days 00:00:00.295869
flot/flot,2, v,16,6,7,35,51,0 days 00:00:01.421326
reactiveui/refit,2, v,13,3,6,39,52,0 days 00:00:04.188120
google/error-prone,1,v,15,3,5,34,49,0 days 00:00:08.156998
onsi/ginkgo,1,v,19,3,11,21,40,0 days 00:00:01.031040
aws/aws-sam-cli,1,v,96,89,1,36,132,0 days 00:00:10.880483
fabiospampinato/cash,1,,16,8,5,36,52,0 days 00:00:00.565700
burnash/gspread,2, v,19,9,8,21,40,0 days 00:00:02.096015
karatelabs/karate,1,v,11,1,6,27,38,0 days 00:00:03.238589
sindresorhus/query-string,2, v,34,12,12,38,72,0 days 00:00:00.248870
OJ/gobuster,1,v,11,1,7,4,15,0 days 00:00:00.182166
crater-invoice/crater,1,,11,4,4,19,30,0 days 00:00:13.363773
jazzband/pip-tools,1,,45,22,12,49,94,0 days 00:00:01.762089
wojtekmaj/react-pdf,1,v,27,13,6,36,63,0 days 00:00:10.047520
bytedeco/javacv,1,,17,1,14,14,31,0 days 00:00:01.933188
plantuml/plantuml,1,v,9,2,4,78,87,0 days 00:00:05.133506
platformio/platformio-core,3, v. v,43,22,13,72,115,0 days 00:00:04.070856
uber/cadence,1,v,22,9,7,55,77,0 days 00:00:33.158906
trpc/trpc,2, v,57,54,1,48,105,0 days 00:00:04.972489
spulec/moto,2, v,14,2,8,152,166,0 days 00:00:08.104670
ractivejs/ractive,1,v,10,1,6,88,98,0 days 00:00:07.898187
ianstormtaylor/superstruct,1,v,14,7,4,55,69,0 days 00:00:00.588950
gruntwork-io/terragrunt,1,v,37,18,12,337,374,0 days 00:00:02.668320
webslides/WebSlides,1,,7,4,1,7,14,0 days 00:00:00.595696
rest-assured/rest-assured,1,rest-assured-,32,6,15,40,72,0 days 00:00:04.791610
File-New-Project/EarTrumpet,1,,9,2,6,29,38,0 days 00:00:02.674547
sparklemotion/nokogiri,2,REL_ v,15,2,10,89,104,0 days 00:00:02.344979
ethereum-mining/ethminer,1,v,10,1,5,3,13,0 days 00:00:01.991248
perkeep/perkeep,1,,11,5,5,0,11,0 days 00:00:14.517175
geerlingguy/ansible-for-devops,1,,32,16,9,1,33,0 days 00:00:00.347072
moroshko/react-autosuggest,1,v,41,30,6,54,95,0 days 00:00:03.335144
Shougo/deoplete.nvim,1,,14,1,11,0,14,0 days 00:00:00.620596
kulshekhar/ts-jest,2, v,30,14,8,88,118,0 days 00:00:02.653074
twitchtv/twirp,1,v,18,8,8,10,28,0 days 00:00:02.134846
postmanlabs/newman,3, v. v,26,8,8,80,106,0 days 00:00:01.490735
airbnb/hypernova,1,v,9,1,4,8,17,0 days 00:00:00.132410
neuecc/UniRx,1,,18,8,5,7,25,0 days 00:00:02.184096
Unleash/unleash,2, v,34,19,7,132,166,0 days 00:00:09.598644
mahmoud/boltons,1,,24,9,9,21,45,0 days 00:00:00.826204
yuliskov/SmartTubeNext,1,,73,54,1,0,73,0 days 00:00:08.173632
davidjbradshaw/iframe-resizer,2, v,26,16,7,96,122,0 days 00:00:01.002454
mitchellh/mapstructure,1,v,6,2,3,11,17,0 days 00:00:00.131867
QuantConnect/Lean,2, v,1917,1077,4,10,1927,0 days 00:00:54.003168
weibocom/motan,1,,5,1,3,17,22,0 days 00:00:00.900263
TypeStrong/typedoc,2, v,22,3,13,127,149,0 days 00:00:03.917954
react-native-device-info/react-native-device-info,1,v,57,43,7,114,171,0 days 00:00:02.934537
gocd/gocd,1,,69,48,4,2,71,0 days 00:02:20.490438
travist/jsencrypt,2, v,7,2,3,3,10,0 days 00:00:00.518127
gevent/gevent,2, v,19,4,12,35,54,0 days 00:00:09.852850
Jrohy/multi-v2ray,1,v,18,10,4,79,97,0 days 00:00:00.462400
voidcosmos/npkill,1,v,8,5,2,19,27,0 days 00:00:00.275681
HMBSbige/ShadowsocksR-Windows,1,,28,12,13,127,155,0 days 00:00:01.507649
Financial-Times/polyfill-service,2, v,87,65,5,87,174,0 days 00:00:19.533850
deepmipt/DeepPavlov,1,,17,6,4,28,45,0 days 00:00:02.763839
vuejs/vue-class-component,1,v,10,2,5,15,25,0 days 00:00:00.297194
plasma-umass/scalene,2, v,3,1,1,22,25,0 days 00:00:00.258089
pentaho/pentaho-kettle,1,,31,10,16,37,68,0 days 00:00:47.384380
vmware-tanzu/octant,1,v,25,16,3,15,40,0 days 00:00:45.138575
mattn/go-sqlite3,1,v,16,4,7,19,35,0 days 00:00:11.632211
redux-observable/redux-observable,2, v,23,13,7,8,31,0 days 00:00:00.538548
taigaio/taiga-back,1,,24,7,9,74,98,0 days 00:00:07.448369
jsx-eslint/eslint-plugin-react,1,v,81,55,6,88,169,0 days 00:00:05.653948
python-visualization/folium,1,v,11,1,7,10,21,0 days 00:00:28.621855
vercel/serve,2, v,49,34,7,96,145,0 days 00:00:00.578810
carla-simulator/carla,1,,9,4,3,38,47,0 days 00:00:01.361504
UKPLab/sentence-transformers,1,v,10,3,5,20,30,0 days 00:00:00.727629
kelseyhightower/confd,1,v,15,3,8,7,22,0 days 00:00:09.319564
mozilla/nunjucks,3, v. v,14,1,7,37,51,0 days 00:00:02.055656
gcanti/fp-ts,1,,38,23,8,115,153,0 days 00:00:06.154509
adnanh/webhook,1,,9,5,3,21,30,0 days 00:00:01.313793
hybridgroup/gobot,3, v. v,29,10,11,16,45,0 days 00:00:02.887119
metalsmith/metalsmith,2, v,24,15,3,60,84,0 days 00:00:00.372952
remix-run/history,1,v,38,24,7,40,78,0 days 00:00:01.145947
ffmpegwasm/ffmpeg.wasm,1,v,10,6,2,18,28,0 days 00:00:00.722277
sindresorhus/type-fest,1,v,40,29,3,34,74,0 days 00:00:00.511654
heroiclabs/nakama,1,v,38,17,5,29,67,0 days 00:01:27.209150
alibaba/formily,1,v,9,1,4,85,94,0 days 00:00:04.610876
brython-dev/brython,1,,12,1,9,46,58,0 days 00:00:25.262509
colinhacks/zod,2, v,20,15,2,23,43,0 days 00:00:01.113119
cortexlabs/cortex,1,v,42,36,1,20,62,0 days 00:00:11.312301
prompt-toolkit/python-prompt-toolkit,1,,5,1,1,51,56,0 days 00:00:00.639241
BeyondDimension/SteamTools,1,,10,6,3,28,38,0 days 00:00:07.196144
rebassjs/rebass,1,v,11,3,5,42,53,0 days 00:00:01.465917
mvt-project/mvt,1,v,4,2,1,36,40,0 days 00:00:00.117361
beautify-web/js-beautify,1,v,13,3,7,74,87,0 days 00:00:03.792438
mrdoob/stats.js,1,r,16,6,8,0,16,0 days 00:00:01.202287
ckeditor/ckeditor5,2, v,48,30,3,6,54,0 days 00:01:32.632589
sindresorhus/ora,1,v,24,9,9,13,37,0 days 00:00:00.180460
hoffstadt/DearPyGui,1,v,8,4,1,10,18,0 days 00:00:24.142726
probot/probot,2, v,71,58,3,124,195,0 days 00:00:03.507110
chromedp/chromedp,1,v,8,1,5,33,41,0 days 00:00:00.488748
yjs/yjs,1,v,19,9,8,151,170,0 days 00:00:03.689783
paramiko/paramiko,3, release- v,23,3,13,152,175,0 days 00:00:01.583848
yiminghe/async-validator,2, v,18,4,11,59,77,0 days 00:00:00.242840
nodegui/nodegui,1,v,48,42,1,45,93,0 days 00:00:05.456497
signalapp/Signal-Server,1,v,215,206,2,18,233,0 days 00:00:06.095265
symfony/http-kernel,1,v,26,4,21,489,515,0 days 00:00:02.293295
sindresorhus/ky,1,v,29,15,2,18,47,0 days 00:00:00.334225
theonedev/onedev,2, v,26,17,2,131,157,0 days 00:00:13.623391
kubernetes/kompose,1,v,34,22,6,3,37,0 days 00:00:11.130006
wix/react-native-calendars,2, v,1248,229,2,59,1307,0 days 00:00:04.666069
developit/mitt,2, v,6,1,3,5,11,0 days 00:00:00.072995
99designs/gqlgen,2, v,16,7,6,35,51,0 days 00:00:04.359246
react-native-image-picker/react-native-image-picker,2, v,37,22,8,86,123,0 days 00:00:00.661501
react-grid-layout/react-draggable,1,v,24,9,7,57,81,0 days 00:00:00.977246
konvajs/konva,1,,41,18,8,131,172,0 days 00:00:05.354974
chaijs/chai,2, v,30,11,9,48,78,0 days 00:00:01.582679
secdev/scapy,1,v,80,71,8,432,512,0 days 00:00:05.294471
dropwizard/metrics,1,v,10,1,8,77,87,0 days 00:00:01.326320
trustedsec/social-engineer-toolkit,1,,17,4,9,87,104,0 days 00:00:03.503116
retejs/rete,2, v,12,4,3,35,47,0 days 00:00:00.394686
akveo/nebular,1,v,23,9,4,23,46,0 days 00:00:06.879379
NginxProxyManager/nginx-proxy-manager,2, v,10,4,2,48,58,0 days 00:00:01.151700
go-vgo/robotgo,2, v,21,4,9,24,45,0 days 00:00:04.943466
isaacs/node-glob,2, v,18,5,10,102,120,0 days 00:00:00.282914
streamlink/streamlink,1,,30,9,7,17,47,0 days 00:00:05.566647
go-swagger/go-swagger,2, v,29,8,11,26,55,0 days 00:00:38.392550
visionmedia/page.js,2, v,10,3,4,29,39,0 days 00:00:00.209124
HangfireIO/Hangfire,2,v. v,13,4,4,92,105,0 days 00:00:04.196061
xupefei/Locale-Emulator,2, v,13,7,5,14,27,0 days 00:00:00.179615
twigphp/Twig,1,v,66,29,23,139,205,0 days 00:00:06.251560
webdriverio/webdriverio,1,v,91,65,12,415,506,0 days 00:00:13.005799
DaveGamble/cJSON,1,v,9,5,1,36,45,0 days 00:00:00.551776
guzzle/psr7,1,,12,1,9,17,29,0 days 00:00:00.493486
prometheus/node_exporter,2, v,17,2,12,11,28,0 days 00:00:08.055991
metricsgraphics/metrics-graphics,3,V v. v,25,12,5,10,35,0 days 00:00:02.153377
doctrine/cache,2, v,17,4,9,27,44,0 days 00:00:00.417514
InsertKoinIO/koin,1,,13,5,6,33,46,0 days 00:00:02.302722
symfony/polyfill-mbstring,1,v,25,2,13,9,34,0 days 00:00:00.158479
googleapis/google-api-python-client,1,v,60,50,6,52,112,0 days 00:06:44.902636
FormidableLabs/radium,1,v,17,6,6,46,63,0 days 00:00:00.696893
ionic-team/capacitor,2, v,18,6,3,138,156,0 days 00:00:03.331953
qemu/qemu,2,release_ v,48,2,42,86,134,0 days 00:02:58.402306
openspug/spug,2,V v,8,3,3,34,42,0 days 00:00:00.585872
numba/numba,2, v,54,9,8,51,105,0 days 00:00:20.029491
react-cosmos/react-cosmos,2, v,33,18,8,41,74,0 days 00:00:04.718943
oclif/oclif,1,v,59,50,5,261,320,0 days 00:00:01.510781
kelektiv/node-cron,2, v,12,2,8,23,35,0 days 00:00:00.260175
cryptomator/cryptomator,1,,18,7,6,73,91,0 days 00:00:02.548299
gotify/server,1,v,5,1,3,41,46,0 days 00:00:00.427366
altair-viz/altair,2, v,13,3,7,8,21,0 days 00:00:04.921854
krallin/tini,1,v,19,6,6,14,33,0 days 00:00:00.162130
webpack/webpack-dev-server,1,v,42,25,9,70,112,0 days 00:00:05.033595
gogf/gf,1,v,14,2,4,106,120,0 days 00:00:07.315082
mopidy/mopidy,1,v,29,6,16,38,67,0 days 00:00:03.687403
lib/pq,1,v,11,3,5,10,21,0 days 00:00:00.254321
facebook/jscodeshift,2, v,11,1,8,45,56,0 days 00:00:00.359395
lanpa/tensorboardX,1,v,15,2,9,1,16,0 days 00:00:00.544700
LeetCode-OpenSource/vscode-leetcode,1,v,17,9,4,26,43,0 days 00:00:00.514782
Supervisor/supervisor,1,,8,1,6,22,30,0 days 00:00:01.171895
tailscale/tailscale,1,v,19,8,2,54,73,0 days 00:01:11.736671
sosedoff/pgweb,1,v,11,6,3,31,42,0 days 00:00:01.265666
swagger-api/swagger-editor,3, v/ v,27,11,11,364,391,0 days 00:00:59.366649
cerebroapp/cerebro,2, v,5,1,3,16,21,0 days 00:00:00.649115
symfony/debug,1,v,16,2,13,354,370,0 days 00:00:00.525153
JeffreySu/WeiXinMPSDK,2, v,4,1,2,40,44,0 days 00:00:04.438375
winsw/winsw,1,v,21,6,12,10,31,0 days 00:00:00.703640
fideloper/TrustedProxy,1,,13,1,11,11,24,0 days 00:00:00.092574
i18next/react-i18next,2, v,84,68,6,164,248,0 days 00:00:03.317774
davemorrissey/subsampling-scale-image-view,1,v,13,7,5,8,21,0 days 00:00:00.640196
sandboxie-plus/Sandboxie,2, v,11,3,4,58,69,0 days 00:00:05.924748
Sonarr/Sonarr,1,v,44,27,6,8,52,0 days 00:00:10.796900
AlessandroZ/LaZagne,2, v,14,6,5,6,20,0 days 00:00:00.840262
boto/boto3,1,,24,8,11,1045,1069,0 days 00:00:02.825110
FluentValidation/FluentValidation,1,,49,14,24,60,109,0 days 00:00:05.952684
PointCloudLibrary/pcl,1,pcl-,13,2,8,12,25,0 days 00:00:27.696574
AppImage/AppImageKit,1,,13,4,8,0,13,0 days 00:00:00.915125
rocksdanister/lively,1,v,18,15,2,29,47,0 days 00:00:05.150348
xo/usql,1,v,10,4,5,22,32,0 days 00:00:00.390777
terkelg/prompts,1,v,9,2,4,24,33,0 days 00:00:00.269957
sebastianbergmann/php-timer,1,,7,1,3,19,26,0 days 00:00:00.085302
evilsocket/opensnitch,1,v,4,1,2,7,11,0 days 00:00:00.651491
hrydgard/ppsspp,1,v,20,3,14,46,66,0 days 00:00:31.640861
apache/cassandra,1,cassandra-,23,8,13,183,206,0 days 00:00:30.985243
MichalLytek/type-graphql,1,v,19,13,1,18,37,0 days 00:00:02.279488
cjbassi/gotop,1,,9,5,1,24,33,0 days 00:00:01.818710
smartystreets/goconvey,2, v,7,3,3,20,27,0 days 00:00:00.427813
pennersr/django-allauth,1,,42,13,18,13,55,0 days 00:00:05.230232
styled-components/polished,2,v. v,22,12,6,56,78,0 days 00:00:02.103735
fancyapps/fancybox,3, V v,5,1,3,30,35,0 days 00:00:00.379941
pytube/pytube,2, v,31,18,9,78,109,0 days 00:00:01.124126
inorganik/countUp.js,2, v,13,3,8,26,39,0 days 00:00:00.339775
graphql-python/graphene,2,v. v,16,7,5,29,45,0 days 00:00:00.571418
sveltejs/sapper,1,v,29,23,4,149,178,0 days 00:00:01.605020
chrisvfritz/prerender-spa-plugin,2, v,10,4,3,1,11,0 days 00:00:00.554411
barteksc/AndroidPdfViewer,1,,14,8,2,8,22,0 days 00:00:00.289379
angular/angularfire,2, v,11,2,5,28,39,0 days 00:00:02.573948
ngrx/platform,2, v,35,19,5,25,60,0 days 00:00:07.403902
jpillora/chisel,2, v,8,2,4,21,29,0 days 00:00:00.750217
symfony/routing,1,v,26,4,21,441,467,0 days 00:00:01.452928
OWASP/Amass,2, v,37,25,6,123,160,0 days 00:00:23.196702
lz4/lz4,2,r v,18,11,2,11,29,0 days 00:00:00.951875
leeoniya/uPlot,1,,7,3,1,44,51,0 days 00:00:00.862353
marionettejs/backbone.marionette,1,v,32,15,10,93,125,0 days 00:00:04.325626
es-shims/es5-shim,1,v,19,8,7,77,96,0 days 00:00:00.437254
phpmyadmin/phpmyadmin,2, RELEASE_,37,9,15,300,337,0 days 00:03:53.939377
java-native-access/jna,2, v,26,3,18,32,58,0 days 00:00:53.740567
sebastianbergmann/diff,1,,7,1,5,11,18,0 days 00:00:00.135358
facebook/litho,1,v,41,25,3,157,198,0 days 00:01:45.880128
pillarjs/path-to-regexp,2, v,24,9,11,28,52,0 days 00:00:00.738990
surmon-china/vue-quill-editor,1,v,6,2,2,21,27,0 days 00:00:00.334005
metafizzy/flickity,1,v,10,3,6,24,34,0 days 00:00:00.558588
vercel/styled-jsx,2, v,15,5,8,78,93,0 days 00:00:00.706360
yhirose/cpp-httplib,1,v,9,3,5,75,84,0 days 00:00:00.622819
AmruthPillai/Reactive-Resume,1,v,7,4,2,24,31,0 days 00:00:02.824475
ljharb/qs,1,v,25,11,10,49,74,0 days 00:00:00.390747
laravel/tinker,1,v,9,3,4,17,26,0 days 00:00:00.617953
google/android-classyshark,1,,15,9,3,0,15,0 days 00:00:00.711827
Zettlr/Zettlr,3, v. v,28,14,6,49,77,0 days 00:00:22.059556
jazzband/django-debug-toolbar,2, v,25,4,15,24,49,0 days 00:00:01.426233
jemalloc/jemalloc,1,,22,4,14,24,46,0 days 00:00:03.453630
readthedocs/readthedocs.org,1,,76,55,5,152,228,0 days 00:00:11.432818
symfony/css-selector,1,v,26,4,20,434,460,0 days 00:00:00.659647
symfony/process,1,v,26,4,21,450,476,0 days 00:00:00.780128
sebastianbergmann/php-file-iterator,1,,7,1,5,27,34,0 days 00:00:00.079077
gitkraken/vscode-gitlens,2, v,45,33,4,91,136,0 days 00:00:12.572426
encode/starlette,1,,19,8,5,94,113,0 days 00:00:00.521846
raineorshine/npm-check-updates,2, v,56,34,11,194,250,0 days 00:00:02.172345
mqttjs/MQTT.js,2, v,42,22,7,109,151,0 days 00:00:00.805745
ThreeMammals/Ocelot,1,,31,19,6,110,141,0 days 00:00:01.928898
cython/cython,1,,19,2,10,71,90,0 days 00:00:07.281510
developit/microbundle,2, v,15,7,6,24,39,0 days 00:00:00.869572
deepstreamIO/deepstream.io,2, v,25,7,8,98,123,0 days 00:00:02.200940
wallabag/wallabag,1,,20,6,10,40,60,0 days 00:00:09.066152
kekingcn/kkFileView,2, v,5,1,2,5,10,0 days 00:00:59.239419
DevinVinson/WordPress-Plugin-Boilerplate,1,,9,5,2,5,14,0 days 00:00:00.173919
xmrig/xmrig,1,v,46,34,7,73,119,0 days 00:00:04.589037
FullHuman/purgecss,2, v,23,11,7,20,43,0 days 00:00:01.706614
Turfjs/turf,2, v,23,15,5,65,88,0 days 00:00:14.167434
final-form/react-final-form,2,v. v,23,16,3,47,70,0 days 00:00:01.274571
reach/router,1,v,5,2,2,13,18,0 days 00:00:00.363618
monero-project/monero,1,v,19,7,7,34,53,0 days 00:00:19.567223
projectstorm/react-diagrams,2, v,16,6,6,23,39,0 days 00:00:01.923948
matthew-andrews/isomorphic-fetch,1,v,12,7,3,14,26,0 days 00:00:00.059180
symfony/var-dumper,1,v,20,4,15,355,375,0 days 00:00:00.785583
reactjs/react-modal,1,v,19,7,6,91,110,0 days 00:00:00.502039
ffuf/ffuf,1,v,18,8,5,6,24,0 days 00:00:00.259612
rr-debugger/rr,1,,28,9,14,6,34,0 days 00:00:06.074391
jsplumb/jsplumb,1,,28,5,18,188,216,0 days 00:00:38.950267
abel533/Mapper,1,,18,8,5,33,51,0 days 00:00:01.004295
trentm/node-bunyan,1,,33,18,7,81,114,0 days 00:00:00.694008
cosmtrek/air,1,v,5,1,2,18,23,0 days 00:00:00.437121
kennethreitz/records,1,v,5,3,1,6,11,0 days 00:00:00.055388
verlok/vanilla-lazyload,2, v,81,56,15,77,158,0 days 00:00:03.321494
reactiveui/ReactiveUI,2, v,41,24,6,181,222,0 days 00:00:40.426601
be5invis/Sarasa-Gothic,1,v,25,12,8,93,118,0 days 00:03:58.348107
taskflow/taskflow,1,v,13,3,8,1,14,0 days 00:00:17.075314
Humanizr/Humanizer,3, V v,16,8,5,49,65,0 days 00:00:01.501798
brunch/brunch,1,,24,11,8,107,131,0 days 00:00:00.824801
bigskysoftware/htmx,2, v,12,6,1,18,30,0 days 00:00:04.355908
olivere/elastic,1,v,8,1,6,317,325,0 days 00:00:01.414356
musescore/MuseScore,1,v,11,1,9,24,35,0 days 00:03:02.202351
guess-js/guess,2, v,4,1,2,42,46,0 days 00:00:01.025941
microsoft/DeepSpeed,1,v,6,1,3,36,42,0 days 00:00:01.455641
transmission/transmission,1,,99,69,12,1,100,0 days 00:01:32.430962
monkeytypegame/monkeytype,1,v,16,6,1,111,127,0 days 00:00:28.242887
Nuitka/Nuitka,1,,13,8,4,238,251,0 days 00:00:02.946867
barry-ran/QtScrcpy,1,v,9,3,3,15,24,0 days 00:00:16.656777
Sylius/Sylius,1,v,30,4,16,151,181,0 days 00:00:30.589061
gobuffalo/buffalo,2, v,15,3,9,107,122,0 days 00:00:01.185061
ajenti/ajenti,2, v,5,2,2,123,128,0 days 00:00:00.521909
filamentgroup/loadCSS,2, v,9,2,6,14,23,0 days 00:00:00.136519
juice-shop/juice-shop,2, v,91,67,8,101,192,0 days 00:00:13.376861
ds300/patch-package,1,v,17,9,3,40,57,0 days 00:00:00.416974
DylanVann/react-native-fast-image,1,v,20,8,7,90,110,0 days 00:00:05.632890
ssssssss-team/spider-flow,1,v,5,3,1,6,11,0 days 00:00:01.109384
vercel/ncc,1,,31,21,4,46,77,0 days 00:00:02.519380
needim/noty,1,v,10,2,5,37,47,0 days 00:00:00.727377
TrinityCore/TrinityCore,1,TDB,74,41,22,6,80,0 days 00:05:35.575304
cssinjs/jss,2, v,60,41,8,86,146,0 days 00:00:02.564081
tgalal/yowsup,1,v,8,3,4,20,28,0 days 00:00:00.466224
twpayne/chezmoi,1,v,27,16,4,106,133,0 days 00:00:02.449869
jupyterhub/jupyterhub,1,,19,2,11,20,39,0 days 00:00:02.661677
SigNoz/signoz,2, v,7,1,2,28,35,0 days 00:00:01.931360
cockpit-project/cockpit,2, v,314,303,8,1,315,0 days 00:02:32.699242
mongodb/mongo-go-driver,2, v,13,4,7,60,73,0 days 00:00:08.902121
NLPchina/elasticsearch-sql,1,,46,21,13,144,190,0 days 00:00:03.648556
infracost/infracost,2, v,10,6,3,62,72,0 days 00:00:00.803976
SirVer/ultisnips,1,,11,2,7,0,11,0 days 00:00:00.716083
alibaba/MNN,1,,13,9,3,36,49,0 days 00:00:08.863668
ActivityWatch/activitywatch,1,v,8,4,3,11,19,0 days 00:00:00.126503
lucas-clemente/quic-go,2,v. v,24,5,10,33,57,0 days 00:00:04.185449
Vincit/objection.js,1,,19,3,10,101,120,0 days 00:00:04.003566
hashicorp/terraform-provider-aws,1,v,226,223,1,33,259,0 days 00:05:38.323070
kazupon/vue-i18n,1,v,64,37,7,83,147,0 days 00:00:08.587276
lcobucci/jwt,1,,11,3,6,34,45,0 days 00:00:00.487447
kanboard/kanboard,1,v,3,1,1,71,74,0 days 00:00:01.818422
aheckmann/gm,2, v,31,13,12,35,66,0 days 00:00:00.500301
sindresorhus/fkill-cli,2, v,23,9,10,3,26,0 days 00:00:00.128891
ElemeFE/v-charts,1,v,14,9,2,72,86,0 days 00:00:00.610709
sindresorhus/np,1,v,42,24,10,34,76,0 days 00:00:00.307529
schollz/howmanypeoplearearound,1,v,4,2,1,11,15,0 days 00:00:00.638098
hugapi/hug,1,,18,11,5,44,62,0 days 00:00:00.764050
grpc/grpc-web,1,,7,4,2,9,16,0 days 00:00:00.453532
Rob--W/cors-anywhere,2, v,3,1,1,18,21,0 days 00:00:00.051550
xojs/xo,1,v,43,24,8,43,86,0 days 00:00:00.509018
gregberge/loadable-components,1,v,30,19,6,35,65,0 days 00:00:02.375157
Laravel-Lang/lang,1,,20,12,6,174,194,0 days 00:00:08.304809
visgl/react-map-gl,2, v,22,10,9,143,165,0 days 00:00:02.795355
electron/fiddle,2, v,29,14,3,22,51,0 days 00:00:04.704669
BoyceLig/Clash_Chinese_Patch,1,,7,1,3,57,64,0 days 00:00:16.633666
enquirer/enquirer,1,,6,2,3,27,33,0 days 00:00:00.275421
flyway/flyway,1,flyway-,40,20,13,101,141,0 days 00:00:06.621382
wailsapp/wails,1,v,19,10,2,44,63,0 days 00:00:00.976957
migueldeicaza/gui.cs,1,v,13,6,4,9,22,0 days 00:00:04.128138
QUANTAXIS/QUANTAXIS,2, V,15,4,5,44,59,0 days 00:00:08.594183
jaredpalmer/tsdx,1,v,13,6,3,40,53,0 days 00:00:00.601264
iterative/dvc,1,,92,83,3,258,350,0 days 00:00:05.188648
Hacker0x01/react-datepicker,2, v,107,85,2,73,180,0 days 00:00:32.973894
wasabeef/glide-transformations,1,,9,3,5,10,19,0 days 00:00:00.680980
grpc/grpc-java,1,v,52,22,4,58,110,0 days 00:00:27.082394
stylelint/stylelint,2, v,97,78,4,88,185,0 days 00:00:14.765765
libretro/RetroArch,2, v,15,3,7,77,92,0 days 00:00:20.507685
josdejong/jsoneditor,1,v,71,48,11,125,196,0 days 00:00:29.158353
eclipse/che,1,,100,95,2,126,226,0 days 00:01:27.720244
svgdotjs/svg.js,1,,50,38,8,48,98,0 days 00:00:02.214624
react-native-camera/react-native-camera,1,v,84,69,5,96,180,0 days 00:00:03.812340
microsoft/azuredatastudio,2, v,40,28,2,89,129,0 days 00:02:27.041776
snapappointments/bootstrap-select,2, v,13,3,7,52,65,0 days 00:00:00.746001
TranslucentTB/TranslucentTB,1,,14,7,6,0,14,0 days 00:00:00.572708
open-policy-agent/opa,1,v,40,22,6,80,120,0 days 00:01:43.482133
mdbootstrap/material-design-for-bootstrap,1,,18,11,5,46,64,0 days 00:00:06.096258
addyosmani/critical,2, v,17,4,9,44,61,0 days 00:00:01.492974
sindresorhus/pageres,2, v,24,8,7,23,47,0 days 00:00:00.216683
pockethub/PocketHub,2, v,11,5,3,9,20,0 days 00:00:01.971860
senchalabs/connect,1,,52,27,11,174,226,0 days 00:00:01.296713
meliorence/react-native-snap-carousel,2,V v,22,15,2,29,51,0 days 00:00:00.677800
FormidableLabs/victory,1,v,65,43,8,156,221,0 days 00:00:17.038380
TarsCloud/Tars,2, v,15,7,4,32,47,0 days 00:00:02.680003
jhen0409/react-native-debugger,1,v,12,3,7,74,86,0 days 00:00:00.569427
botpress/botpress,2, v,88,76,4,234,322,0 days 00:00:35.332059
lvgl/lvgl,2, v,26,10,7,20,46,0 days 00:00:19.509405
mswjs/msw,2, v,38,31,1,90,128,0 days 00:00:02.076841
Automattic/kue,2, v,10,2,7,47,57,0 days 00:00:00.253925
charmbracelet/glow,1,v,7,4,1,10,17,0 days 00:00:00.174883
apidoc/apidoc,1,,27,7,10,19,46,0 days 00:00:01.626585
BookStackApp/BookStack,3, v. v,36,10,9,113,149,0 days 00:00:12.225022
pinojs/pino,2, v,90,69,7,150,240,0 days 00:00:01.315277
squizlabs/PHP_CodeSniffer,1,,19,5,12,51,70,0 days 00:00:05.960600
argoproj/argo-cd,1,v,25,9,4,115,140,0 days 00:00:13.757779
mongodb/node-mongodb-native,3,V v. v,25,4,18,387,412,0 days 00:00:17.959873
deepmind/sonnet,1,v,35,24,1,0,35,0 days 00:00:02.691898
future-architect/vuls,1,v,19,4,6,64,83,0 days 00:00:01.252947
dingo/api,2, v,16,9,5,41,57,0 days 00:00:00.523470
r-spacex/SpaceX-API,2, v,15,9,3,8,23,0 days 00:00:00.741068
FormidableLabs/spectacle,2, v,35,12,11,77,112,0 days 00:00:01.910787
vnotex/vnote,2, v,47,34,4,13,60,0 days 00:00:08.544655
uncss/uncss,1,,9,2,5,9,18,0 days 00:00:00.281704
reactjs/react-transition-group,1,v,19,9,7,19,38,0 days 00:00:01.247836
deployphp/deployer,1,v,20,6,9,47,67,0 days 00:00:00.734294
exceljs/exceljs,2, v,41,28,7,180,221,0 days 00:00:02.181622
oblador/react-native-animatable,1,v,10,4,4,13,23,0 days 00:00:00.243533
acaudwell/Gource,1,gource-,20,5,11,0,20,0 days 00:00:00.757168
cheat/cheat,1,,18,10,4,67,85,0 days 00:00:01.071386
arasatasaygin/is.js,1,v,8,5,2,13,21,0 days 00:00:00.246378
Atmosphere-NX/Atmosphere,1,,18,7,6,48,66,0 days 00:00:14.217914
crimx/ext-saladict,3, V v,59,47,6,139,198,0 days 00:00:06.563193
upx/upx,1,v,31,7,18,0,31,0 days 00:00:17.685066
docmirror/dev-sidecar,2, v,7,3,2,16,23,0 days 00:00:01.445111
hackware1993/MagicIndicator,1,,8,4,2,5,13,0 days 00:00:00.452935
callstack/react-native-paper,2, v,53,40,5,61,114,0 days 00:00:06.800961
coleifer/peewee,1,,35,12,13,139,174,0 days 00:00:02.988878
chimurai/http-proxy-middleware,1,v,26,19,6,30,56,0 days 00:00:00.635621
direnv/direnv,2, v,33,8,16,42,75,0 days 00:00:01.891799
pyinstaller/pyinstaller,2, v,28,5,19,6,34,0 days 00:00:10.640435
boardgameio/boardgame.io,1,v,39,28,4,111,150,0 days 00:00:06.408042
bulletphysics/bullet3,1,,18,5,9,6,24,0 days 00:00:35.581731
phpDocumentor/ReflectionDocBlock,1,,14,4,8,24,38,0 days 00:00:00.590280
symfony/console,1,v,26,4,21,466,492,0 days 00:00:01.892021
Gallopsled/pwntools,1,,26,5,8,35,61,0 days 00:00:06.561886
coredns/coredns,1,v,20,7,7,42,62,0 days 00:00:28.266822
rough-stuff/wired-elements,1,v,9,2,4,26,35,0 days 00:00:00.775689
cure53/DOMPurify,2, v,12,3,8,68,80,0 days 00:00:00.788365
PrefectHQ/prefect,1,,17,5,6,102,119,0 days 00:00:09.821536
aksonov/react-native-router-flux,2, v,13,3,6,34,47,0 days 00:00:01.114261
javascript-obfuscator/javascript-obfuscator,1,,63,47,4,122,185,0 days 00:00:20.859231
OWASP/owasp-mstg,2, v,5,1,3,7,12,0 days 00:00:03.267753
didi/cube-ui,2, v,13,10,1,69,82,0 days 00:00:11.984790
react-dropzone/react-dropzone,2, v,55,34,12,120,175,0 days 00:00:02.051893
thumbor/thumbor,1,,61,33,14,178,239,0 days 00:00:04.384190
capnproto/capnproto,1,v,9,1,6,12,21,0 days 00:00:05.327545
paulmillr/chokidar,1,,28,10,14,70,98,0 days 00:00:00.522434
helmetjs/helmet,1,v,51,23,8,34,85,0 days 00:00:01.217327
inversify/InversifyJS,2, v,25,15,7,22,47,0 days 00:00:01.060164
ginuerzh/gost,2, v,21,11,7,11,32,0 days 00:00:05.088694
callstack/linaria,1,v,14,9,4,24,38,0 days 00:00:01.186256
mayswind/AriaNg,1,,9,1,6,14,23,0 days 00:00:00.684605
aws/chalice,1,,38,17,8,43,81,0 days 00:00:03.100181
TuSimple/naive-ui,2, v,26,23,1,70,96,0 days 00:00:05.261783
didi/chameleon,2, v,4,1,1,19,23,0 days 00:00:00.811980
marmelab/gremlins.js,2, v,5,1,3,2,7,0 days 00:00:00.398554
dromara/Sa-Token,1,v,23,18,2,1,24,0 days 00:00:01.886310
phpDocumentor/TypeResolver,1,,14,2,9,18,32,0 days 00:00:00.389276
gka/chroma.js,2, v,9,3,5,26,35,0 days 00:00:00.710702
antvis/G6,1,,9,2,3,64,73,0 days 00:00:02.172961
fkhadra/react-toastify,1,v,33,16,8,60,93,0 days 00:00:02.261902
sinonjs/sinon,2, v,57,27,18,121,178,0 days 00:00:32.603007
crawlab-team/crawlab,1,v,6,1,3,21,27,0 days 00:00:04.870324
ydataai/pandas-profiling,2,v. v,20,10,7,14,34,0 days 00:00:39.969695
webtorrent/webtorrent-desktop,1,v,25,18,5,13,38,0 days 00:00:03.094513
react-page/react-page,2, v,58,45,6,214,272,0 days 00:00:09.481782
facebookresearch/ParlAI,2, v,10,5,2,10,20,0 days 00:00:04.363088
tinode/chat,1,v,6,1,4,45,51,0 days 00:00:00.970396
OpenRefine/OpenRefine,2, v,13,1,10,9,22,0 days 00:00:18.844434
heartexlabs/label-studio,2,v. v,14,4,2,24,38,0 days 00:00:40.827178
zerotier/ZeroTierOne,1,,15,4,6,68,83,0 days 00:00:05.592161
facebook/chisel,1,,10,1,6,3,13,0 days 00:00:00.202185
remarkjs/react-markdown,2, v,22,7,11,46,68,0 days 00:00:01.009964
sonic-pi-net/sonic-pi,1,v,16,5,7,9,25,0 days 00:01:39.415229
encode/httpx,1,,23,10,4,47,70,0 days 00:00:01.282224
tweepy/tweepy,2, v,40,17,15,4,44,0 days 00:00:03.266054
golang-migrate/migrate,1,v,24,7,7,25,49,0 days 00:00:00.801685
Aircoookie/WLED,1,v,8,1,6,15,23,0 days 00:00:01.503979
GoogleChromeLabs/comlink,1,v,15,8,4,23,38,0 days 00:00:00.702276
mementum/backtrader,1,,7,2,1,132,139,0 days 00:00:00.550334
pytest-dev/pytest,1,,42,10,17,122,164,0 days 00:00:10.173265
mapeditor/tiled,1,v,27,3,20,56,83,0 days 00:00:21.622653
coursera-dl/coursera-dl,1,,8,1,5,12,20,0 days 00:00:00.305860
cert-manager/cert-manager,1,v,25,3,3,49,74,0 days 00:01:18.030992
ultralytics/yolov3,1,v,12,6,4,0,12,0 days 00:00:00.954853
desandro/imagesloaded,1,v,11,3,5,27,38,0 days 00:00:00.166058
gregberge/svgr,1,v,36,29,4,19,55,0 days 00:00:03.373802
cefsharp/CefSharp,1,v,27,5,11,70,97,0 days 00:00:14.847222
microsoft/Windows-universal-samples,2, v,438,13,9,171,609,0 days 00:00:05.632015
pyodide/pyodide,2, v,20,11,6,25,45,0 days 00:00:01.333112
doctrine/dbal,2, v,18,2,14,79,97,0 days 00:00:05.682242
caprover/caprover,2,V v,12,6,5,17,29,0 days 00:00:01.809494
piskelapp/piskel,1,v,14,2,9,16,30,0 days 00:00:01.653884
catboost/catboost,3, v. v,25,7,3,57,82,0 days 00:04:35.859174
mailpile/Mailpile,1,,5,1,2,6,11,0 days 00:00:03.618258
questdb/questdb,2, v,12,1,8,39,51,0 days 00:00:26.509322
cyrus-and/gdb-dashboard,1,v,15,6,8,15,30,0 days 00:00:00.166479
tweenjs/tween.js,3, r v,30,12,12,23,53,0 days 00:00:01.162752
EpistasisLab/tpot,2, v,9,1,5,15,24,0 days 00:00:01.257940
Automattic/node-canvas,2, v,30,11,13,88,118,0 days 00:00:01.264347
spotDL/spotify-downloader,1,v,14,4,4,38,52,0 days 00:00:06.643036
aws/serverless-application-model,2, v,42,25,6,9,51,0 days 00:00:05.327011
chakra-core/ChakraCore,1,v,9,1,3,52,61,0 days 00:00:39.914215
Shopify/sarama,1,v,34,10,15,18,52,0 days 00:00:01.964390
claudiodangelis/qrcp,1,,6,2,3,17,23,0 days 00:00:00.295661
XTLS/Xray-core,1,v,6,3,1,21,27,0 days 00:00:01.065658
Justson/AgentWeb,2, v,4,1,1,13,17,0 days 00:00:00.423712
google/go-github,1,v,59,43,6,35,94,0 days 00:00:05.109624
muesli/duf,1,v,8,5,2,4,12,0 days 00:00:00.101535
jprichardson/node-fs-extra,2, v,43,18,12,42,85,0 days 00:00:01.018215
pmndrs/jotai,1,v,24,17,1,88,112,0 days 00:00:01.515845
shipshapecode/tether,1,v,13,6,4,60,73,0 days 00:00:00.863217
nextapps-de/flexsearch,1,,4,2,1,13,17,0 days 00:00:00.614230
videolan/vlc,1,,9,1,3,50,59,0 days 00:00:58.769490
welldone-software/why-did-you-render,2,v. v,19,8,6,67,86,0 days 00:00:01.810834
listen1/listen1_chrome_extension,1,v,32,22,7,36,68,0 days 00:00:01.225996
wkentaro/labelme,1,v,50,38,9,125,175,0 days 00:00:02.945780
MarshallOfSound/Google-Play-Music-Desktop-Player-UNOFFICIAL-,2, v,26,17,3,32,58,0 days 00:00:02.569420
blevesearch/bleve,1,v,14,3,7,27,41,0 days 00:00:02.185123
restsharp/RestSharp,2, v,30,14,11,29,59,0 days 00:00:03.777035
gskinner/regexr,1,,5,2,1,6,11,0 days 00:00:00.287547
tsayen/dom-to-image,1,,13,7,3,23,36,0 days 00:00:04.531961
James-Yu/LaTeX-Workshop,1,v,89,74,1,126,215,0 days 00:00:11.715234
giampaolo/psutil,1,release-,32,8,17,52,84,0 days 00:00:04.372504
MonoGame/MonoGame,2, v,12,1,9,4,16,0 days 00:00:15.148118
nilaoda/N_m3u8DL-CLI,1,,18,9,3,65,83,0 days 00:00:00.492450
OnsenUI/OnsenUI,1,,20,6,8,68,88,0 days 00:00:38.515524
cesanta/mongoose,1,,43,12,22,1,44,0 days 00:00:09.398426
node-schedule/node-schedule,2, v,10,3,5,36,46,0 days 00:00:00.138751
nodejs/node-gyp,2, v,37,7,18,98,135,0 days 00:00:02.608988
jwtk/jjwt,1,,11,4,6,15,26,0 days 00:00:00.602994
projectdiscovery/nuclei,2,v. v,10,2,6,43,53,0 days 00:00:00.839700
rq/rq,2, v,24,2,15,44,68,0 days 00:00:00.928441
KurtBestor/Hitomi-Downloader,1,v,17,3,8,0,17,0 days 00:00:00.358772
libgit2/libgit2,1,v,29,7,16,48,77,0 days 00:00:14.076449
junit-team/junit4,1,r,8,1,6,5,13,0 days 00:00:01.376002
borgbackup/borg,1,,22,13,5,36,58,0 days 00:00:02.044104
vector-im/element-web,1,v,27,9,9,172,199,0 days 00:00:03.408954
chocolatey/choco,1,,5,1,2,38,43,0 days 00:00:01.758620
sebastianbergmann/php-code-coverage,1,,23,4,13,138,161,0 days 00:00:01.697485
panjf2000/ants,1,v,9,4,4,15,24,0 days 00:00:00.156980
Nozbe/WatermelonDB,1,v,19,5,6,17,36,0 days 00:00:07.531853
uber/react-vis,2, v,22,14,3,77,99,0 days 00:00:00.959264
cytoscape/cytoscape.js,1,v,29,10,13,198,227,0 days 00:00:21.318736
myclabs/DeepCopy,1,,12,1,10,18,30,0 days 00:00:00.134789
benoitc/gunicorn,1,,31,12,14,51,82,0 days 00:00:01.651285
MahApps/MahApps.Metro,1,,21,5,11,33,54,0 days 00:00:09.042206
dat-ecosystem-archive/dat,1,v,43,31,8,64,107,0 days 00:00:00.776923
square/moshi,1,moshi-parent-,15,1,12,4,19,0 days 00:00:01.224289
agenda/agenda,2, v,20,5,11,65,85,0 days 00:00:02.103717
openframeworks/openFrameworks,1,,10,1,6,16,26,0 days 00:02:34.889354
coil-kt/coil,1,,15,5,6,12,27,0 days 00:00:03.215266
protobufjs/protobuf.js,2, v,23,11,6,55,78,0 days 00:00:04.962314
pre-commit/pre-commit,1,v,60,32,9,111,171,0 days 00:00:01.756183
stanfordnlp/CoreNLP,1,v,11,5,3,12,23,0 days 00:00:29.563887
jopohl/urh,1,v,17,8,7,74,91,0 days 00:00:14.338946
NG-ZORRO/ng-zorro-antd,1,,41,30,5,65,106,0 days 00:00:12.092424
dropwizard/dropwizard,1,v,15,1,11,119,134,0 days 00:00:04.996727
symfony/http-foundation,1,v,26,4,21,464,490,0 days 00:00:01.795996
lima-vm/lima,1,v,11,6,1,16,27,0 days 00:00:00.419138
googleapis/google-api-php-client,2, v,13,2,8,32,45,0 days 00:00:00.784783
bloomrpc/bloomrpc,2, v,6,2,3,9,15,0 days 00:00:00.810184
ninja-build/ninja,2,release- v,14,1,10,12,26,0 days 00:00:00.905201
devhubapp/devhub,2, v,55,47,3,61,116,0 days 00:00:25.727486
hediet/vscode-drawio,1,v,10,6,2,13,23,0 days 00:00:00.669597
tidwall/tile38,1,,27,6,7,59,86,0 days 00:00:13.583279
OpenFeign/feign,3, release- v,72,48,10,54,126,0 days 00:00:02.999754
symfony/event-dispatcher,1,v,26,4,21,436,462,0 days 00:00:00.822486
apache/tvm,1,v,7,1,5,1,8,0 days 00:00:10.847910
olivernn/lunr.js,1,v,12,1,6,46,58,0 days 00:00:01.664993
knadh/listmonk,1,v,4,1,2,0,4,0 days 00:00:01.461258
VulcanJS/Vulcan,2, v,22,11,6,45,67,0 days 00:00:03.107950
paragonie/random_compat,2, v,7,3,1,54,61,0 days 00:00:00.096444
resilience4j/resilience4j,3, v. v,22,5,9,15,37,0 days 00:00:04.170589
Koenkk/zigbee2mqtt,1,,28,16,5,33,61,0 days 00:00:05.454252
happyfish100/fastdfs,1,V,16,7,5,0,16,0 days 00:00:01.803789
electron/electron-packager,1,v,53,30,10,42,95,0 days 00:00:00.855290
nopSolutions/nopCommerce,1,release-,29,20,8,6,35,0 days 00:12:54.381778
rofl0r/proxychains-ng,1,v,16,3,10,1,17,0 days 00:00:00.342602
OpenIMSDK/Open-IM-Server,1,v,3,1,1,15,18,0 days 00:00:00.584495
HabitRPG/habitica,2, v,351,348,2,612,963,0 days 00:04:49.216185
shwenzhang/AndResGuard,1,,3,1,1,35,38,0 days 00:00:00.141958
pypa/pip,1,,36,2,27,73,109,0 days 00:00:12.389279
symfony/finder,1,v,26,4,20,440,466,0 days 00:00:00.805832
sockjs/sockjs-client,1,v,11,1,7,20,31,0 days 00:00:01.247609
PaddlePaddle/PaddleHub,2, v,12,3,1,10,22,0 days 00:01:24.888219
Stuk/jszip,1,v,19,5,11,14,33,0 days 00:00:01.766678
sahat/satellizer,1,,14,7,4,41,55,0 days 00:00:01.831085
szimek/signature_pad,1,v,11,3,4,19,30,0 days 00:00:00.210086
ng-bootstrap/ng-bootstrap,1,,27,12,6,49,76,0 days 00:00:04.310114
dotnet/machinelearning,1,v,18,12,4,5,23,0 days 00:00:35.513068
smicallef/spiderfoot,1,v,8,1,6,1,9,0 days 00:00:07.232216
airbnb/epoxy,1,,41,26,5,22,63,0 days 00:00:02.383662
arrow-py/arrow,1,,17,3,11,37,54,0 days 00:00:00.595015
ChrisRM/material-theme-jetbrains,2, v,83,68,2,163,246,0 days 00:00:12.188959
firefly-iii/firefly-iii,1,,41,19,8,201,242,0 days 00:00:35.638129
adrai/flowchart.js,1,v,17,4,9,31,48,0 days 00:00:00.728888
Jguer/yay,1,v,49,33,9,26,75,0 days 00:00:01.589433
doitsujin/dxvk,1,v,40,30,5,32,72,0 days 00:00:05.589131
Pikaday/Pikaday,1,,9,1,7,6,15,0 days 00:00:00.192411
grommet/grommet,2, v,41,18,8,76,117,0 days 00:00:15.872171
qutebrowser/qutebrowser,1,v,32,4,16,49,81,0 days 00:00:14.822845
mediaelement/mediaelement,1,,32,8,12,117,149,0 days 00:00:04.568715
tiangolo/typer,1,,4,1,1,15,19,0 days 00:00:00.175133
mjmlio/mjml,3, V v,25,8,11,50,75,0 days 00:00:01.536022
JustArchiNET/ArchiSteamFarm,1,,167,154,10,431,598,0 days 00:00:28.903172
abpframework/abp,2, v,43,33,3,60,103,0 days 00:02:42.604606
huggingface/datasets,1,,26,21,1,26,52,0 days 00:00:17.482604
wtfutil/wtf,2, v,41,26,1,26,67,0 days 00:00:22.263064
d2l-ai/d2l-en,1,v,8,1,4,17,25,0 days 00:00:08.629666
justauth/JustAuth,3, v. v,14,9,2,25,39,0 days 00:00:00.589469
zalmoxisus/redux-devtools-extension,2, v,27,23,2,43,70,0 days 00:00:00.934693
scylladb/scylla,1,scylla-,33,11,10,130,163,0 days 00:00:38.504052
grpc-ecosystem/grpc-gateway,1,v,28,10,10,43,71,0 days 00:00:04.718596
automerge/automerge,1,v,13,4,6,20,33,0 days 00:00:00.600122
fabric/fabric,1,,26,4,19,97,123,0 days 00:00:01.601739
Tencent/APIJSON,1,,37,21,7,51,88,0 days 00:00:05.410654
powerline/powerline,1,,13,3,7,10,23,0 days 00:00:01.243854
orhanobut/logger,2, v,13,7,3,1,14,0 days 00:00:00.206640
verdaccio/verdaccio,1,v,64,34,13,148,212,0 days 00:00:11.224867
android-hacker/VirtualXposed,2, v,12,3,3,55,67,0 days 00:00:00.888420
google/cadvisor,2, v,45,20,15,71,116,0 days 00:00:16.880991
getgrav/grav,1,,13,3,8,170,183,0 days 00:00:03.488402
microsoft/recommenders,1,,9,3,3,2,11,0 days 00:00:03.479958
authelia/authelia,1,v,55,39,5,114,169,0 days 00:00:08.007949
Budibase/budibase,1,v,10,5,3,479,489,0 days 00:00:06.830513
liabru/matter-js,1,,10,1,7,8,18,0 days 00:00:10.437540
microsoft/AirSim,2,v. v,3,1,1,15,18,0 days 00:00:01.350644
RaRe-Technologies/gensim,1,,23,6,11,36,59,0 days 00:00:15.797203
flipped-aurora/gin-vue-admin,3,V v. v,7,2,2,21,28,0 days 00:00:01.433404
timescale/timescaledb,1,,28,8,8,33,61,0 days 00:00:18.347714
ahmetb/kubectx,1,v,9,2,5,11,20,0 days 00:00:00.103574
python/mypy,1,v,59,38,8,7,66,0 days 00:00:24.491717
remotion-dev/remotion,1,v,14,8,1,81,95,0 days 00:00:11.566438
brix/crypto-js,2, release-,4,2,1,10,14,0 days 00:00:00.295451
mdx-js/mdx,2, v,26,19,5,140,166,0 days 00:00:02.808581
xtermjs/xterm.js,1,,76,52,7,35,111,0 days 00:00:06.463229
mockito/mockito,1,v,58,32,10,409,467,0 days 00:00:12.272641
txthinking/brook,1,v,43,22,6,0,43,0 days 00:00:38.675143
redwoodjs/redwood,2, v,57,53,1,71,128,0 days 00:00:18.750918
termux/termux-app,1,v,89,73,7,0,89,0 days 00:00:02.182707
xtaci/kcptun,2, v,106,79,7,0,106,0 days 00:00:01.753679
bcicen/ctop,2, v,5,2,2,11,16,0 days 00:00:00.159709
arduino/Arduino,1,,26,5,13,46,72,0 days 00:00:47.381225
GoogleContainerTools/skaffold,1,v,80,76,1,29,109,0 days 00:00:55.708851
selectize/selectize.js,1,v,12,5,2,64,76,0 days 00:00:00.829850
gionkunz/chartist-js,1,v,11,6,4,47,58,0 days 00:00:00.759611
WerWolv/ImHex,1,v,19,14,2,12,31,0 days 00:00:09.595068
http-party/node-http-proxy,2, v,27,11,13,70,97,0 days 00:00:00.459068
filp/whoops,1,,18,6,8,50,68,0 days 00:00:00.333161
wechaty/wechaty,1,v,15,4,7,8,23,0 days 00:00:01.682690
Semantic-Org/Semantic-UI-React,1,v,93,78,5,211,304,0 days 00:00:08.126468
DIYgod/DPlayer,2, v,21,12,5,21,42,0 days 00:00:01.660400
modood/Administrative-divisions-of-China,1,,9,1,7,7,16,0 days 00:01:47.285316
CachetHQ/Cachet,1,v,7,1,2,30,37,0 days 00:00:02.407370
you-dont-need/You-Dont-Need-Momentjs,1,v,6,3,2,5,11,0 days 00:00:00.093393
rwaldron/johnny-five,2, v,14,3,7,73,87,0 days 00:00:01.862843
umijs/qiankun,1,v,14,4,7,92,106,0 days 00:00:00.331510
Foundry376/Mailspring,1,,11,1,6,43,54,0 days 00:00:10.637697
faressoft/terminalizer,1,v,6,3,1,25,31,0 days 00:00:00.123687
Intervention/image,1,,15,3,8,93,108,0 days 00:00:00.318947
redux-form/redux-form,1,v,46,30,8,141,187,0 days 00:00:05.396487
revel/revel,1,v,18,4,10,7,25,0 days 00:00:00.962401
onnx/onnx,1,v,13,1,10,9,22,0 days 00:00:06.666911
charmbracelet/bubbletea,1,v,20,14,4,27,47,0 days 00:00:00.281858
NodeBB/NodeBB,1,v,30,2,17,93,123,0 days 00:00:20.973753
showdownjs/showdown,2, v,14,3,7,42,56,0 days 00:00:00.630056
moment/luxon,1,,37,21,6,69,106,0 days 00:00:03.137362
thephpleague/flysystem,1,,13,2,6,175,188,0 days 00:00:00.713847
psf/requests-html,1,v,8,6,1,22,30,0 days 00:00:00.115306
horovod/horovod,1,v,16,3,10,53,69,0 days 00:00:02.261818
pqina/filepond,1,,52,41,4,143,195,0 days 00:00:05.270635
OptimalBits/bull,2, v,49,26,13,84,133,0 days 00:00:01.816932
bvaughn/react-window,1,,4,2,1,16,20,0 days 00:00:00.350436
google/gvisor,1,release-,99,94,2,0,99,0 days 00:00:42.829800
openstf/stf,1,v,12,4,7,16,28,0 days 00:00:01.904464
aws/aws-cli,1,,46,24,17,1642,1688,0 days 00:00:15.747962
pyecharts/pyecharts,1,v,14,4,6,29,43,0 days 00:00:01.160581
barryvdh/laravel-ide-helper,1,v,25,8,15,61,86,0 days 00:00:00.423503
uuidjs/uuid,1,v,16,6,8,21,37,0 days 00:00:00.872757
surmon-china/vue-awesome-swiper,2, v,14,5,5,36,50,0 days 00:00:00.385947
MaterialDesignInXAML/MaterialDesignInXamlToolkit,2, v,21,5,12,12,33,0 days 00:00:09.418410
tensorflow/tensor2tensor,3, v. v,15,5,4,61,76,0 days 00:00:06.042392
danilowoz/react-content-loader,2, v,16,6,8,27,43,0 days 00:00:01.747080
liriliri/eruda,1,v,15,6,5,40,55,0 days 00:00:01.141617
gaearon/react-hot-loader,2, v,25,13,6,107,132,0 days 00:00:01.422948
josdejong/mathjs,1,v,109,83,4,118,227,0 days 00:00:38.272650
wkhtmltopdf/wkhtmltopdf,1,,8,4,3,31,39,0 days 00:00:00.217604
11ty/eleventy,1,v,13,2,7,41,54,0 days 00:00:00.889382
systemjs/systemjs,2, v,40,18,10,187,227,0 days 00:00:03.925042
keybase/client,2, v,29,21,4,65,94,0 days 00:06:17.312503
rt2zz/redux-persist,1,v,36,27,6,76,112,0 days 00:00:00.676741
visionmedia/supertest,2, v,29,8,13,29,58,0 days 00:00:00.449764
lra/mackup,1,,8,4,3,53,61,0 days 00:00:00.228975
keycloak/keycloak,1,,16,3,7,21,37,0 days 00:00:53.176611
casbin/casbin,1,v,68,52,5,118,186,0 days 00:00:00.802565
aquasecurity/trivy,1,v,28,19,2,59,87,0 days 00:00:13.629502
oliver-moran/jimp,2, v,15,8,4,71,86,0 days 00:00:04.773032
foambubble/foam,1,v,17,10,3,44,61,0 days 00:00:01.562181
arut/nginx-rtmp-module,1,v,12,5,3,100,112,0 days 00:00:00.335397
Miserlou/Zappa,2, v,50,42,3,71,121,0 days 00:00:02.159623
Delgan/loguru,1,,6,1,4,12,18,0 days 00:00:00.372363
react-dates/react-dates,1,v,78,74,1,81,159,0 days 00:00:02.203288
carloscuesta/gitmoji,1,v,13,5,2,5,18,0 days 00:00:00.624423
roots/sage,2, v,27,10,12,35,62,0 days 00:00:01.546093
webpack-contrib/webpack-bundle-analyzer,1,v,32,19,8,34,66,0 days 00:00:01.870858
http-party/http-server,2, v,15,2,10,30,45,0 days 00:00:00.604444
tabler/tabler-icons,1,v,69,65,2,15,84,0 days 00:00:36.774946
aurelia/framework,1,,23,16,5,32,55,0 days 00:00:00.874692
Tonejs/Tone.js,2, r,12,1,8,4,16,0 days 00:00:05.367758
jaredreich/pell,1,v,6,4,1,6,12,0 days 00:00:00.146147
Tamsiree/RxTool,2, v,15,7,4,177,192,0 days 00:00:01.651669
karma-runner/karma,2, v,35,14,12,198,233,0 days 00:00:02.614643
openshift/origin,1,v,14,2,10,25,39,0 days 00:08:10.759629
FaridSafi/react-native-gifted-chat,2, v,16,6,7,46,62,0 days 00:00:01.324823
ramsey/uuid,1,,26,6,14,37,63,0 days 00:00:01.231187
mamedev/mame,1,mame,124,89,11,0,124,0 days 00:23:23.079679
flairNLP/flair,1,v,11,1,6,12,23,0 days 00:00:01.609237
apache/druid,1,druid-,18,1,13,366,384,0 days 00:00:36.218940
segmentio/evergreen,1,v,51,39,2,84,135,0 days 00:00:05.272460
ben-manes/caffeine,2, v,16,4,7,45,61,0 days 00:00:04.447325
ranger/ranger,1,v,10,1,8,31,41,0 days 00:00:01.063521
emirpasic/gods,1,v,19,14,3,6,25,0 days 00:00:00.634540
mikepenz/MaterialDrawer,1,v,35,19,8,166,201,0 days 00:00:01.728828
AdguardTeam/AdGuardHome,1,v,19,6,4,31,50,0 days 00:00:06.151236
LuckSiege/PictureSelector,2,v. v,12,6,5,91,103,0 days 00:00:01.762104
NetEase/pomelo,2, v,9,1,4,84,93,0 days 00:00:00.355030
PuerkitoBio/goquery,1,v,12,1,8,10,22,0 days 00:00:00.172723
QL-Win/QuickLook,2, v,4,1,1,38,42,0 days 00:00:01.192124
go-chi/chi,1,v,12,1,5,27,39,0 days 00:00:00.320682
thingsboard/thingsboard,1,v,15,2,7,33,48,0 days 00:00:14.484886
nock/nock,2, v,125,108,13,181,306,0 days 00:00:07.442938
koekeishiya/yabai,1,v,12,5,1,34,46,0 days 00:00:01.075534
d2-projects/d2-admin,2, v,25,17,4,62,87,0 days 00:00:02.560846
apexcharts/apexcharts.js,2, v,32,15,3,54,86,0 days 00:00:13.060507
microsoft/nni,1,v,27,9,2,16,43,0 days 00:00:13.776507
sindresorhus/got,1,v,70,49,11,71,141,0 days 00:00:01.332125
netchx/netch,2, v,6,1,3,47,53,0 days 00:00:00.865395
spicetify/spicetify-cli,2,v. v,23,14,5,52,75,0 days 00:00:01.621380
meolu/walle-web,1,v,13,8,1,6,19,0 days 00:00:01.775617
mifi/lossless-cut,1,v,70,52,9,67,137,0 days 00:00:04.003699
rjsf-team/react-jsonschema-form,1,v,71,56,6,52,123,0 days 00:00:12.274050
rizinorg/cutter,1,v,14,6,5,16,30,0 days 00:00:02.408484
hotwired/stimulus,1,v,12,5,4,14,26,0 days 00:00:00.780001
slimphp/Slim,1,,40,11,21,55,95,0 days 00:00:02.185811
graphile/postgraphile,1,v,35,20,7,60,95,0 days 00:00:03.839303
nexe/nexe,1,v,5,2,1,14,19,0 days 00:00:00.495865
wenzhixin/bootstrap-table,1,,18,3,9,39,57,0 days 00:00:06.585354
bettercap/bettercap,1,v,33,23,5,10,43,0 days 00:00:11.538228
mlflow/mlflow,2, v,35,21,1,20,55,0 days 00:01:23.704768
cloudwu/skynet,1,v,15,7,6,18,33,0 days 00:00:01.684635
java-decompiler/jd-gui,1,v,7,5,1,11,18,0 days 00:00:00.679381
antvis/G2,2, v,13,2,8,144,157,0 days 00:00:02.857805
searx/searx,2, v,14,1,12,3,17,0 days 00:00:05.852410
RPCS3/rpcs3,1,v,5,1,3,21,26,0 days 00:00:11.261190
pagehelper/Mybatis-PageHelper,1,v,18,9,6,42,60,0 days 00:00:00.806538
conventional-changelog/commitlint,1,v,47,28,10,89,136,0 days 00:00:03.826850
single-spa/single-spa,2, v,29,15,10,85,114,0 days 00:00:00.907025
micro/micro,2, v,62,46,2,37,99,0 days 00:00:05.544079
OpenAPITools/openapi-generator,2, v,16,2,11,38,54,0 days 00:01:55.910653
PHPOffice/PhpSpreadsheet,1,,24,6,7,10,34,0 days 00:00:10.688539
davisking/dlib,1,v,55,14,13,0,55,0 days 00:00:14.570211
FriendsOfPHP/PHP-CS-Fixer,1,v,48,26,14,148,196,0 days 00:00:07.020346
ccampbell/mousetrap,1,,7,1,5,21,28,0 days 00:00:00.115067
nightwatchjs/nightwatch,1,v,16,1,9,207,223,0 days 00:00:01.879663
google/brotli,1,v,6,1,4,10,16,0 days 00:00:01.742351
argoproj/argo-workflows,2, v,23,7,9,102,125,0 days 00:00:17.314384
mail-in-a-box/mailinabox,1,v,45,16,11,0,45,0 days 00:00:01.350082
jquery/jquery-ui,1,,8,1,6,38,46,0 days 00:00:05.567104
ajv-validator/ajv,2, v,71,54,6,89,160,0 days 00:00:01.968125
SFTtech/openage,1,v,5,2,2,4,9,0 days 00:00:01.252647
allenai/allennlp,2, v,24,7,5,23,47,0 days 00:00:04.205875
containerd/containerd,2, v,9,1,7,76,85,0 days 00:00:24.660824
baidu/amis,1,,9,5,2,37,46,0 days 00:00:07.455122
keeweb/keeweb,1,v,25,10,9,103,128,0 days 00:00:03.986282
stylus/stylus,1,,53,34,11,115,168,0 days 00:00:01.809867
beetbox/beets,1,v,6,1,4,30,36,0 days 00:00:01.686434
nats-io/nats-server,1,v,17,2,12,49,66,0 days 00:00:06.796296
jonas/tig,1,tig-,27,6,19,22,49,0 days 00:00:02.076785
tomnomnom/gron,2, v,7,2,2,27,34,0 days 00:00:00.093104
WickyNilliams/headroom.js,1,v,9,1,5,8,17,0 days 00:00:00.147440
dgraph-io/badger,1,v,14,6,7,20,34,0 days 00:00:01.193026
containrrr/watchtower,1,v,8,1,5,24,32,0 days 00:00:00.302595
kubernetes/dashboard,1,v,15,1,10,20,35,0 days 00:00:50.752674
mobile-shell/mosh,1,mosh-,4,2,1,10,14,0 days 00:00:00.277333
doctrine/inflector,2, v,6,1,4,10,16,0 days 00:00:00.114931
SpartnerNL/Laravel-Excel,2, v,11,3,6,143,154,0 days 00:00:00.571561
Kotlin/kotlinx.coroutines,1,,24,11,6,38,62,0 days 00:00:04.410793
ent/ent,1,v,10,3,4,21,31,0 days 00:00:10.875348
networkx/networkx,1,networkx-,37,7,25,10,47,0 days 00:00:07.465961
wbkd/react-flow,2, v,56,52,2,118,174,0 days 00:00:07.508666
summernote/summernote,1,v,8,2,2,52,60,0 days 00:00:00.778426
javve/list.js,2, v,11,4,5,10,21,0 days 00:00:00.505320
lokesh/color-thief,2, v,5,1,2,6,11,0 days 00:00:00.156085
GoogleChrome/workbox,1,v,24,10,7,38,62,0 days 00:00:05.818499
ansible/awx,1,,36,18,3,20,56,0 days 00:00:35.220824
browserslist/browserslist,1,,49,24,11,119,168,0 days 00:00:01.407386
video-dev/hls.js,1,v,16,2,9,185,201,0 days 00:01:26.365514
jxnblk/mdx-deck,1,v,21,16,2,91,112,0 days 00:00:01.431123
Rapptz/discord.py,1,v,24,15,6,41,65,0 days 00:00:02.321195
fengyuanchen/cropperjs,1,v,14,6,4,40,54,0 days 00:00:01.870184
downshift-js/downshift,1,v,49,38,4,179,228,0 days 00:00:01.185365
casesandberg/react-color,2, v,14,8,5,23,37,0 days 00:00:02.358365
lingochamp/FileDownloader,1,v,11,4,4,56,67,0 days 00:00:00.587235
tymondesigns/jwt-auth,1,,6,3,2,29,35,0 days 00:00:00.226412
App-vNext/Polly,2, v,7,3,2,4,11,0 days 00:00:00.535393
swaywm/sway,1,,22,7,8,7,29,0 days 00:00:03.015797
polybar/polybar,1,,20,12,7,84,104,0 days 00:00:01.447910
mholt/PapaParse,1,,19,5,7,55,74,0 days 00:00:00.338544
ionic-team/stencil,1,v,53,40,2,189,242,0 days 00:00:09.839063
go-playground/validator,1,v,94,69,10,59,153,0 days 00:00:02.296041
star7th/showdoc,2, v,18,6,6,124,142,0 days 00:00:03.167442
spatie/laravel-permission,1,,87,61,11,71,158,0 days 00:00:01.079721
VSCodeVim/Vim,2, v,38,19,6,187,225,0 days 00:00:05.634787
rqlite/rqlite,1,v,56,37,8,39,95,0 days 00:00:02.053982
apache/pulsar,1,v,14,1,10,37,51,0 days 00:00:42.998542
PatrickJS/angular-starter,2, v,6,4,1,5,11,0 days 00:00:00.196857
restify/node-restify,2, v,44,27,13,96,140,0 days 00:00:01.594521
akiran/react-slick,2, v,13,3,8,27,40,0 days 00:00:00.442168
avwo/whistle,1,v,31,12,10,342,373,0 days 00:00:06.556942
dbcli/pgcli,2, v,39,16,10,47,86,0 days 00:00:01.697423
abseil/abseil-cpp,1,,17,5,9,0,17,0 days 00:00:05.670949
peers/peerjs,2, v,6,1,4,30,36,0 days 00:00:02.078302
netbox-community/netbox,2, v,24,6,13,173,197,0 days 00:00:07.839005
dbcli/mycli,1,v,26,8,10,20,46,0 days 00:00:00.662987
milvus-io/milvus,1,v,9,3,3,15,24,0 days 00:00:11.649249
dangrossman/daterangepicker,2, v,5,1,3,58,63,0 days 00:00:00.163027
luin/ioredis,2, v,54,33,11,132,186,0 days 00:00:02.035383
dotnet/AspNetCore.Docs,1,,40,33,1,0,40,0 days 00:00:26.782560
TypeStrong/ts-node,1,v,52,29,9,83,135,0 days 00:00:01.599614
jina-ai/clip-as-service,1,v,15,11,2,92,107,0 days 00:00:00.518036
tidwall/gjson,1,v,15,5,6,42,57,0 days 00:00:00.249413
styleguidist/react-styleguidist,2, v,47,30,7,215,262,0 days 00:00:04.644542
imakewebthings/waypoints,2, v,6,1,4,17,23,0 days 00:00:00.190091
redis/redis-py,2, v,15,2,9,49,64,0 days 00:00:01.094472
okonet/lint-staged,2, v,44,23,7,145,189,0 days 00:00:01.177755
GoogleContainerTools/kaniko,1,v,33,19,4,4,37,0 days 00:00:29.562793
golangci/golangci-lint,1,v,47,31,1,63,110,0 days 00:00:14.789606
reactstrap/reactstrap,2, v,61,45,7,54,115,0 days 00:00:02.803598
thanos-io/thanos,1,v,26,7,2,17,43,0 days 00:00:31.990147
git-lfs/git-lfs,2, v,29,3,19,60,89,0 days 00:00:10.351476
aspnetboilerplate/aspnetboilerplate,3, v. v,91,57,7,125,216,0 days 00:00:11.101043
PrismJS/prism,2, v,29,8,11,11,40,0 days 00:00:04.423075
snabbdom/snabbdom,1,v,14,3,6,33,47,0 days 00:00:01.469254
debug-js/debug,1,,22,7,8,47,69,0 days 00:00:00.197994
lucidrains/vit-pytorch,1,,32,27,1,105,137,0 days 00:00:00.443726
pagekit/vue-resource,1,,12,5,4,41,53,0 days 00:00:00.420853
shipshapecode/shepherd,1,v,46,28,9,73,119,0 days 00:00:02.778230
AppIntro/AppIntro,2, v,10,1,8,8,18,0 days 00:00:01.261670
jantimon/html-webpack-plugin,2, v,47,34,10,36,83,0 days 00:00:01.196607
ant-design/ant-design-mobile,2, v,28,19,4,107,135,0 days 00:00:05.148193
mailhog/MailHog,2, v,10,7,2,16,26,0 days 00:00:00.459363
vercel/micro,2, v,21,13,5,34,55,0 days 00:00:00.461585
react-static/react-static,1,v,28,20,5,162,190,0 days 00:00:02.742689
SpacehuhnTech/esp8266_deauther,3, v. v,10,5,3,3,13,0 days 00:00:01.577305
cyclejs/cyclejs,1,v,32,27,1,50,82,0 days 00:00:03.464371
serbanghita/Mobile-Detect,1,,6,2,3,64,70,0 days 00:00:00.327348
clauderic/react-sortable-hoc,1,v,20,14,3,52,72,0 days 00:00:00.597092
samuelcolvin/pydantic,2,V v,42,30,6,37,79,0 days 00:00:01.688798
tinygo-org/tinygo,1,v,23,9,3,4,27,0 days 00:00:02.993741
h2o/h2o,1,v,12,3,2,32,44,0 days 00:00:06.048831
haltu/muuri,1,,9,1,5,14,23,0 days 00:00:01.570908
plouc/nivo,1,v,67,56,7,45,112,0 days 00:00:15.485175
atomiks/tippyjs,2, v,27,20,5,65,92,0 days 00:00:03.972427
FredrikNoren/ungit,2, v,16,9,6,126,142,0 days 00:00:05.084252
spencermountain/compromise,2, v,70,45,12,148,218,0 days 00:00:20.928950
HandBrake/HandBrake,1,,8,1,6,35,43,0 days 00:00:18.188822
typesense/typesense,2, v,16,5,5,8,24,0 days 00:00:02.087437
qrohlf/trianglify,1,v,12,1,8,8,20,0 days 00:00:00.421080
jacomyal/sigma.js,1,v,7,1,3,8,15,0 days 00:00:02.626324
spotify/annoy,3, v. v,9,1,4,15,24,0 days 00:00:00.195981
kubernetes-sigs/kind,2, v,14,2,6,10,24,0 days 00:00:04.098080
Ciphey/Ciphey,2, v,18,15,1,8,26,0 days 00:00:00.555110
bitwarden/server,2, v,49,31,4,58,107,0 days 00:00:06.564938
zricethezav/gitleaks,1,v,60,47,5,62,122,0 days 00:00:03.408114
nhn/tui.calendar,1,v,21,13,3,42,63,0 days 00:00:11.554558
w7corp/easywechat,1,,47,25,16,241,288,0 days 00:00:01.697549
frida/frida,1,,54,30,10,579,633,0 days 00:00:01.944289
apple/darwin-xnu,1,xnu-,19,16,2,104,123,0 days 00:00:24.638353
NaturalNode/natural,2, v,6,2,3,44,50,0 days 00:00:00.464714
socketio/socket.io-client,1,,28,2,16,97,125,0 days 00:00:02.480952
coryhouse/react-slingshot,2, v,8,3,2,7,15,0 days 00:00:00.358542
dask/dask,1,,97,59,9,141,238,0 days 00:00:19.198170
immerjs/immer,2, v,35,23,5,94,129,0 days 00:00:01.314499
squidfunk/mkdocs-material,1,,52,34,6,192,244,0 days 00:00:11.525151
tj/commander.js,2, v,50,19,18,38,88,0 days 00:00:01.763283
dromara/hutool,1,,11,1,6,102,113,0 days 00:00:02.912040
python-pillow/Pillow,1,,39,1,35,35,74,0 days 00:00:11.727286
visgl/deck.gl,2, v,32,8,11,250,282,0 days 00:00:17.798440
jesseduffield/lazydocker,1,v,18,11,5,27,45,0 days 00:00:05.317317
doczjs/docz,1,v,19,13,5,66,85,0 days 00:00:03.241904
dmlc/xgboost,2, v,21,1,14,12,33,0 days 00:00:05.469970
labstack/echo,2, v,20,3,10,75,95,0 days 00:00:00.930285
vuejs/devtools,1,v,10,4,4,36,46,0 days 00:00:01.255205
halo-dev/halo,1,v,10,2,5,42,52,0 days 00:00:05.586919
react-native-elements/react-native-elements,2, v,30,18,5,52,82,0 days 00:00:03.669455
lovell/sharp,1,v,30,4,16,88,118,0 days 00:00:02.493778
alibaba/nacos,2, v,16,9,6,15,31,0 days 00:00:15.468587
pure-css/pure,1,v,9,1,7,14,23,0 days 00:00:00.511162
rook/rook,1,v,19,1,16,103,122,0 days 00:00:11.392145
files-community/Files,1,v,23,18,4,38,61,0 days 00:00:11.842173
redux-saga/redux-saga,2, v,18,9,5,40,58,0 days 00:00:01.680326
frappe/erpnext,2, v,153,136,7,763,916,0 days 00:02:51.461115
seata/seata,3, V v,15,6,3,18,33,0 days 00:00:05.730398
reduxjs/react-redux,1,v,26,17,6,59,85,0 days 00:00:01.221303
t4t5/sweetalert,2, v,9,2,3,23,32,0 days 00:00:00.340733
ovity/octotree,1,v,5,1,3,26,31,0 days 00:00:00.421263
ramda/ramda,2, v,28,13,9,26,54,0 days 00:00:03.049298
sampotts/plyr,1,v,16,6,7,195,211,0 days 00:00:04.147257
appwrite/appwrite,1,,13,1,3,30,43,0 days 00:00:16.593684
angular/components,1,,31,13,7,128,159,0 days 00:00:30.175531
dimsemenov/PhotoSwipe,1,v,5,1,2,43,48,0 days 00:00:03.317587
guzzle/guzzle,2, v,37,16,14,96,133,0 days 00:00:03.764230
inconshreveable/ngrok,1,,20,18,1,1,21,0 days 00:00:00.334273
github/hub,1,v,29,14,10,59,88,0 days 00:00:02.918351
facebook/draft-js,2, v,11,7,3,16,27,0 days 00:00:01.391078
feathericons/feather,1,v,39,28,3,12,51,0 days 00:00:02.400682
helm/helm,2, v,32,8,12,68,100,0 days 00:00:05.766466
httpie/httpie,1,,19,2,12,28,47,0 days 00:00:01.004013
fabricjs/fabric.js,2, v,34,10,14,69,103,0 days 00:00:09.537211
vega/vega,1,v,45,20,15,73,118,0 days 00:00:51.370935
ehang-io/nps,3,V v. v,19,14,1,44,63,0 days 00:00:00.938122
usablica/intro.js,2, v,29,5,13,12,41,0 days 00:00:03.037895
bevacqua/dragula,2, v,18,14,1,49,67,0 days 00:00:00.315726
openfaas/faas,2, v,18,9,7,110,128,0 days 00:00:05.082759
vercel/pkg,1,,15,7,5,42,57,0 days 00:00:02.155686
bilibili/flv.js,1,v,7,1,4,8,15,0 days 00:00:00.464843
mochajs/mocha,2, v,65,28,15,110,175,0 days 00:00:07.283894
paularmstrong/normalizr,2, v,16,7,5,18,34,0 days 00:00:00.478829
conwnet/github1s,1,v,7,4,1,19,26,0 days 00:00:01.075794
qishibo/AnotherRedisDesktopManager,2, v,6,1,3,34,40,0 days 00:00:00.489711
chenglou/react-motion,1,v,5,1,2,19,24,0 days 00:00:01.269033
jlmakes/scrollreveal,1,v,10,3,5,36,46,0 days 00:00:00.211255
docsifyjs/docsify,1,v,44,35,6,147,191,0 days 00:00:02.605147
react-bootstrap/react-bootstrap,2, v,44,24,10,108,152,0 days 00:00:04.955723
slidevjs/slidev,1,v,31,27,1,143,174,0 days 00:00:01.248733
sirupsen/logrus,2, v,20,6,8,35,55,0 days 00:00:00.410964
rollup/rollup,1,v,169,157,3,411,580,0 days 00:00:19.577891
emberjs/ember.js,1,v,68,20,4,184,252,0 days 00:00:27.515559
yeasy/docker_practice,1,v,13,1,9,0,13,0 days 00:00:00.938558
localForage/localForage,1,,19,10,7,43,62,0 days 00:00:00.837183
michalsnik/aos,2, v,11,4,4,24,35,0 days 00:00:00.191689
vuejs/vuepress,1,v,24,14,5,50,74,0 days 00:00:01.462867
nicolargo/glances,1,v,22,2,15,70,92,0 days 00:00:03.541180
postcss/autoprefixer,1,,53,27,14,133,186,0 days 00:00:02.474052
uglide/RedisDesktopManager,1,,33,19,4,38,71,0 days 00:00:09.209727
homebridge/homebridge,2, v,6,1,4,51,57,0 days 00:00:00.548238
petkaantonov/bluebird,1,v,24,11,7,115,139,0 days 00:00:03.147086
microsoft/cascadia-code,1,v,18,8,3,0,18,0 days 00:00:14.696390
necolas/react-native-web,1,,17,6,7,242,259,0 days 00:00:03.376169
python-poetry/poetry,1,,14,10,3,63,77,0 days 00:00:01.266772
avajs/ava,1,v,54,37,4,23,77,0 days 00:00:03.862512
eslint/eslint,1,v,164,153,3,103,267,0 days 00:00:35.345415
Seldaek/monolog,1,,36,9,21,26,62,0 days 00:00:02.002299
open-mmlab/mmdetection,1,v,29,26,1,6,35,0 days 00:00:09.359593
validatorjs/validator.js,2, v,107,79,8,43,150,0 days 00:00:02.223551
mozilla/DeepSpeech,1,v,9,1,6,13,22,0 days 00:00:04.494220
electron-react-boilerplate/electron-react-boilerplate,1,v,32,13,10,31,63,0 days 00:00:02.474772
marmelab/react-admin,1,v,46,32,4,168,214,0 days 00:00:10.897505
schollz/croc,1,v,31,15,6,106,137,0 days 00:00:16.006603
youzan/vant,1,v,33,13,6,377,410,0 days 00:00:08.364077
zyedidia/micro,1,v,6,1,3,22,28,0 days 00:00:01.048334
js-cookie/js-cookie,1,v,10,1,7,13,23,0 days 00:00:00.263756
ShareX/ShareX,1,v,50,24,11,22,72,0 days 00:00:50.030998
spf13/viper,1,v,13,2,8,13,26,0 days 00:00:00.370166
swagger-api/swagger-ui,3, v/ v,69,51,10,189,258,0 days 00:02:04.571874
parse-community/parse-server,1,,34,15,12,111,145,0 days 00:00:08.348450
celery/celery,2, v,22,3,17,143,165,0 days 00:00:06.060834
apache/skywalking,1,v,20,4,6,11,31,0 days 00:00:18.761739
benweet/stackedit,1,v,23,17,4,104,127,0 days 00:00:09.239902
freebsd/freebsd-src,1,release/,62,3,58,16,78,0 days 00:28:25.892873
TeamNewPipe/NewPipe,2, v,17,3,10,100,117,0 days 00:00:05.709321
felixrieseberg/windows95,1,v,11,4,5,3,14,0 days 00:00:00.941004
afollestad/material-dialogs,3, v. v,20,12,3,98,118,0 days 00:00:02.494193
alibaba/Sentinel,2, v,8,2,3,16,24,0 days 00:00:02.052753
signalapp/Signal-Android,3, v. v,180,163,8,860,1040,0 days 00:02:30.962685
segmentio/nightmare,1,,21,9,4,67,88,0 days 00:00:00.407690
codex-team/editor.js,2, v,11,3,5,16,27,0 days 00:00:00.968177
eligrey/FileSaver.js,2, v,3,1,1,12,15,0 days 00:00:00.063872
taichi-dev/taichi,2, v,7,1,3,96,103,0 days 00:00:01.648762
locustio/locust,2, v,27,9,10,56,83,0 days 00:00:01.748650
winstonjs/winston,2, v,24,6,13,62,86,0 days 00:00:00.683436
StevenBlack/hosts,2, v,24,10,7,405,429,0 days 00:02:07.397388
streamlit/streamlit,2, v,83,79,1,46,129,0 days 00:00:26.305919
vuejs/vue-router,1,v,19,9,5,59,78,0 days 00:00:01.399649
Popmotion/popmotion,2, v,21,14,5,131,152,0 days 00:00:01.732529
osquery/osquery,2, v,39,13,12,80,119,0 days 00:00:10.304697
python-telegram-bot/python-telegram-bot,3, V v,49,27,8,39,88,0 days 00:00:06.229778
graphql/graphql-js,2, v,34,12,13,88,122,0 days 00:00:07.706479
reduxjs/reselect,1,v,11,6,4,14,25,0 days 00:00:00.313681
zhongyang219/TrafficMonitor,1,V,18,8,6,4,22,0 days 00:00:01.409906
chalk/chalk,1,v,16,3,8,16,32,0 days 00:00:00.228786
telegramdesktop/tdesktop,1,v,34,11,15,542,576,0 days 00:00:10.974179
DrKLO/Telegram,1,release-,47,40,1,37,84,0 days 00:01:46.375923
vadimdemedes/ink,1,v,16,6,6,23,39,0 days 00:00:00.335821
sideway/joi,2, v,92,63,11,135,227,0 days 00:00:05.503532
jumpserver/jumpserver,2, v,31,24,5,103,134,0 days 00:00:06.862984
solidjs/solid,1,v,27,16,2,137,164,0 days 00:00:03.407861
urfave/cli,1,v,33,20,8,34,67,0 days 00:00:01.028856
PyTorchLightning/pytorch-lightning,1,,16,3,4,98,114,0 days 00:00:07.424435
mingrammer/diagrams,1,v,20,14,3,16,36,0 days 00:00:01.267767
recharts/recharts,1,v,26,13,6,93,119,0 days 00:00:01.781445
google/ExoPlayer,1,r,20,1,14,84,104,0 days 00:00:33.799872
Baseflow/PhotoView,2, v,8,2,4,12,20,0 days 00:00:00.299175
pbatard/rufus,1,v,42,11,15,28,70,0 days 00:00:10.860734
websockets/ws,2, v,40,13,11,114,154,0 days 00:00:01.116705
OpenZeppelin/openzeppelin-contracts,1,v,30,10,5,22,52,0 days 00:00:06.619974
wenyan-lang/wenyan,1,v,3,1,1,12,15,0 days 00:00:00.942206
jhipster/generator-jhipster,1,v,110,89,5,114,224,0 days 00:00:34.224469
appsmithorg/appsmith,3, v. v,13,7,3,129,142,0 days 00:00:05.703448
iawia002/lux,2, v,15,7,5,59,74,0 days 00:00:00.986929
philc/vimium,2, v,11,2,5,17,28,0 days 00:00:00.974464
lensapp/lens,1,v,19,6,6,56,75,0 days 00:00:07.262477
eggjs/egg,1,,70,51,10,43,113,0 days 00:00:03.313816
go-kratos/kratos,1,v,11,2,7,21,32,0 days 00:00:03.361048
mpv-player/mpv,1,v,34,10,8,46,80,0 days 00:00:20.382516
valyala/fasthttp,1,v,43,27,4,3,46,0 days 00:00:02.473337
quii/learn-go-with-tests,2, v,22,13,5,27,49,0 days 00:00:00.753619
svg/svgo,2, v,20,8,11,66,86,0 days 00:00:01.336845
magenta/magenta,2, v,7,1,3,42,49,0 days 00:00:01.979599
aseprite/aseprite,2, v,9,1,7,84,93,0 days 00:00:05.589372
dapr/dapr,1,v,19,9,1,23,42,0 days 00:00:20.163085
typicode/lowdb,1,v,21,8,9,36,57,0 days 00:00:00.614081
react-dnd/react-dnd,2, v,45,25,10,100,145,0 days 00:00:12.482646
vnpy/vnpy,2, v,22,6,7,28,50,0 days 00:00:41.678784
dgraph-io/dgraph,1,v,13,1,9,60,73,0 days 00:00:28.894279
flameshot-org/flameshot,1,v,11,3,6,30,41,0 days 00:00:02.745188
NickeManarin/ScreenToGif,1,,37,16,7,43,80,0 days 00:00:15.357657
SortableJS/Vue.Draggable,2,v. v,24,13,6,25,49,0 days 00:00:06.236110
google/or-tools,1,v,32,7,8,3,35,0 days 00:16:23.873061
facebook/flux,1,,4,1,2,9,13,0 days 00:00:00.338301
nosir/cleave.js,1,v,9,2,5,57,66,0 days 00:00:01.257684
freqtrade/freqtrade,1,,44,35,3,14,58,0 days 00:00:19.669891
mybatis/mybatis-3,1,mybatis-,5,1,3,32,37,0 days 00:00:03.993322
TanStack/table,1,v,36,24,6,86,122,0 days 00:00:07.284816
mysqljs/mysql,1,v,28,10,9,26,54,0 days 00:00:00.967454
jquense/yup,1,v,27,12,8,67,94,0 days 00:00:01.077630
pmndrs/zustand,1,v,13,4,6,56,69,0 days 00:00:00.719652
alibaba/ice,3, V v,23,17,1,57,80,0 days 00:00:08.058277
linlinjava/litemall,1,v,19,10,2,3,22,0 days 00:00:11.062913
Molunerfinn/PicGo,1,v,11,4,5,21,32,0 days 00:00:00.753416
facebookresearch/fairseq,1,v,8,1,4,6,14,0 days 00:00:01.503698
pubkey/rxdb,1,,58,43,2,55,113,0 days 00:00:53.563776
ai/nanoid,1,,12,5,4,73,85,0 days 00:00:00.547115
badges/shields,1,,8,3,4,3,11,0 days 00:00:03.022825
oldj/SwitchHosts,1,v,9,2,5,36,45,0 days 00:00:03.939697
cookiecutter/cookiecutter,1,,14,3,7,15,29,0 days 00:00:00.550219
Redocly/redoc,1,v,39,33,1,56,95,0 days 00:00:49.085396
nostra13/Android-Universal-Image-Loader,1,v,3,1,1,12,15,0 days 00:00:00.342014
remix-run/remix,1,v,27,22,1,61,88,0 days 00:00:05.557295
arendst/Tasmota,1,v,35,14,7,58,93,0 days 00:01:15.107507
less/less.js,1,v,26,8,13,42,68,0 days 00:00:06.499610
brettwooldridge/HikariCP,1,HikariCP-,17,2,10,82,99,0 days 00:00:01.129888
defunkt/jquery-pjax,2, v,12,6,3,15,27,0 days 00:00:00.320705
eclipse-theia/theia,2, v,43,36,2,33,76,0 days 00:00:24.470247
fingerprintjs/fingerprintjs,2, v,23,11,7,50,73,0 days 00:00:00.659854
gorilla/mux,1,v,8,1,5,6,14,0 days 00:00:00.173670
bazelbuild/bazel,1,,47,30,8,56,103,0 days 00:02:05.503620
ag-grid/ag-grid,2, v,87,62,5,103,190,0 days 00:17:40.132506
handlebars-lang/handlebars.js,2, v,14,5,6,56,70,0 days 00:00:00.706673
zloirock/core-js,2, v,41,26,7,156,197,0 days 00:00:10.930074
wekan/wekan,2, v,610,607,2,27,637,0 days 00:01:51.439121
restic/restic,1,v,13,2,7,18,31,0 days 00:00:42.750433
facebook/fresco,1,v,35,14,13,12,47,0 days 00:00:44.688663
dropzone/dropzone,1,v,32,15,12,83,115,0 days 00:00:01.345145
testing-library/react-testing-library,1,v,57,43,2,110,167,0 days 00:00:00.648086
derailed/k9s,2, v,25,17,2,155,180,0 days 00:00:02.237847
grafana/k6,1,v,36,12,6,36,72,0 days 00:00:15.187882
twitter/typeahead.js,1,v,4,1,2,11,15,0 days 00:00:00.293642
GoogleChromeLabs/squoosh,1,v,10,4,5,17,27,0 days 00:00:01.434349
monicahq/monica,1,v,47,32,4,39,86,0 days 00:00:40.342505
jamiebuilds/react-loadable,1,v,13,8,3,16,29,0 days 00:00:00.213323
Tencent/tinker,1,v,7,3,2,46,53,0 days 00:00:00.661600
responsively-org/responsively-app,1,v,18,14,3,10,28,0 days 00:00:12.173338
framework7io/framework7,1,v,43,19,11,172,215,0 days 00:00:42.913554
nfl/react-helmet,1,,15,5,4,18,33,0 days 00:00:00.501294
joewalnes/websocketd,1,v,11,3,2,15,26,0 days 00:00:00.082025
plotly/dash,1,v,42,29,3,33,75,0 days 00:00:38.928317
hubotio/hubot,1,v,26,7,12,68,94,0 days 00:00:00.554363
gchq/CyberChef,1,v,119,106,4,273,392,0 days 00:00:10.892573
aFarkas/lazysizes,1,,21,10,7,45,66,0 days 00:00:00.751836
nginx/nginx,1,release-,32,10,20,516,548,0 days 00:00:05.580430
sanic-org/sanic,2, v,21,2,13,49,70,0 days 00:00:01.700305
matryer/xbar,2, v,9,5,2,5,14,0 days 00:00:00.329067
zadam/trilium,2, v,14,11,1,134,148,0 days 00:00:06.120090
nondanee/UnblockNeteaseMusic,1,v,23,17,1,34,57,0 days 00:00:00.266077
ionic-team/ionicons,2, v,21,9,10,51,72,0 days 00:00:06.300873
bokeh/bokeh,1,,23,1,14,50,73,0 days 00:00:23.150394
v2fly/v2ray-core,1,v,185,168,4,217,402,0 days 00:00:14.194756
jsdom/jsdom,2, v,98,67,9,144,242,0 days 00:02:12.912133
trojan-gfw/trojan,1,v,24,15,4,19,43,0 days 00:00:00.391774
visionmedia/superagent,2, v,50,23,13,84,134,0 days 00:00:01.335555
youzan/vant-weapp,1,v,16,7,4,91,107,0 days 00:00:01.991942
filebrowser/filebrowser,1,v,34,23,6,62,96,0 days 00:00:01.895044
uber-go/zap,1,v,22,11,8,6,28,0 days 00:00:00.516241
EastWorld/wechat-app-mall,2, v,14,6,4,8,22,0 days 00:00:00.883921
knex/knex,2, v,25,2,17,146,171,0 days 00:00:04.615057
notepad-plus-plus/notepad-plus-plus,2, v,42,8,11,159,201,0 days 00:00:27.164267
jaegertracing/jaeger,1,v,40,24,3,13,53,0 days 00:00:05.172219
react-grid-layout/react-grid-layout,2, v,22,9,8,86,108,0 days 00:00:01.710946
radareorg/radare2,2, release-,42,22,6,43,85,0 days 00:00:52.248593
wagerfield/parallax,1,v,6,2,2,5,11,0 days 00:00:00.247616
briannesbitt/Carbon,1,,99,80,7,79,178,0 days 00:00:15.466606
oblador/react-native-vector-icons,1,v,37,14,10,42,79,0 days 00:00:02.564204
spotify/luigi,2, v,13,4,7,46,59,0 days 00:00:02.143502
buger/goreplay,2, v,18,5,10,23,41,0 days 00:00:03.662428
semantic-release/semantic-release,2, v,62,48,9,206,268,0 days 00:00:01.589074
ustbhuangyi/better-scroll,3, v. v,17,6,4,41,58,0 days 00:00:06.006586
handsontable/handsontable,2, v,62,27,14,117,179,0 days 00:01:55.924196
nikic/PHP-Parser,1,v,24,7,12,41,65,0 days 00:00:02.482535
outline/outline,2, v,64,54,1,39,103,0 days 00:00:10.906212
motdotla/dotenv,1,v,33,17,11,26,59,0 days 00:00:01.241704
jasmine/jasmine,1,v,28,5,17,29,57,0 days 00:00:03.078540
JedWatson/classnames,1,v,4,1,2,16,20,0 days 00:00:00.065356
jhao104/proxy_pool,1,,10,1,6,2,12,0 days 00:00:00.176993
infernojs/inferno,2, v,38,29,6,160,198,0 days 00:00:04.007021
janl/mustache.js,2, v,20,6,12,23,43,0 days 00:00:00.512305
wulkano/Kap,1,v,13,2,5,14,27,0 days 00:00:01.183624
auth0/node-jsonwebtoken,1,v,29,13,9,42,71,0 days 00:00:00.262511
airbnb/visx,1,v,29,25,1,200,229,0 days 00:00:02.890458
teambit/bit,1,v,18,7,5,121,139,0 days 00:00:04.537716
facebook/yoga,2, v,19,6,8,23,42,0 days 00:00:04.704739
tailwindlabs/heroicons,1,v,4,1,2,15,19,0 days 00:00:00.648720
huiyadanli/RevokeMsgPatcher,1,,15,6,3,0,15,0 days 00:00:00.380821
catchorg/Catch2,3,V v. v,24,7,7,62,86,0 days 00:00:04.370201
bower/bower,2, v,18,8,4,83,101,0 days 00:00:00.981745
cool-RR/PySnooper,1,,7,1,5,10,17,0 days 00:00:00.140965
cocos2d/cocos2d-x,1,cocos2d-x-,20,2,8,17,37,0 days 00:01:15.340996
KaTeX/KaTeX,1,v,15,3,10,41,56,0 days 00:00:13.996796
grafana/loki,1,v,17,4,4,8,25,0 days 00:01:22.261379
qbittorrent/qBittorrent,1,release-,24,5,16,145,169,0 days 00:01:04.234807
lottie-react-native/lottie-react-native,1,v,16,2,9,37,53,0 days 00:00:06.894584
designmodo/Flat-UI,1,,5,1,3,5,10,0 days 00:00:01.466795
airbnb/react-sketchapp,2, v,20,11,5,27,47,0 days 00:00:00.755859
flatpickr/flatpickr,2, v,23,10,4,121,144,0 days 00:00:00.956455
2dust/v2rayNG,1,,8,1,5,111,119,0 days 00:00:00.150223
DapperLib/Dapper,1,,31,22,6,13,44,0 days 00:00:10.356313
LMAX-Exchange/disruptor,1,,9,1,4,22,31,0 days 00:00:00.533086
fullcalendar/fullcalendar,1,v,44,16,18,72,116,0 days 00:00:09.719773
ChainSafe/web3.js,2, v,25,16,7,54,79,0 days 00:00:10.772307
icsharpcode/ILSpy,2, v,16,2,11,9,25,0 days 00:00:20.778193
cloudreve/Cloudreve,1,,7,1,5,14,21,0 days 00:00:01.351081
matomo-org/matomo,1,,64,20,21,130,194,0 days 00:01:57.611737
jellyfin/jellyfin,1,v,8,2,4,30,38,0 days 00:00:09.616897
pyg-team/pytorch_geometric,1,,9,1,5,22,31,0 days 00:00:01.190280
nodemailer/nodemailer,1,v,47,20,15,170,217,0 days 00:00:01.865840
pouchdb/pouchdb,2, v,24,7,8,47,71,0 days 00:00:18.553630
gabime/spdlog,1,v,19,4,10,15,34,0 days 00:00:01.994291
desktop/desktop,1,release-,22,6,8,136,158,0 days 00:00:08.812944
you-dont-need/You-Dont-Need-Lodash-Underscore,1,v,14,5,6,6,20,0 days 00:00:00.264953
riot/riot,1,v,44,16,10,155,199,0 days 00:00:07.794608
kovidgoyal/kitty,1,v,25,8,9,58,83,0 days 00:00:15.154206
Tencent/vConsole,2, v,24,13,7,34,58,0 days 00:00:01.428029
magic-wormhole/magic-wormhole,1,,12,2,6,22,34,0 days 00:00:00.845054
framer/motion,1,v,60,51,3,243,303,0 days 00:00:07.672217
browsh-org/browsh,1,v,5,2,2,45,50,0 days 00:00:00.385623
Tencent/ncnn,1,,32,9,3,0,32,0 days 00:00:13.938752
iovisor/bcc,1,v,24,1,6,9,33,0 days 00:00:05.870492
antonmedv/fx,1,,27,18,4,34,61,0 days 00:00:00.270929
frappe/charts,2, v,5,1,3,13,18,0 days 00:00:00.741024
mkdocs/mkdocs,1,,20,9,9,27,47,0 days 00:00:03.108346
pqrs-org/Karabiner-Elements,1,v,28,11,5,0,28,0 days 00:00:18.003630
simdjson/simdjson,1,v,12,1,5,26,38,0 days 00:01:33.823907
hdodenhof/CircleImageView,1,v,9,1,7,6,15,0 days 00:00:00.097853
fmtlib/fmt,2, v,23,2,14,16,39,0 days 00:00:03.441562
node-red/node-red,2, v,26,3,18,99,125,0 days 00:00:12.862127
InstaPy/InstaPy,2, v,6,2,1,37,43,0 days 00:00:00.657365
sweetalert2/sweetalert2,1,v,129,115,3,544,673,0 days 00:00:06.227765
localtunnel/localtunnel,1,v,13,3,6,20,33,0 days 00:00:00.094039
erusev/parsedown,2, v,17,10,5,51,68,0 days 00:00:00.246863
checkly/headless-recorder,1,v,8,4,3,10,18,0 days 00:00:00.839287
krisk/Fuse,2, v,25,12,10,50,75,0 days 00:00:01.523999
jarun/nnn,1,v,34,11,4,2,36,0 days 00:00:01.657054
joke2k/faker,1,v,95,84,9,138,233,0 days 00:00:03.396632
barryvdh/laravel-debugbar,2,V v,24,11,10,99,123,0 days 00:00:00.406035
chrislusf/seaweedfs,2, v,218,211,2,0,218,0 days 00:00:13.566303
greensock/GSAP,1,,26,5,17,72,98,0 days 00:00:04.902298
browserify/browserify,2, v,149,129,7,264,413,0 days 00:00:01.580458
iBotPeaches/Apktool,1,v,12,3,8,23,35,0 days 00:00:02.432662
Kr328/ClashForAndroid,2, v,18,10,1,94,112,0 days 00:00:00.726057
Anuken/Mindustry,1,v,136,129,4,0,136,0 days 00:00:41.366388
FormidableLabs/webpack-dashboard,2, v,12,3,8,31,43,0 days 00:00:00.335128
infinitered/ignite,2, v,52,42,6,94,146,0 days 00:00:02.094189
micropython/micropython,1,v,19,4,10,31,50,0 days 00:00:13.890695
hashcat/hashcat,1,v,17,4,9,8,25,0 days 00:00:30.264254
alibaba/ARouter,1,,4,1,2,16,20,0 days 00:00:00.131489
medcl/elasticsearch-analysis-ik,1,v,42,5,11,130,172,0 days 00:00:01.464756
be5invis/Iosevka,1,v,59,45,8,163,222,0 days 00:00:13.682691
microsoft/LightGBM,1,v,9,1,6,19,28,0 days 00:00:02.927581
janpaepke/ScrollMagic,1,v,5,2,2,21,26,0 days 00:00:00.883265
marcuswestin/store.js,1,v,4,1,2,31,35,0 days 00:00:00.081475
uNetworking/uWebSockets,1,v,66,52,5,26,92,0 days 00:00:01.129023
CopyTranslator/CopyTranslator,2, v,6,1,3,14,20,0 days 00:00:00.827412
bootstrap-vue/bootstrap-vue,2, v,47,38,2,66,113,0 days 00:00:11.369331
dogecoin/dogecoin,2, v,17,3,10,64,81,0 days 00:00:19.213669
gpujs/gpu.js,1,,21,15,3,55,76,0 days 00:00:04.687515
koel/koel,1,v,18,6,6,38,56,0 days 00:00:02.913369
Qv2ray/Qv2ray,1,v,15,11,2,32,47,0 days 00:00:02.648808
wting/autojump,1,release-v,31,14,8,22,53,0 days 00:00:00.270321
hapijs/hapi,2, v,129,106,11,194,323,0 days 00:00:08.528109
commitizen/cz-cli,2, v,16,6,7,58,74,0 days 00:00:00.402679
kamranahmedse/driver.js,2, v,8,3,1,27,35,0 days 00:00:00.388231
RasaHQ/rasa,1,,33,15,7,233,266,0 days 00:00:13.704195
infinitered/reactotron,1,v,46,36,3,40,86,0 days 00:00:04.240011
foreversd/forever,2, v,17,2,10,51,68,0 days 00:00:00.421960
markdown-it/markdown-it,1,,29,13,10,47,76,0 days 00:00:02.420217
google/filament,1,v,23,13,5,70,93,0 days 00:00:31.947991
docker-slim/docker-slim,1,,38,21,10,17,55,0 days 00:00:12.702255
vuejs/vue,2, v,15,4,7,145,160,0 days 00:00:04.945577
twbs/bootstrap,1,v,23,3,15,36,59,0 days 00:00:12.455525
facebook/react,2, v,36,8,14,58,94,0 days 00:00:21.235248
d3/d3,1,v,91,58,12,197,288,0 days 00:00:05.740292
axios/axios,2, v,27,10,10,30,57,0 days 00:00:01.843401
hashicorp/packer,2, v,21,5,15,82,103,0 days 00:00:33.351396
thomaspark/bootswatch,1,v,15,1,11,34,49,0 days 00:00:39.073044
containers/podman,1,v,21,5,4,95,116,0 days 00:00:45.334973
puppeteer/puppeteer,1,v,61,49,1,33,94,0 days 00:00:08.240208
iluwatar/java-design-patterns,1,,19,3,13,0,19,0 days 00:00:07.540141
electron/electron,1,v,113,74,19,595,708,0 days 00:00:28.982039
nvbn/thefuck,1,,79,64,8,4,83,0 days 00:00:01.228619
vercel/next.js,2, v,33,11,8,122,155,0 days 00:00:44.379827
facebook/react-native,2, v,67,52,8,144,211,0 days 00:01:04.798747
tensorflow/models,2,v. v,19,3,9,6,25,0 days 00:00:25.758838
Genymobile/scrcpy,1,v,25,9,5,2,27,0 days 00:00:01.414178
laravel/laravel,1,v,40,19,17,134,174,0 days 00:00:05.560235
microsoft/PowerToys,2, v,28,19,3,31,59,0 days 00:00:20.951177
aws/aws-sdk-js,1,v,1089,1078,5,301,1390,0 days 00:32:49.635828
storybookjs/storybook,1,v,107,90,13,323,430,0 days 00:00:23.013389
microsoft/TypeScript,1,v,12,2,2,120,132,0 days 00:01:24.211264
typicode/json-server,2, v,17,4,10,106,123,0 days 00:00:00.942238
ant-design/ant-design,1,,79,66,4,329,408,0 days 00:01:10.983010
hakimel/reveal.js,1,,27,3,18,11,38,0 days 00:00:03.366350
FortAwesome/Font-Awesome,2, v,30,6,15,40,70,0 days 00:01:00.836554
gin-gonic/gin,1,v,13,3,8,13,26,0 days 00:00:00.666148
huggingface/transformers,2, v,46,41,1,49,95,0 days 00:00:43.925910
pallets/flask,1,,16,5,10,25,41,0 days 00:00:01.764257
reduxjs/redux,1,v,26,16,6,42,68,0 days 00:00:01.926529
webpack/webpack,1,v,152,134,8,224,376,0 days 00:00:23.135045
gohugoio/hugo,1,v,93,72,10,101,194,0 days 00:00:17.424375
chartjs/Chart.js,2, v,21,7,10,31,52,0 days 00:00:07.442450
sveltejs/svelte,1,v,134,119,2,244,378,0 days 00:00:12.188699
bitcoin/bitcoin,1,v,25,3,20,82,107,0 days 00:00:44.360757
expressjs/express,1,,61,40,12,185,246,0 days 00:00:02.274516
socketio/socket.io,1,,30,5,15,118,148,0 days 00:00:02.592641
521xueweihan/HelloGitHub,1,vol.,19,16,1,0,19,0 days 00:00:00.766775
fatedier/frp,1,v,42,23,11,30,72,0 days 00:00:09.712912
adam-p/markdown-here,1,v,15,8,6,34,49,0 days 00:00:01.438481
shadowsocks/shadowsocks-windows,1,,13,4,7,49,62,0 days 00:00:00.958235
jquery/jquery,1,,23,1,21,63,86,0 days 00:00:06.356561
django/django,1,,19,1,14,248,267,0 days 00:01:08.860624
tailwindlabs/tailwindcss,1,v,21,9,8,127,148,0 days 00:00:36.269495
h5bp/html5-boilerplate,2, v,19,2,13,10,29,0 days 00:00:01.352165
coder/code-server,2, v,20,9,4,22,42,0 days 00:00:25.126926
mrdoob/three.js,1,r,132,107,6,0,132,0 days 00:02:41.463194
lodash/lodash,1,,48,39,4,59,107,0 days 00:00:12.138576
azl397985856/leetcode,2, v,35,25,3,5,40,0 days 00:00:02.192533
atom/atom,2, v,271,256,2,104,375,0 days 00:00:31.739752
psf/requests,2, v,43,11,22,101,144,0 days 00:00:02.779275
remix-run/react-router,1,v,39,22,11,76,115,0 days 00:00:04.614536
nestjs/nest,2, v,33,18,5,167,200,0 days 00:00:04.888516
protocolbuffers/protobuf,1,v,29,6,14,46,75,0 days 00:00:49.157890
ionic-team/ionic-framework,2, v,43,27,10,140,183,0 days 00:00:21.761602
tiangolo/fastapi,2, v,77,68,3,52,129,0 days 00:00:04.016498
elastic/kibana,1,v,55,17,12,190,245,0 days 00:07:26.263994
BabylonJS/Babylon.js,2, v,36,16,14,36,72,0 days 00:08:30.562289
3b1b/manim,2, v,8,1,1,10,18,0 days 00:00:02.329660
junegunn/fzf,1,,27,8,13,76,103,0 days 00:00:01.216439
soimort/you-get,1,v,3,1,1,143,146,0 days 00:00:00.249051
tesseract-ocr/tesseract,1,,15,1,10,8,23,0 days 00:00:13.463134
strapi/strapi,1,v,16,7,3,79,95,0 days 00:00:09.496408
juliangarnier/anime,2, v,8,2,5,6,14,0 days 00:00:00.584748
moment/moment,1,,40,15,12,46,86,0 days 00:00:23.532666
scrapy/scrapy,1,,32,7,17,58,90,0 days 00:00:05.975978
ansible/ansible,2, v,26,4,13,174,200,0 days 00:00:58.525319
caddyserver/caddy,1,v,14,2,10,49,63,0 days 00:00:04.176070
prettier/prettier,2, v,39,20,8,71,110,0 days 00:00:23.170329
nuxt/nuxt.js,1,v,30,17,7,112,142,0 days 00:00:04.104838
yarnpkg/yarn,2, v,50,38,1,114,164,0 days 00:00:09.369103
v2ray/v2ray-core,1,v,168,154,3,182,350,0 days 00:00:07.881609
babel/babel,1,v,90,67,9,606,696,0 days 00:00:33.215128
iamkun/dayjs,1,v,11,5,4,99,110,0 days 00:00:00.411084
gogs/gogs,1,v,11,4,6,51,62,0 days 00:00:10.686784
Dogfalo/materialize,2, v,17,10,4,20,37,0 days 00:00:05.909829
ColorlibHQ/AdminLTE,2, v,13,4,6,47,60,0 days 00:00:41.603869
grafana/grafana,2, v,46,7,9,181,227,0 days 00:01:19.275189
vercel/hyper,2, v,18,9,6,43,61,0 days 00:00:11.029697
impress/impress.js,1,,8,4,3,4,12,0 days 00:00:00.308354
FiloSottile/mkcert,1,v,6,3,2,8,14,0 days 00:00:00.630816
ocornut/imgui,1,v,72,44,5,2,74,0 days 00:00:12.866116
PhilJay/MPAndroidChart,1,v,8,2,4,33,41,0 days 00:00:01.614442
facebook/jest,2, v,68,45,10,143,211,0 days 00:00:22.268667
apache/echarts,1,,29,5,14,64,93,0 days 00:01:44.670852
hexojs/hexo,1,,38,15,12,101,139,0 days 00:00:01.828168
dcloudio/uni-app,2, v,8,2,1,8,16,0 days 00:00:04.559378
TryGhost/Ghost,2, v,170,154,8,318,488,0 days 00:00:28.398019
facebook/docusaurus,1,v,14,8,1,37,51,0 days 00:00:03.573294
commaai/openpilot,1,v,8,1,6,62,70,0 days 00:00:10.224640
sahat/hackathon-starter,1,,8,2,4,6,14,0 days 00:00:00.881833
shadowsocks/shadowsocks,1,,4,1,2,14,18,0 days 00:00:00.127725
obsproject/obs-studio,1,,30,1,13,89,119,0 days 00:00:20.072900
Leaflet/Leaflet,1,v,16,1,13,27,43,0 days 00:00:09.405615
vuetifyjs/vuetify,1,v,23,7,8,284,307,0 days 00:00:09.463051
quilljs/quill,1,v,23,12,5,99,122,0 days 00:00:01.456166
d2l-ai/d2l-zh,1,v,9,5,3,0,9,0 days 00:00:02.928038
koajs/koa,1,,43,23,13,44,87,0 days 00:00:00.741784
lerna/lerna,1,v,39,26,6,70,109,0 days 00:00:04.977490
airbnb/lottie-android,2,v. v,21,8,9,42,63,0 days 00:00:07.571983
gulpjs/gulp,2, v,6,2,3,13,19,0 days 00:00:00.191299
prometheus/prometheus,2, v,67,35,6,79,146,0 days 00:01:15.118126
zenorocha/clipboard.js,1,v,9,5,3,33,42,0 days 00:00:00.136492
bumptech/glide,1,v,21,6,11,15,36,0 days 00:00:06.552223
marktext/marktext,1,v,7,2,4,20,27,0 days 00:00:04.723701
ant-design/ant-design-pro,2, v,18,6,6,12,30,0 days 00:00:01.270374
shadowsocks/shadowsocks-android,1,v,24,8,11,156,180,0 days 00:00:07.205320
wagoodman/dive,1,v,10,5,2,15,25,0 days 00:00:00.278671
wg/wrk,1,,10,1,6,11,21,0 days 00:00:00.854042
immutable-js/immutable-js,2, v,16,11,3,39,55,0 days 00:00:01.706845
evanw/esbuild,1,v,12,5,2,284,296,0 days 00:00:02.478653
google/zx,1,,23,21,1,19,42,0 days 00:00:00.194044
XX-net/XX-Net,1,,51,36,5,285,336,0 days 00:00:11.657606
videojs/video.js,2, v,70,38,15,220,290,0 days 00:00:34.022071
nolimits4web/swiper,1,v,49,14,12,139,188,0 days 00:00:06.807245
pandas-dev/pandas,2, v,28,1,22,56,84,0 days 00:00:47.915733
NervJS/taro,1,v,12,2,5,272,284,0 days 00:00:09.194483
nativefier/nativefier,2, v,56,42,9,90,146,0 days 00:00:01.386674
carbon-app/carbon,1,,24,14,4,194,218,0 days 00:00:01.555374
Blankj/AndroidUtilCode,1,,27,12,7,89,116,0 days 00:00:13.851778
hashicorp/terraform,2, v,18,2,12,158,176,0 days 00:00:50.108227
microsoft/monaco-editor,2, v,28,11,10,36,64,0 days 00:00:12.564240
streamich/react-use,1,v,134,130,3,117,251,0 days 00:00:06.229688
google/leveldb,2, v,21,7,7,0,21,0 days 00:00:00.800929
nlohmann/json,2, v,15,2,8,36,51,0 days 00:00:47.341831
certbot/certbot,1,v,68,54,2,31,99,0 days 00:00:14.374696
2dust/v2rayN,1,,117,111,1,2,119,0 days 00:00:07.202960
date-fns/date-fns,2,v. v,77,62,7,42,119,0 days 00:00:10.291615
react-boilerplate/react-boilerplate,1,v,17,6,6,13,30,0 days 00:00:01.668824
beego/beego,1,v,16,3,10,24,40,0 days 00:00:02.653449
jashkenas/backbone,2, v,10,2,7,22,32,0 days 00:00:01.283428
istio/istio,1,,22,3,12,143,165,0 days 00:01:18.334480
tastejs/todomvc,2, v,7,1,3,6,13,0 days 00:00:17.491931
nocodb/nocodb,2, v,9,5,2,86,95,0 days 00:00:10.979693
openai/gym,2, v,15,7,6,34,49,0 days 00:00:01.041842
RocketChat/Rocket.Chat,1,,103,94,1,245,348,0 days 00:02:01.153306
vuejs/vuex,1,v,21,7,7,24,45,0 days 00:00:02.974237
markedjs/marked,2, v,16,2,11,94,110,0 days 00:00:01.361698
caolan/async,2, v,25,13,10,52,77,0 days 00:00:01.915113
Dreamacro/clash,1,v,28,10,3,14,42,0 days 00:00:00.788832
mitmproxy/mitmproxy,2, v,30,4,17,35,65,0 days 00:00:12.783679
kenwheeler/slick,2, v,8,3,3,43,51,0 days 00:00:00.212478
square/leakcanary,1,v,14,4,9,10,24,0 days 00:00:04.361079
tannerlinsley/react-query,1,v,77,73,2,294,371,0 days 00:00:03.740373
jesseduffield/lazygit,2, v,33,21,5,151,184,0 days 00:00:07.605914
standard/standard,1,v,66,55,8,87,153,0 days 00:00:00.982227
atlassian/react-beautiful-dnd,2, v,24,15,4,46,70,0 days 00:00:04.418387
ReactiveX/rxjs,1,,19,7,6,45,64,0 days 00:00:06.369102
naptha/tesseract.js,2, v,4,1,2,28,32,0 days 00:00:02.502442
apolloconfig/apollo,2, v,19,2,9,16,35,0 days 00:00:05.666337
typicode/husky,1,v,34,16,11,88,122,0 days 00:00:01.651232
airbnb/lottie-web,2,v. v,24,9,9,144,168,0 days 00:00:11.563197
jashkenas/underscore,1,,20,5,13,54,74,0 days 00:00:02.538199
getsentry/sentry,2, v,102,90,9,294,396,0 days 00:01:56.918623
fxsjy/jieba,1,v,23,17,5,5,28,0 days 00:01:08.736505
composer/composer,1,,15,1,11,110,125,0 days 00:00:05.491106
denysdovhan/wtfjs,1,v,23,13,6,16,39,0 days 00:00:01.226751
postcss/postcss,1,,20,4,10,207,227,0 days 00:00:01.647083
layui/layui,2, v,7,1,4,41,48,0 days 00:00:01.357163
webtorrent/webtorrent,1,v,125,112,9,284,409,0 days 00:00:05.462520
docker/compose,2, v,41,12,15,67,108,0 days 00:00:04.685839
niklasvh/html2canvas,2, v,7,3,3,17,24,0 days 00:00:02.252405
request/request,1,v,73,55,6,71,144,0 days 00:00:01.273081
github/fetch,1,v,21,10,9,19,40,0 days 00:00:00.247769
select2/select2,1,,9,2,5,27,36,0 days 00:00:00.588801
Modernizr/Modernizr,1,v,20,4,12,23,43,0 days 00:00:01.468772
aria2/aria2,1,release-,53,22,18,87,140,0 days 00:00:23.346848
cheeriojs/cheerio,2, v,22,7,7,30,52,0 days 00:00:00.630313
SortableJS/Sortable,1,,17,3,10,18,35,0 days 00:00:00.781067
tmux/tmux,1,,25,1,19,0,25,0 days 00:00:04.932697
laravel/framework,2, v,163,148,13,630,793,0 days 00:00:35.288325
sequelize/sequelize,2, v,137,107,19,334,471,0 days 00:00:11.738213
GitbookIO/gitbook,1,,22,17,2,68,90,0 days 00:00:02.325950
harness/drone,1,v,31,17,9,44,75,0 days 00:00:08.598366
Binaryify/NeteaseCloudMusicApi,2, v,52,36,7,102,154,0 days 00:00:01.672811
kubernetes/kubernetes,1,v,45,20,19,329,374,0 days 00:06:49.080705
remy/nodemon,1,v,20,7,9,101,121,0 days 00:00:00.636138
lenve/vhr,1,v,12,9,1,0,12,0 days 00:00:03.018981
YMFE/yapi,2, v,9,2,3,68,77,0 days 00:00:07.040504
bvaughn/react-virtualized,2, v,71,65,3,129,200,0 days 00:00:03.491105
ggreer/the_silver_searcher,1,,37,17,8,12,49,0 days 00:00:00.851209
akveo/ngx-admin,1,v,19,2,9,8,27,0 days 00:00:03.442800
Automattic/mongoose,2, v,58,15,20,646,704,0 days 00:00:14.559769
parallax/jsPDF,3, v. v,9,1,7,26,35,0 days 00:00:18.410791
CodeHubApp/CodeHub,1,,15,10,3,13,28,0 days 00:00:02.329410
rclone/rclone,1,v,69,36,11,21,90,0 days 00:03:25.061562
encode/django-rest-framework,1,,22,1,17,106,128,0 days 00:00:04.534382
fastify/fastify,1,v,104,96,1,90,194,0 days 00:00:03.606832
pmndrs/react-spring,1,v,22,15,3,150,172,0 days 00:00:05.129571
hankcs/HanLP,1,v,9,2,5,44,53,0 days 00:00:43.675572
elastic/elasticsearch,1,v,67,22,16,231,298,0 days 00:05:39.912468
influxdata/influxdb,2, v,26,6,14,133,159,0 days 00:00:20.689819
GoogleChrome/lighthouse,2, v,56,40,4,42,98,0 days 00:00:44.207339
explosion/spaCy,2, v,28,14,11,72,100,0 days 00:00:55.823702
plotly/plotly.js,1,v,72,54,3,133,205,0 days 00:10:24.505304
kubernetes/minikube,1,v,61,43,1,45,106,0 days 00:01:13.616340
photonstorm/phaser,2, v,39,20,11,59,98,0 days 00:04:31.160996
