project,prefixes,prefixes_names,main_releases,rapid_releases,trad_releases,patches,releases,time
1adrianb/face-alignment,1,v,5,1,2,5,10,0 days 00:00:00.030234
bytedance/IconPark,1,v,4,1,1,32,36,0 days 00:00:00.034739
FaisalUmair/udemy-downloader-gui,1,v,9,4,2,12,21,0 days 00:00:00.035481
robinvdvleuten/vuex-persistedstate,1,v,21,9,7,14,35,0 days 00:00:00.037379
stevenjoezhang/live2d-widget,1,v,8,5,2,9,17,0 days 00:00:00.016963
mindoc-org/mindoc,1,v,14,10,3,17,31,0 days 00:00:00.061660
Yelp/dumb-init,1,v,8,4,3,14,22,0 days 00:00:00.031542
expressjs/session,1,v,17,7,6,45,62,0 days 00:00:00.068932
jquense/react-big-calendar,1,v,37,18,12,77,114,0 days 00:00:00.093211
kalcaddle/KodExplorer,2, v,31,15,10,3,34,0 days 00:00:00.033366
vuejs/apollo,2, v,5,1,2,8,13,0 days 00:00:00.047919
listen1/listen1_desktop,1,v,26,18,5,40,66,0 days 00:00:00.034704
botman/botman,2, v,17,9,6,44,61,0 days 00:00:00.071294
bblanchon/ArduinoJson,1,v,42,20,11,56,98,0 days 00:00:00.112189
googleapis/google-api-python-client,1,v,60,50,6,52,112,0 days 00:00:00.152755
telegraf/telegraf,2, v,68,48,5,112,180,0 days 00:00:00.162920
go-yaml/yaml,1,v,6,2,3,10,16,0 days 00:00:00.032305
VirusTotal/yara,1,v,17,1,12,16,33,0 days 00:00:00.193435
projectdiscovery/subfinder,2, v,10,5,4,24,34,0 days 00:00:00.077155
ecrmnn/collect.js,1,,35,24,5,154,189,0 days 00:00:00.114532
matthewmueller/x-ray,1,,5,2,2,13,18,0 days 00:00:00.024018
bchavez/Bogus,1,v,7,5,1,97,104,0 days 00:00:00.085063
substack/tape,1,v,50,23,16,85,135,0 days 00:00:00.106936
encode/apistar,1,,6,2,3,88,94,0 days 00:00:00.074294
joeyespo/grip,1,v,15,3,10,9,24,0 days 00:00:00.044653
maaslalani/slides,1,v,8,4,1,8,16,0 days 00:00:00.022676
eternnoir/pyTelegramBotAPI,1,,15,3,7,37,52,0 days 00:00:00.126627
lightbend/config,1,v,9,1,4,19,28,0 days 00:00:00.075068
graphql-editor/graphql-editor,2, v,19,15,1,127,146,0 days 00:00:00.078153
neutralinojs/neutralinojs,1,v,26,18,4,4,30,0 days 00:00:00.100869
Dman95/SASM,1,v,15,4,9,11,26,0 days 00:00:00.119332
assaf/zombie,2, v,21,12,7,111,132,0 days 00:00:00.224227
kickstarter/android-oss,1,v,36,18,5,36,72,0 days 00:00:00.403944
Xhofe/alist,1,v,9,5,2,33,42,0 days 00:00:00.139906
capstone-engine/capstone,1,,5,2,2,9,14,0 days 00:00:00.312335
tijsverkoyen/CssToInlineStyles,1,,9,2,5,20,29,0 days 00:00:00.029273
thephpleague/omnipay,2, v,12,4,5,18,30,0 days 00:00:00.058654
ml5js/ml5-library,3, v V,9,3,3,45,54,0 days 00:00:00.255559
roots/bedrock,1,,21,3,12,82,103,0 days 00:00:00.074763
MikeMcl/bignumber.js,2, v,20,3,11,27,47,0 days 00:00:00.034932
golden-layout/golden-layout,2, v,7,1,3,25,32,0 days 00:00:00.060251
datreeio/datree,1,,14,11,2,93,107,0 days 00:00:00.109057
kyleconroy/sqlc,2, v,15,6,3,1,16,0 days 00:00:00.062551
OpenNMT/OpenNMT-py,2, v,15,6,8,14,29,0 days 00:00:00.272361
shaka-project/shaka-player,1,v,18,2,10,119,137,0 days 00:00:00.543628
docker/docker-py,1,,40,7,11,63,103,0 days 00:00:00.334722
lebab/lebab,1,v,14,8,2,28,42,0 days 00:00:00.068385
modulz/stitches,1,v,5,2,1,22,27,0 days 00:00:00.067608
Respect/Validation,1,,11,1,8,108,119,0 days 00:00:00.160238
nodeca/js-yaml,1,,23,2,18,51,74,0 days 00:00:00.100205
haifengl/smile,1,v,12,3,6,10,22,0 days 00:00:00.140963
documentationjs/documentation,1,v,36,23,7,49,85,0 days 00:00:00.097412
vuejs/vetur,2, v,23,12,6,47,70,0 days 00:00:00.273867
google/ios-webkit-debug-proxy,2, v,9,2,5,9,18,0 days 00:00:00.026659
graphql-java/graphql-java,2, v,40,13,14,2,42,0 days 00:00:00.205524
tilt-dev/tilt,1,v,30,18,4,172,202,0 days 00:00:00.340067
Lexikos/AutoHotkey_L,2,v L,56,48,2,146,202,0 days 00:00:00.192703
antonioru/beautiful-react-hooks,1,,5,2,1,6,11,0 days 00:00:00.035530
sockeqwe/mosby,1,,7,3,2,8,15,0 days 00:00:00.042248
gzu-liyujiang/AndroidPicker,1,,11,3,5,45,56,0 days 00:00:00.044809
benbusby/whoogle-search,2, v,7,1,2,15,22,0 days 00:00:00.048710
dinerojs/dinero.js,2, v,13,8,3,17,30,0 days 00:00:00.041679
dotnetcore/CAP,1,v,22,5,11,30,52,0 days 00:00:00.120850
nl8590687/ASRT_SpeechRecognition,1,v,10,4,4,4,14,0 days 00:00:00.026663
doctrine/common,2, v,18,1,16,31,49,0 days 00:00:00.342817
express-validator/express-validator,1,v,55,29,15,60,115,0 days 00:00:00.087847
hashicorp/serf,1,v,9,3,3,22,31,0 days 00:00:00.119343
expressjs/cors,1,v,11,3,5,23,34,0 days 00:00:00.025512
tensorflow/serving,2, r,25,6,10,27,52,0 days 00:00:00.464993
jackc/pgx,1,v,36,11,14,18,54,0 days 00:00:00.215762
pagekit/pagekit,1,,4,1,2,31,35,0 days 00:00:00.368621
mikaelbr/node-notifier,1,v,24,4,13,45,69,0 days 00:00:00.054199
missive/emoji-mart,1,v,20,8,7,40,60,0 days 00:00:00.059935
bfenetworks/bfe,1,v,18,10,3,0,18,0 days 00:00:00.078531
jrnl-org/jrnl,2, v,13,2,5,24,37,0 days 00:00:00.116509
jbaysolutions/vue-grid-layout,1,,5,1,1,29,34,0 days 00:00:00.034414
MinecraftForge/MinecraftForge,2, v,59,33,13,10,69,0 days 00:00:00.752091
evernote/android-job,1,v,4,1,2,36,40,0 days 00:00:00.037025
johnkerl/miller,2, v,29,15,8,23,52,0 days 00:00:00.510237
jaywcjlove/hotkeys,1,v,12,4,7,62,74,0 days 00:00:00.042391
angular-ui/ui-grid,1,v,24,10,11,86,110,0 days 00:00:00.282583
weaveworks/scope,2, v,31,17,5,30,61,0 days 00:00:00.366254
serilog/serilog,1,v,19,3,7,13,32,0 days 00:00:00.136873
lutris/lutris,2, v,3,1,1,63,66,0 days 00:00:00.441516
jonls/redshift,2, v,17,6,7,2,19,0 days 00:00:00.049365
NVIDIA/TensorRT,2, v,27,17,2,6,33,0 days 00:00:00.033869
gcanti/io-ts,1,,20,10,3,84,104,0 days 00:00:00.058808
anishathalye/dotbot,1,v,20,6,11,28,48,0 days 00:00:00.031267
algolia/places,1,v,34,26,4,69,103,0 days 00:00:00.082464
valor-software/ngx-bootstrap,2, v,31,15,9,81,112,0 days 00:00:00.165972
nathancahill/split,2, v,10,5,3,38,48,0 days 00:00:00.034195
jonschlinkert/remarkable,2, v,9,6,2,13,22,0 days 00:00:00.037190
fatih/color,1,v,16,4,10,1,17,0 days 00:00:00.019461
ppoffice/hexo-theme-icarus,2, v,22,9,9,9,31,0 days 00:00:00.040429
ly525/luban-h5,1,v,18,12,3,14,32,0 days 00:00:00.047589
chyroc/WechatSogou,1,v,8,1,3,15,23,0 days 00:00:00.022572
mwouts/jupytext,3, v v.,20,10,7,75,95,0 days 00:00:00.145421
log4js-node/log4js-node,1,v,32,19,9,90,122,0 days 00:00:00.141219
kaorun343/vue-property-decorator,1,v,24,8,5,16,40,0 days 00:00:00.033035
mixn/carbon-now-cli,2, v,5,2,1,7,12,0 days 00:00:00.020397
SixLabors/ImageSharp,1,v,3,1,1,6,9,0 days 00:00:01.487519
arachnys/cabot,1,,6,4,1,33,39,0 days 00:00:00.057134
go-flutter-desktop/go-flutter,1,v,39,33,3,15,54,0 days 00:00:00.038764
alan-turing-institute/sktime,1,v,10,1,4,14,24,0 days 00:00:00.174317
open-cli-tools/concurrently,2, v,27,7,14,18,45,0 days 00:00:00.034587
go-acme/lego,1,v,34,15,7,17,51,0 days 00:00:00.087562
gorakhargosh/watchdog,1,v,12,2,6,35,47,0 days 00:00:00.082399
barryvdh/laravel-dompdf,1,v,10,1,8,24,34,0 days 00:00:00.022129
devicons/devicon,1,v,17,6,5,4,21,0 days 00:00:00.073090
bytedance/xgplayer,1,v,4,1,2,44,48,0 days 00:00:00.146597
oauth2-proxy/oauth2-proxy,1,v,18,1,10,9,27,0 days 00:00:00.127208
agentejo/cockpit,1,,8,1,5,27,35,0 days 00:00:00.257953
berty/berty,1,v,390,387,1,579,969,0 days 00:00:01.581674
i-tu/Hasklig,2, v,12,5,4,0,12,0 days 00:00:00.064337
ExactTarget/fuelux,1,,25,10,6,59,84,0 days 00:00:00.298248
leongersen/noUiSlider,1,,45,19,16,58,103,0 days 00:00:00.084086
django/channels,1,,20,9,8,44,64,0 days 00:00:00.174145
encode/uvicorn,1,,17,4,4,119,136,0 days 00:00:00.105318
domlysz/BlenderGIS,2, v,3,1,1,0,3,0 days 00:00:00.035189
tjanczuk/edge,1,v,11,5,5,23,34,0 days 00:00:00.046318
PyGithub/PyGithub,2, v,62,40,9,23,85,0 days 00:00:00.246990
tzapu/WiFiManager,2, v,16,10,3,0,16,0 days 00:00:00.030434
containers/buildah,3, v V,42,22,3,70,112,0 days 00:00:00.494123
alibaba/transmittable-thread-local,2, v,18,6,8,31,49,0 days 00:00:00.058486
arturbien/React95,1,v,13,7,3,6,19,0 days 00:00:00.049976
crowdsecurity/crowdsec,1,v,7,1,3,39,46,0 days 00:00:00.063033
h6ah4i/android-advancedrecyclerview,1,,8,1,6,22,30,0 days 00:00:00.046986
substack/minimist,1,,6,2,2,20,26,0 days 00:00:00.016557
wasabeef/Blurry,1,,6,1,4,7,13,0 days 00:00:00.015727
mher/flower,1,v,9,1,6,15,24,0 days 00:00:00.093154
graphql-dotnet/graphql-dotnet,2, v,42,24,7,45,87,0 days 00:00:00.139365
kartik-v/bootstrap-fileinput,1,v,26,18,7,61,87,0 days 00:00:00.082654
release-it/release-it,1,,84,66,12,176,260,0 days 00:00:00.188524
go-task/task,1,v,26,9,7,26,52,0 days 00:00:00.080023
naver/billboard.js,1,,21,1,13,54,75,0 days 00:00:00.216302
sachinchoolur/lightGallery,2, v,16,4,8,66,82,0 days 00:00:00.074442
nodegit/nodegit,1,v,27,9,10,67,94,0 days 00:00:00.288907
phan/phan,1,,33,13,10,127,160,0 days 00:00:00.460965
crossplane/crossplane,1,v,23,11,3,34,57,0 days 00:00:00.414944
nhn/tui.image-editor,2, v,21,7,12,17,38,0 days 00:00:00.064689
bestiejs/benchmark.js,1,,5,2,2,19,24,0 days 00:00:00.080029
wangyu-/udp2raw,1,,38,31,2,0,38,0 days 00:00:00.065009
vrana/adminer,1,v,17,4,11,35,52,0 days 00:00:00.270483
onionshare/onionshare,2, v,18,5,11,9,27,0 days 00:00:00.322344
hiroppy/fusuma,1,v,37,32,3,59,96,0 days 00:00:00.111141
GoogleChrome/lighthouse-ci,1,v,9,1,5,24,33,0 days 00:00:00.056564
share/sharedb,1,v,23,7,9,111,134,0 days 00:00:00.125401
snorkel-team/snorkel,1,v,4,1,2,11,15,0 days 00:00:00.285105
chainer/chainer,1,v,60,47,3,18,78,0 days 00:00:02.528841
windicss/windicss,1,v,13,8,1,81,94,0 days 00:00:00.070975
arkime/arkime,1,v,32,2,17,70,102,0 days 00:00:00.374264
microsoft/Windows-driver-samples,1,,609,57,1,0,609,0 days 00:00:00.450515
rectorphp/rector,2, v,13,1,9,351,364,0 days 00:00:01.036069
rmax/scrapy-redis,2, v,6,1,3,12,18,0 days 00:00:00.018430
vuejs/v2.vuejs.org,1,v,8,4,3,9,17,0 days 00:00:00.033221
timolins/react-hot-toast,1,v,7,3,2,5,12,0 days 00:00:00.026427
ai/size-limit,1,,45,29,7,101,146,0 days 00:00:00.123450
reviewdog/reviewdog,2, v,6,1,4,21,27,0 days 00:00:00.157445
reactchartjs/react-chartjs-2,3, v v.,24,9,9,51,75,0 days 00:00:00.049236
msiemens/tinydb,2, v,34,10,16,26,60,0 days 00:00:00.051494
laravel/socialite,1,v,18,2,9,62,80,0 days 00:00:00.066684
luraproject/lura,2, v,15,2,10,12,27,0 days 00:00:00.052058
reek/anti-adblock-killer,1,v,31,29,1,0,31,0 days 00:00:00.036252
lancedikson/bowser,2, v,26,11,8,33,59,0 days 00:00:00.185322
nhn/tui.chart,2, v,38,21,8,60,98,0 days 00:00:00.184070
expressjs/body-parser,1,,21,9,8,47,68,0 days 00:00:00.045461
jvm-profiling-tools/async-profiler,1,v,14,2,9,9,23,0 days 00:00:00.045322
TommyLemon/Android-ZBLibrary,1,,21,13,4,4,25,0 days 00:00:00.038163
jarun/buku,2, v,36,18,6,3,39,0 days 00:00:00.118330
btraceio/btrace,3, release- v,5,1,2,34,39,0 days 00:00:00.083034
journeyapps/zxing-android-embedded,1,v,15,4,9,7,22,0 days 00:00:00.070879
healthchecks/healthchecks,2, v,28,10,1,8,36,0 days 00:00:00.160138
pypa/pipx,1,,15,7,5,36,51,0 days 00:00:00.045137
openpgpjs/openpgpjs,1,v,40,18,13,109,149,0 days 00:00:00.293975
minbrowser/min,2, v,26,4,8,31,57,0 days 00:00:00.173237
laravel-mix/laravel-mix,1,v,27,19,3,105,132,0 days 00:00:00.128817
spectreconsole/spectre.console,1,,44,38,1,3,47,0 days 00:00:00.055694
standard-things/esm,1,,29,27,1,160,189,0 days 00:00:00.529175
Mailtrain-org/mailtrain,1,v,25,20,2,10,35,0 days 00:00:00.105243
Snapchat/KeyDB,1,v,6,1,2,16,22,0 days 00:00:01.648516
uber/prototool,1,v,18,13,3,2,20,0 days 00:00:00.036723
istanbuljs/nyc,1,v,58,43,4,56,114,0 days 00:00:00.085488
lukeed/polka,1,v,5,2,2,9,14,0 days 00:00:00.024346
ZipArchive/ZipArchive,2, v,17,4,9,80,97,0 days 00:00:00.064700
wiremock/wiremock,2, release-,55,28,16,28,83,0 days 00:00:00.151366
zhaojun1998/zfile,1,,32,26,3,11,43,0 days 00:00:00.038135
json5/json5,1,v,10,1,7,8,18,0 days 00:00:00.041283
aws/aws-sdk-php,1,,234,217,7,1228,1462,0 days 00:00:02.661754
material-shell/material-shell,2, v,11,7,2,0,11,0 days 00:00:00.058299
kedacore/keda,1,v,14,3,4,3,17,0 days 00:00:00.118295
timber/timber,2, v,32,10,14,96,128,0 days 00:00:00.354013
uNetworking/uWebSockets.js,1,v,59,51,3,6,65,0 days 00:00:00.148493
panjf2000/gnet,1,v,8,2,5,35,43,0 days 00:00:00.055082
rauchg/slackin,1,,14,8,3,26,40,0 days 00:00:00.032915
johannesjo/super-productivity,1,v,58,48,3,296,354,0 days 00:00:00.757308
pedroslopez/whatsapp-web.js,1,v,18,8,3,39,57,0 days 00:00:00.045576
google/benchmark,1,v,8,2,5,9,17,0 days 00:00:00.085638
kubeedge/kubeedge,1,v,14,1,10,11,25,0 days 00:00:00.312715
Angel-ML/angel,2,Release- v,14,2,6,4,18,0 days 00:00:00.220736
fengyuanchen/viewerjs,1,v,21,6,10,28,49,0 days 00:00:00.039693
reactjs/react-rails,2, v,24,9,9,31,55,0 days 00:00:00.191197
docker/machine,2, v,16,2,8,16,32,0 days 00:00:00.345184
ponylang/ponyc,2, release-,51,31,9,56,107,0 days 00:00:00.480791
LonamiWebs/Telethon,1,v,44,26,4,91,135,0 days 00:00:00.173843
vitalets/x-editable,1,,6,4,1,9,15,0 days 00:00:00.036374
hajimehoshi/ebiten,1,v,17,2,13,66,83,0 days 00:00:00.392250
go-admin-team/go-admin,1,v,6,1,3,27,33,0 days 00:00:00.076970
meetecho/janus-gateway,1,v,11,1,7,53,64,0 days 00:00:00.371992
roadrunner-server/roadrunner,2, v,22,7,7,81,103,0 days 00:00:00.350442
sghall/react-move,1,v,28,19,7,21,49,0 days 00:00:00.044536
SigmaHQ/sigma,1,,19,6,6,10,29,0 days 00:00:00.917701
ServiceStack/ServiceStack,1,v,17,2,12,41,58,0 days 00:00:00.768077
glidejs/glide,1,v,8,1,5,25,33,0 days 00:00:00.040210
hotoo/pinyin,1,,13,1,10,28,41,0 days 00:00:00.033279
0x7c13/Notepads,1,v,14,9,2,42,56,0 days 00:00:00.069591
espnet/espnet,1,v.,11,1,6,32,43,0 days 00:00:01.068706
mobxjs/mobx-state-tree,2, v,38,28,7,64,102,0 days 00:00:00.240642
ocrmypdf/OCRmyPDF,1,v,63,40,7,115,178,0 days 00:00:00.234088
electronicarts/EASTL,1,,14,1,8,31,45,0 days 00:00:00.125144
wilsonpage/fastdom,2, v,8,5,2,23,31,0 days 00:00:00.026345
boto/boto,2, v,50,28,10,29,79,0 days 00:00:00.559063
electerm/electerm,2, v,35,23,5,292,327,0 days 00:00:00.221736
baconjs/bacon.js,1,,9,3,3,200,209,0 days 00:00:00.216617
sebastianbergmann/exporter,1,,7,2,4,12,19,0 days 00:00:00.040176
mbdavid/LiteDB,2,v v.,8,1,3,27,35,0 days 00:00:00.202616
kelektiv/node.bcrypt.js,2, v,11,1,9,39,50,0 days 00:00:00.044502
zo0r/react-native-push-notification,2, v,16,10,2,19,35,0 days 00:00:00.061249
zendesk/android-floating-action-button,1,,11,9,1,4,15,0 days 00:00:00.017328
mRemoteNG/mRemoteNG,2, v,17,9,7,23,40,0 days 00:00:00.324643
rs/zerolog,1,v,27,9,8,16,43,0 days 00:00:00.030363
houtianze/bypy,1,,5,1,2,69,74,0 days 00:00:00.045940
appleboy/gorush,2, v,16,6,8,15,31,0 days 00:00:00.053601
doctrine/annotations,2, v,14,1,9,20,34,0 days 00:00:00.330789
opencart/opencart,1,,11,4,5,24,35,0 days 00:00:00.894224
mautic/mautic,1,,30,6,13,59,89,0 days 00:00:01.768598
linkedin/css-blocks,2, v,17,9,4,22,39,0 days 00:00:00.129394
sindresorhus/caprine,2, v,70,49,3,43,113,0 days 00:00:00.079636
sebastianbergmann/environment,1,,11,1,6,27,38,0 days 00:00:00.042619
rancher/os,1,v,15,4,6,43,58,0 days 00:00:00.186357
kpdecker/jsdiff,1,v,15,3,9,24,39,0 days 00:00:00.035576
the-benchmarker/web-frameworks,2, v,3,1,1,13,16,0 days 00:00:00.055452
conventional-changelog/standard-version,1,v,24,8,13,13,37,0 days 00:00:00.039613
optuna/optuna,1,v,36,27,2,4,40,0 days 00:00:00.804519
ramboxapp/community-edition,1,,7,3,3,36,43,0 days 00:00:00.094434
Squirrel/Squirrel.Windows,1,,17,5,7,48,65,0 days 00:00:00.178462
yugabyte/yugabyte-db,2, v,18,1,12,73,91,0 days 00:00:01.030995
dylanaraps/pywal,1,,17,10,2,65,82,0 days 00:00:00.070904
simeji/jid,2, v,7,4,1,14,21,0 days 00:00:00.017650
Uberi/speech_recognition,1,,16,6,6,29,45,0 days 00:00:00.033446
graphql/express-graphql,1,v,12,3,7,31,43,0 days 00:00:00.058614
isomorphic-git/isomorphic-git,1,v,96,86,3,238,334,0 days 00:00:00.235568
automl/auto-sklearn,3, v v.,12,2,6,21,33,0 days 00:00:00.155130
vmware-tanzu/velero,1,v,17,2,8,43,60,0 days 00:00:00.227236
gocd/gocd,1,,69,48,4,2,71,0 days 00:00:01.230148
Cyan4973/xxHash,2,v r,12,4,4,11,23,0 days 00:00:00.082048
katspaugh/wavesurfer.js,2, v,26,5,10,105,131,0 days 00:00:00.118752
invoiceninja/invoiceninja,1,v,41,21,5,387,428,0 days 00:00:01.485808
arc298/instagram-scraper,2, v,11,3,4,68,79,0 days 00:00:00.041726
symfony/translation,1,v,26,4,21,462,488,0 days 00:00:00.417900
PHPOffice/PHPWord,1,,12,3,7,8,20,0 days 00:00:00.137271
baldurk/renderdoc,1,v,39,6,11,0,39,0 days 00:00:01.028313
maxogden/menubar,1,v,18,4,8,47,65,0 days 00:00:00.037291
elasticsearch-dump/elasticsearch-dump,2, v,113,92,6,137,250,0 days 00:00:00.176438
FreeRDP/FreeRDP,1,,9,2,4,8,17,0 days 00:00:01.118757
albertlauncher/albert,1,v,17,9,5,64,81,0 days 00:00:00.084603
node-formidable/formidable,2, v,12,8,3,33,45,0 days 00:00:00.167208
Radarr/Radarr,2, v,99,64,14,13,112,0 days 00:00:00.869232
feross/simple-peer,1,v,50,34,10,71,121,0 days 00:00:00.221938
doccano/doccano,1,v,8,2,3,19,27,0 days 00:00:00.183304
99designs/aws-vault,1,v,34,17,9,32,66,0 days 00:00:00.084285
dtm-labs/dtm,1,v,21,18,1,35,56,0 days 00:00:00.075715
apache/storm,2, v,11,1,9,26,37,0 days 00:00:01.041691
yocontra/react-responsive,1,v,8,2,4,28,36,0 days 00:00:00.029010
react-native-video/react-native-video,2, v,24,13,7,49,73,0 days 00:00:00.096445
StackExchange/blackbox,1,v,18,6,8,0,18,0 days 00:00:00.044735
JetBrains/Exposed,1,,8,3,3,78,86,0 days 00:00:00.126068
Zizaco/entrust,1,,10,2,7,8,18,0 days 00:00:00.036538
gitalk/gitalk,1,v,5,1,3,16,21,0 days 00:00:00.019922
jackocnr/intl-tel-input,2, v,62,41,10,262,324,0 days 00:00:00.343849
medialize/URI.js,2,v v.,20,7,11,54,74,0 days 00:00:00.074802
go-resty/resty,1,v,34,14,10,7,41,0 days 00:00:00.037950
i18next/i18next,2, v,91,66,9,222,313,0 days 00:00:00.240690
amoffat/sh,1,,34,26,5,17,51,0 days 00:00:00.193068
RichardKnop/machinery,1,v,11,1,7,86,97,0 days 00:00:00.099561
DIYgod/APlayer,2, v,6,3,2,15,21,0 days 00:00:00.030283
shentao/vue-multiselect,2, v,5,2,1,20,25,0 days 00:00:00.030572
yagop/node-telegram-bot-api,1,v,26,14,6,13,39,0 days 00:00:00.053598
maxence-charriere/go-app,2, v,37,24,6,69,106,0 days 00:00:00.090072
jiaaro/pydub,1,v,17,3,9,19,36,0 days 00:00:00.055337
dataarts/dat.gui,2, v,6,1,2,18,24,0 days 00:00:00.042548
baskerville/bspwm,1,,9,5,1,15,24,0 days 00:00:00.073284
redux-offline/redux-offline,2, v,7,1,4,9,16,0 days 00:00:00.033336
software-mansion/react-native-reanimated,1,,23,10,2,19,42,0 days 00:00:00.111654
swaggo/swag,2,v v.,9,1,5,23,32,0 days 00:00:00.045775
NixOS/nix,1,,37,5,23,53,90,0 days 00:00:00.968724
securego/gosec,2, v,16,3,8,8,24,0 days 00:00:00.060064
ArthurHub/Android-Image-Cropper,1,,9,2,6,23,32,0 days 00:00:00.041085
simonw/datasette,1,,55,43,6,39,94,0 days 00:00:00.141964
bpmn-io/bpmn-js,2, v,75,46,7,155,230,0 days 00:00:00.280051
faker-js/faker,1,v,22,10,9,26,48,0 days 00:00:00.151372
fruitcake/laravel-cors,2,v V,16,5,10,33,49,0 days 00:00:00.036894
thephpleague/oauth2-server,1,,25,3,11,72,97,0 days 00:00:00.299140
electerious/Lychee,2, v,11,1,6,31,42,0 days 00:00:00.086747
garris/BackstopJS,2, v,25,9,8,106,131,0 days 00:00:00.118734
dylang/npm-check,2, v,12,4,6,33,45,0 days 00:00:00.035414
gruntwork-io/terratest,1,v,39,21,9,296,335,0 days 00:00:00.438904
belluzj/fantasque-sans,2, v,5,1,2,10,15,0 days 00:00:00.020144
centrifugal/centrifugo,1,v,24,5,9,57,81,0 days 00:00:00.095350
pahen/madge,2, v,30,13,11,29,59,0 days 00:00:00.046002
chrismaltby/gb-studio,2, v,6,3,2,6,12,0 days 00:00:00.225679
marshmallow-code/marshmallow,1,,48,22,11,77,125,0 days 00:00:00.227628
react-native-svg/react-native-svg,2, v,45,30,7,164,209,0 days 00:00:00.288163
uber/cadence,1,v,22,9,7,55,77,0 days 00:00:00.222614
snipe/snipe-it,3, v V,30,12,13,130,160,0 days 00:00:00.765397
jenssegers/laravel-mongodb,2, v,19,3,12,91,110,0 days 00:00:00.102112
PaddlePaddle/Paddle-Lite,3, release/ v,15,4,7,6,21,0 days 00:00:00.573936
tindy2013/subconverter,1,v,7,3,2,28,35,0 days 00:00:00.047553
gsoft-inc/craco,1,v,32,24,2,27,59,0 days 00:00:00.132975
crater-invoice/crater,1,,11,4,4,19,30,0 days 00:00:00.087954
aws/aws-sam-cli,1,v,96,89,1,36,132,0 days 00:00:00.151654
chancejs/chancejs,2, v,9,3,5,47,56,0 days 00:00:00.144067
thedevs-network/kutt,1,v,10,5,2,51,61,0 days 00:00:00.051357
mcollina/autocannon,1,v,52,36,9,43,95,0 days 00:00:00.063672
filhodanuvem/gitql,2, v,10,2,6,8,18,0 days 00:00:00.024962
concourse/concourse,1,v,134,117,4,81,215,0 days 00:00:02.090884
supertokens/supertokens-core,1,v,22,15,2,17,39,0 days 00:00:00.050667
flot/flot,2, v,16,6,7,35,51,0 days 00:00:00.073308
SocketCluster/socketcluster,3, v v.,17,13,3,26,43,0 days 00:00:00.069090
hashicorp/raft,1,v,5,1,3,15,20,0 days 00:00:00.065745
xonsh/xonsh,1,,12,1,10,100,112,0 days 00:00:00.655613
onsi/ginkgo,1,v,19,3,11,21,40,0 days 00:00:00.062063
wojtekmaj/react-pdf,1,v,27,13,6,36,63,0 days 00:00:00.082478
reactiveui/refit,2, v,13,3,6,39,52,0 days 00:00:00.132443
burnash/gspread,2, v,19,9,8,21,40,0 days 00:00:00.070074
fabiospampinato/cash,1,,16,8,5,36,52,0 days 00:00:00.062950
google/error-prone,1,v,15,3,5,34,49,0 days 00:00:00.318751
plantuml/plantuml,1,v,9,2,4,78,87,0 days 00:00:00.079230
sindresorhus/query-string,2, v,34,12,12,38,72,0 days 00:00:00.043082
OJ/gobuster,1,v,11,1,7,4,15,0 days 00:00:00.032735
bytedeco/javacv,1,,17,1,14,14,31,0 days 00:00:00.047704
karatelabs/karate,1,v,11,1,6,27,38,0 days 00:00:00.211729
jazzband/pip-tools,1,,45,22,12,49,94,0 days 00:00:00.132574
ractivejs/ractive,1,v,10,1,6,88,98,0 days 00:00:00.274373
trpc/trpc,2, v,57,54,1,48,105,0 days 00:00:00.258787
platformio/platformio-core,3, v v.,43,22,13,72,115,0 days 00:00:00.379268
heroiclabs/nakama,1,v,38,17,5,29,67,0 days 00:00:00.091070
Graylog2/graylog2-server,1,,25,1,20,124,149,0 days 00:00:01.663081
spulec/moto,2, v,14,2,8,152,166,0 days 00:00:00.465407
rest-assured/rest-assured,1,rest-assured-,32,6,15,40,72,0 days 00:00:00.134111
ianstormtaylor/superstruct,1,v,14,7,4,55,69,0 days 00:00:00.076778
webslides/WebSlides,1,,7,4,1,7,14,0 days 00:00:00.040373
File-New-Project/EarTrumpet,1,,9,2,6,29,38,0 days 00:00:00.084103
moroshko/react-autosuggest,1,v,41,30,6,54,95,0 days 00:00:00.064005
perkeep/perkeep,1,,11,5,5,0,11,0 days 00:00:00.666495
gruntwork-io/terragrunt,1,v,37,18,12,337,374,0 days 00:00:00.296356
geerlingguy/ansible-for-devops,1,,32,16,9,1,33,0 days 00:00:00.037824
Shougo/deoplete.nvim,1,,14,1,11,0,14,0 days 00:00:00.126240
twitchtv/twirp,1,v,18,8,8,10,28,0 days 00:00:00.049759
Unleash/unleash,2, v,34,19,7,132,166,0 days 00:00:00.327029
kulshekhar/ts-jest,2, v,30,14,8,88,118,0 days 00:00:00.256485
sparklemotion/nokogiri,2,REL_ v,15,2,10,89,104,0 days 00:00:00.604487
airbnb/hypernova,1,v,9,1,4,8,17,0 days 00:00:00.023964
neuecc/UniRx,1,,18,8,5,7,25,0 days 00:00:00.168174
postmanlabs/newman,3, v v.,26,8,8,80,106,0 days 00:00:00.359332
yuliskov/SmartTubeNext,1,,73,54,1,0,73,0 days 00:00:00.420681
cupy/cupy,1,v,56,48,1,6,62,0 days 00:00:02.254181
mahmoud/boltons,1,,24,9,9,21,45,0 days 00:00:00.088948
mitchellh/mapstructure,1,v,6,2,3,11,17,0 days 00:00:00.029445
davidjbradshaw/iframe-resizer,2, v,26,16,7,96,122,0 days 00:00:00.108066
weibocom/motan,1,,5,1,3,17,22,0 days 00:00:00.041930
TypeStrong/typedoc,2, v,22,3,13,127,149,0 days 00:00:00.137999
ethereum-mining/ethminer,1,v,10,1,5,3,13,0 days 00:00:01.147773
travist/jsencrypt,2, v,7,2,3,3,10,0 days 00:00:00.022359
vmware-tanzu/octant,1,v,25,16,3,15,40,0 days 00:00:00.294129
react-native-device-info/react-native-device-info,1,v,57,43,7,114,171,0 days 00:00:00.125919
Jrohy/multi-v2ray,1,v,18,10,4,79,97,0 days 00:00:00.232599
voidcosmos/npkill,1,v,8,5,2,19,27,0 days 00:00:00.038352
Financial-Times/polyfill-service,2, v,87,65,5,87,174,0 days 00:00:00.375059
gevent/gevent,2, v,19,4,12,35,54,0 days 00:00:00.470129
pentaho/pentaho-kettle,1,,31,10,16,37,68,0 days 00:00:01.042310
HMBSbige/ShadowsocksR-Windows,1,,28,12,13,127,155,0 days 00:00:00.158611
vuejs/vue-class-component,1,v,10,2,5,15,25,0 days 00:00:00.022858
python-visualization/folium,1,v,11,1,7,10,21,0 days 00:00:00.108039
mattn/go-sqlite3,1,v,16,4,7,19,35,0 days 00:00:00.069041
redux-observable/redux-observable,2, v,23,13,7,8,31,0 days 00:00:00.042711
plasma-umass/scalene,2, v,3,1,1,22,25,0 days 00:00:00.121725
deepmipt/DeepPavlov,1,,17,6,4,28,45,0 days 00:00:00.168248
kelseyhightower/confd,1,v,15,3,8,7,22,0 days 00:00:00.078015
taigaio/taiga-back,1,,24,7,9,74,98,0 days 00:00:00.275761
vercel/serve,2, v,49,34,7,96,145,0 days 00:00:00.109557
PrestaShop/PrestaShop,1,,30,14,3,83,113,0 days 00:00:04.833662
jsx-eslint/eslint-plugin-react,1,v,81,55,6,88,169,0 days 00:00:00.257870
UKPLab/sentence-transformers,1,v,10,3,5,20,30,0 days 00:00:00.075762
mozilla/nunjucks,3, v v.,14,1,7,37,51,0 days 00:00:00.116507
hoffstadt/DearPyGui,1,v,8,4,1,10,18,0 days 00:00:00.217372
brython-dev/brython,1,,12,1,9,46,58,0 days 00:00:00.453329
carla-simulator/carla,1,,9,4,3,38,47,0 days 00:00:00.372349
gcanti/fp-ts,1,,38,23,8,115,153,0 days 00:00:00.284735
adnanh/webhook,1,,9,5,3,21,30,0 days 00:00:00.135314
ffmpegwasm/ffmpeg.wasm,1,v,10,6,2,18,28,0 days 00:00:00.024084
metalsmith/metalsmith,2, v,24,15,3,60,84,0 days 00:00:00.047574
hybridgroup/gobot,3, v v.,29,10,11,16,45,0 days 00:00:00.185349
sindresorhus/type-fest,1,v,40,29,3,34,74,0 days 00:00:00.038875
cortexlabs/cortex,1,v,42,36,1,20,62,0 days 00:00:00.180405
remix-run/history,1,v,38,24,7,40,78,0 days 00:00:00.086148
colinhacks/zod,2, v,20,15,2,23,43,0 days 00:00:00.098013
rebassjs/rebass,1,v,11,3,5,42,53,0 days 00:00:00.128276
BeyondDimension/SteamTools,1,,10,6,3,28,38,0 days 00:00:00.166122
alibaba/formily,1,v,9,1,4,85,94,0 days 00:00:00.180922
mvt-project/mvt,1,v,4,2,1,36,40,0 days 00:00:00.042632
beautify-web/js-beautify,1,v,13,3,7,74,87,0 days 00:00:00.231990
mrdoob/stats.js,1,r,16,6,8,0,16,0 days 00:00:00.020829
probot/probot,2, v,71,58,3,124,195,0 days 00:00:00.170631
sindresorhus/ora,1,v,24,9,9,13,37,0 days 00:00:00.018055
prompt-toolkit/python-prompt-toolkit,1,,5,1,1,51,56,0 days 00:00:00.223108
yjs/yjs,1,v,19,9,8,151,170,0 days 00:00:00.158678
nodegui/nodegui,1,v,48,42,1,45,93,0 days 00:00:00.116117
chromedp/chromedp,1,v,8,1,5,33,41,0 days 00:00:00.049954
paramiko/paramiko,3, v release-,23,3,13,152,175,0 days 00:00:00.253859
yiminghe/async-validator,2, v,18,4,11,59,77,0 days 00:00:00.048486
theonedev/onedev,2, v,26,17,2,131,157,0 days 00:00:00.352874
signalapp/Signal-Server,1,v,215,206,2,18,233,0 days 00:00:00.337802
tailscale/tailscale,1,v,19,8,2,54,73,0 days 00:00:00.637003
sindresorhus/ky,1,v,29,15,2,18,47,0 days 00:00:00.036059
go-swagger/go-swagger,2, v,29,8,11,26,55,0 days 00:00:00.192801
kubernetes/kompose,1,v,34,22,6,3,37,0 days 00:00:00.111933
99designs/gqlgen,2, v,16,7,6,35,51,0 days 00:00:00.162657
developit/mitt,2, v,6,1,3,5,11,0 days 00:00:00.018724
ckeditor/ckeditor5,2, v,48,30,3,6,54,0 days 00:00:03.717576
swagger-api/swagger-editor,3, v v/,27,11,11,364,391,0 days 00:00:00.417389
konvajs/konva,1,,41,18,8,131,172,0 days 00:00:00.239165
react-grid-layout/react-draggable,1,v,24,9,7,57,81,0 days 00:00:00.066534
react-native-image-picker/react-native-image-picker,2, v,37,22,8,86,123,0 days 00:00:00.246218
symfony/http-kernel,1,v,26,4,21,489,515,0 days 00:00:00.678048
chaijs/chai,2, v,30,11,9,48,78,0 days 00:00:00.142963
akveo/nebular,1,v,23,9,4,23,46,0 days 00:00:00.140866
QuantConnect/Lean,2, v,1917,1077,4,10,1927,0 days 00:00:05.390739
retejs/rete,2, v,12,4,3,35,47,0 days 00:00:00.046495
go-vgo/robotgo,2, v,21,4,9,24,45,0 days 00:00:00.088445
NginxProxyManager/nginx-proxy-manager,2, v,10,4,2,48,58,0 days 00:00:00.085686
dropwizard/metrics,1,v,10,1,8,77,87,0 days 00:00:00.323858
isaacs/node-glob,2, v,18,5,10,102,120,0 days 00:00:00.082498
HangfireIO/Hangfire,2,v v.,13,4,4,92,105,0 days 00:00:00.201650
secdev/scapy,1,v,80,71,8,432,512,0 days 00:00:00.734814
visionmedia/page.js,2, v,10,3,4,29,39,0 days 00:00:00.048985
xupefei/Locale-Emulator,2, v,13,7,5,14,27,0 days 00:00:00.030928
streamlink/streamlink,1,,30,9,7,17,47,0 days 00:00:00.431063
prometheus/node_exporter,2, v,17,2,12,11,28,0 days 00:00:00.135397
DaveGamble/cJSON,1,v,9,5,1,36,45,0 days 00:00:00.070341
guzzle/psr7,1,,12,1,9,17,29,0 days 00:00:00.050666
trustedsec/social-engineer-toolkit,1,,17,4,9,87,104,0 days 00:00:00.928993
metricsgraphics/metrics-graphics,3,v V v.,25,12,5,10,35,0 days 00:00:00.096166
twigphp/Twig,1,v,66,29,23,139,205,0 days 00:00:00.513554
InsertKoinIO/koin,1,,13,5,6,33,46,0 days 00:00:00.129128
doctrine/cache,2, v,17,4,9,27,44,0 days 00:00:00.070073
symfony/polyfill-mbstring,1,v,25,2,13,9,34,0 days 00:00:00.018050
FormidableLabs/radium,1,v,17,6,6,46,63,0 days 00:00:00.072514
react-cosmos/react-cosmos,2, v,33,18,8,41,74,0 days 00:00:00.228385
altair-viz/altair,2, v,13,3,7,8,21,0 days 00:00:00.194851
openspug/spug,2,v V,8,3,3,34,42,0 days 00:00:00.065343
ionic-team/capacitor,2, v,18,6,3,138,156,0 days 00:00:00.461939
wix/react-native-calendars,2, v,1248,229,2,59,1307,0 days 00:00:02.148038
webdriverio/webdriverio,1,v,91,65,12,415,506,0 days 00:00:01.245525
kelektiv/node-cron,2, v,12,2,8,23,35,0 days 00:00:00.046874
gogf/gf,1,v,14,2,4,106,120,0 days 00:00:00.320097
gotify/server,1,v,5,1,3,41,46,0 days 00:00:00.041221
webpack/webpack-dev-server,1,v,42,25,9,70,112,0 days 00:00:00.161600
krallin/tini,1,v,19,6,6,14,33,0 days 00:00:00.025576
oclif/oclif,1,v,59,50,5,261,320,0 days 00:00:00.254137
cryptomator/cryptomator,1,,18,7,6,73,91,0 days 00:00:00.371499
lanpa/tensorboardX,1,v,15,2,9,1,16,0 days 00:00:00.038621
facebook/jscodeshift,2, v,11,1,8,45,56,0 days 00:00:00.048547
LeetCode-OpenSource/vscode-leetcode,1,v,17,9,4,26,43,0 days 00:00:00.035696
lib/pq,1,v,11,3,5,10,21,0 days 00:00:00.056949
sosedoff/pgweb,1,v,11,6,3,31,42,0 days 00:00:00.064173
Supervisor/supervisor,1,,8,1,6,22,30,0 days 00:00:00.203854
sandboxie-plus/Sandboxie,2, v,11,3,4,58,69,0 days 00:00:00.127193
Sonarr/Sonarr,1,v,44,27,6,8,52,0 days 00:00:00.610713
numba/numba,2, v,54,9,8,51,105,0 days 00:00:01.723161
cerebroapp/cerebro,2, v,5,1,3,16,21,0 days 00:00:00.052539
mopidy/mopidy,1,v,29,6,16,38,67,0 days 00:00:00.738412
JeffreySu/WeiXinMPSDK,2, v,4,1,2,40,44,0 days 00:00:00.553671
i18next/react-i18next,2, v,84,68,6,164,248,0 days 00:00:00.185208
winsw/winsw,1,v,21,6,12,10,31,0 days 00:00:00.054299
symfony/debug,1,v,16,2,13,354,370,0 days 00:00:00.246189
fideloper/TrustedProxy,1,,13,1,11,11,24,0 days 00:00:00.025647
davemorrissey/subsampling-scale-image-view,1,v,13,7,5,8,21,0 days 00:00:00.027357
facebook/litho,1,v,41,25,3,157,198,0 days 00:00:01.064516
mamedev/mame,1,mame,124,89,11,0,124,0 days 00:00:05.773082
AlessandroZ/LaZagne,2, v,14,6,5,6,20,0 days 00:00:00.064155
be5invis/Sarasa-Gothic,1,v,25,12,8,93,118,0 days 00:00:00.059812
FluentValidation/FluentValidation,1,,49,14,24,60,109,0 days 00:00:00.154502
AppImage/AppImageKit,1,,13,4,8,0,13,0 days 00:00:00.129424
rocksdanister/lively,1,v,18,15,2,29,47,0 days 00:00:00.037874
xo/usql,1,v,10,4,5,22,32,0 days 00:00:00.047862
terkelg/prompts,1,v,9,2,4,24,33,0 days 00:00:00.028581
sebastianbergmann/php-timer,1,,7,1,3,19,26,0 days 00:00:00.028851
PointCloudLibrary/pcl,1,pcl-,13,2,8,12,25,0 days 00:00:01.045220
evilsocket/opensnitch,1,v,4,1,2,7,11,0 days 00:00:00.073831
MichalLytek/type-graphql,1,v,19,13,1,18,37,0 days 00:00:00.056502
cjbassi/gotop,1,,9,5,1,24,33,0 days 00:00:00.030385
pennersr/django-allauth,1,,42,13,18,13,55,0 days 00:00:00.161891
qemu/qemu,2,v release_,48,2,42,86,134,0 days 00:00:08.485928
smartystreets/goconvey,2, v,7,3,3,20,27,0 days 00:00:00.071043
styled-components/polished,2,v v.,22,12,6,56,78,0 days 00:00:00.065290
fancyapps/fancybox,3, v V,5,1,3,30,35,0 days 00:00:00.032146
ngrx/platform,2, v,35,19,5,25,60,0 days 00:00:00.113143
pytube/pytube,2, v,31,18,9,78,109,0 days 00:00:00.110889
inorganik/countUp.js,2, v,13,3,8,26,39,0 days 00:00:00.038099
chrisvfritz/prerender-spa-plugin,2, v,10,4,3,1,11,0 days 00:00:00.017914
barteksc/AndroidPdfViewer,1,,14,8,2,8,22,0 days 00:00:00.019328
sveltejs/sapper,1,v,29,23,4,149,178,0 days 00:00:00.145840
graphql-python/graphene,2,v v.,16,7,5,29,45,0 days 00:00:00.108664
jpillora/chisel,2, v,8,2,4,21,29,0 days 00:00:00.024071
angular/angularfire,2, v,11,2,5,28,39,0 days 00:00:00.100945
OWASP/Amass,2, v,37,25,6,123,160,0 days 00:00:00.156183
java-native-access/jna,2, v,26,3,18,32,58,0 days 00:00:00.266379
boto/boto3,1,,24,8,11,1045,1069,0 days 00:00:01.590296
leeoniya/uPlot,1,,7,3,1,44,51,0 days 00:00:00.080285
apache/cassandra,1,cassandra-,23,8,13,183,206,0 days 00:00:01.880694
marionettejs/backbone.marionette,1,v,32,15,10,93,125,0 days 00:00:00.243732
kekingcn/kkFileView,2, v,5,1,2,5,10,0 days 00:00:00.025176
es-shims/es5-shim,1,v,19,8,7,77,96,0 days 00:00:00.085610
sebastianbergmann/diff,1,,7,1,5,11,18,0 days 00:00:00.024012
lz4/lz4,2,v r,18,11,2,11,29,0 days 00:00:00.448529
nopSolutions/nopCommerce,1,release-,29,20,8,6,35,0 days 00:00:00.921815
surmon-china/vue-quill-editor,1,v,6,2,2,21,27,0 days 00:00:00.017650
pillarjs/path-to-regexp,2, v,24,9,11,28,52,0 days 00:00:00.034458
metafizzy/flickity,1,v,10,3,6,24,34,0 days 00:00:00.040182
vercel/styled-jsx,2, v,15,5,8,78,93,0 days 00:00:00.052247
symfony/routing,1,v,26,4,21,441,467,0 days 00:00:00.947901
yhirose/cpp-httplib,1,v,9,3,5,75,84,0 days 00:00:00.079541
ljharb/qs,1,v,25,11,10,49,74,0 days 00:00:00.068109
laravel/tinker,1,v,9,3,4,17,26,0 days 00:00:00.029021
google/android-classyshark,1,,15,9,3,0,15,0 days 00:00:00.041027
AmruthPillai/Reactive-Resume,1,v,7,4,2,24,31,0 days 00:00:00.204018
hrydgard/ppsspp,1,v,20,3,14,46,66,0 days 00:00:02.314114
jazzband/django-debug-toolbar,2, v,25,4,15,24,49,0 days 00:00:00.167600
Zettlr/Zettlr,3, v v.,28,14,6,49,77,0 days 00:00:00.453952
gitkraken/vscode-gitlens,2, v,45,33,4,91,136,0 days 00:00:00.233597
jemalloc/jemalloc,1,,22,4,14,24,46,0 days 00:00:00.245566
sebastianbergmann/php-file-iterator,1,,7,1,5,27,34,0 days 00:00:00.028564
symfony/css-selector,1,v,26,4,20,434,460,0 days 00:00:00.295179
encode/starlette,1,,19,8,5,94,113,0 days 00:00:00.247964
raineorshine/npm-check-updates,2, v,56,34,11,194,250,0 days 00:00:00.260950
symfony/process,1,v,26,4,21,450,476,0 days 00:00:00.361500
mqttjs/MQTT.js,2, v,42,22,7,109,151,0 days 00:00:00.123886
developit/microbundle,2, v,15,7,6,24,39,0 days 00:00:00.065096
phpmyadmin/phpmyadmin,2, RELEASE_,37,9,15,300,337,0 days 00:00:08.700269
TrinityCore/TrinityCore,1,TDB,74,41,22,6,80,0 days 00:00:03.168909
deepstreamIO/deepstream.io,2, v,25,7,8,98,123,0 days 00:00:00.136068
ThreeMammals/Ocelot,1,,31,19,6,110,141,0 days 00:00:00.343298
DevinVinson/WordPress-Plugin-Boilerplate,1,,9,5,2,5,14,0 days 00:00:00.034751
Turfjs/turf,2, v,23,15,5,65,88,0 days 00:00:00.219439
xmrig/xmrig,1,v,46,34,7,73,119,0 days 00:00:00.209066
FullHuman/purgecss,2, v,23,11,7,20,43,0 days 00:00:00.082940
reach/router,1,v,5,2,2,13,18,0 days 00:00:00.025578
final-form/react-final-form,2,v v.,23,16,3,47,70,0 days 00:00:00.050431
wallabag/wallabag,1,,20,6,10,40,60,0 days 00:00:00.573835
matthew-andrews/isomorphic-fetch,1,v,12,7,3,14,26,0 days 00:00:00.016976
projectstorm/react-diagrams,2, v,16,6,6,23,39,0 days 00:00:00.250089
reactjs/react-modal,1,v,19,7,6,91,110,0 days 00:00:00.057088
ffuf/ffuf,1,v,18,8,5,6,24,0 days 00:00:00.028682
readthedocs/readthedocs.org,1,,76,55,5,152,228,0 days 00:00:01.419093
symfony/var-dumper,1,v,20,4,15,355,375,0 days 00:00:00.280740
abel533/Mapper,1,,18,8,5,33,51,0 days 00:00:00.050914
jsplumb/jsplumb,1,,28,5,18,188,216,0 days 00:00:00.550204
trentm/node-bunyan,1,,33,18,7,81,114,0 days 00:00:00.069430
cosmtrek/air,1,v,5,1,2,18,23,0 days 00:00:00.022957
kennethreitz/records,1,v,5,3,1,6,11,0 days 00:00:00.026425
rr-debugger/rr,1,,28,9,14,6,34,0 days 00:00:00.343106
verlok/vanilla-lazyload,2, v,81,56,15,77,158,0 days 00:00:00.135059
cython/cython,1,,19,2,10,71,90,0 days 00:00:01.337330
taskflow/taskflow,1,v,13,3,8,1,14,0 days 00:00:00.107596
monero-project/monero,1,v,19,7,7,34,53,0 days 00:00:00.987070
musescore/MuseScore,1,v,11,1,9,24,35,0 days 00:00:01.776585
bigskysoftware/htmx,2, v,12,6,1,18,30,0 days 00:00:00.103901
Humanizr/Humanizer,3, v V,16,8,5,49,65,0 days 00:00:00.249351
guess-js/guess,2, v,4,1,2,42,46,0 days 00:00:00.047225
brunch/brunch,1,,24,11,8,107,131,0 days 00:00:00.270464
olivere/elastic,1,v,8,1,6,317,325,0 days 00:00:00.243024
reactiveui/ReactiveUI,2, v,41,24,6,181,222,0 days 00:00:00.756223
microsoft/DeepSpeed,1,v,6,1,3,36,42,0 days 00:00:00.076797
barry-ran/QtScrcpy,1,v,9,3,3,15,24,0 days 00:00:00.042502
monkeytypegame/monkeytype,1,v,16,6,1,111,127,0 days 00:00:00.408179
transmission/transmission,1,,99,69,12,1,100,0 days 00:00:00.811167
gobuffalo/buffalo,2, v,15,3,9,107,122,0 days 00:00:00.324629
filamentgroup/loadCSS,2, v,9,2,6,14,23,0 days 00:00:00.028495
ajenti/ajenti,2, v,5,2,2,123,128,0 days 00:00:00.293278
DylanVann/react-native-fast-image,1,v,20,8,7,90,110,0 days 00:00:00.063406
Nuitka/Nuitka,1,,13,8,4,238,251,0 days 00:00:00.653952
hashicorp/terraform-provider-aws,1,v,226,223,1,33,259,0 days 00:00:04.637103
ssssssss-team/spider-flow,1,v,5,3,1,6,11,0 days 00:00:00.033184
ds300/patch-package,1,v,17,9,3,40,57,0 days 00:00:00.056265
vercel/ncc,1,,31,21,4,46,77,0 days 00:00:00.055603
needim/noty,1,v,10,2,5,37,47,0 days 00:00:00.031707
tgalal/yowsup,1,v,8,3,4,20,28,0 days 00:00:00.081006
microsoft/azuredatastudio,2, v,40,28,2,89,129,0 days 00:00:00.807761
cssinjs/jss,2, v,60,41,8,86,146,0 days 00:00:00.158448
mongodb/mongo-go-driver,2, v,13,4,7,60,73,0 days 00:00:00.132325
alibaba/MNN,1,,13,9,3,36,49,0 days 00:00:00.085371
SigNoz/signoz,2, v,7,1,2,28,35,0 days 00:00:00.076572
cockpit-project/cockpit,2, v,314,303,8,1,315,0 days 00:00:01.458158
twpayne/chezmoi,1,v,27,16,4,106,133,0 days 00:00:00.224555
NLPchina/elasticsearch-sql,1,,46,21,13,144,190,0 days 00:00:00.117847
infracost/infracost,2, v,10,6,3,62,72,0 days 00:00:00.121457
SirVer/ultisnips,1,,11,2,7,0,11,0 days 00:00:00.111566
kazupon/vue-i18n,1,v,64,37,7,83,147,0 days 00:00:00.147303
ActivityWatch/activitywatch,1,v,8,4,3,11,19,0 days 00:00:00.048675
Vincit/objection.js,1,,19,3,10,101,120,0 days 00:00:00.136674
juice-shop/juice-shop,2, v,91,67,8,101,192,0 days 00:00:01.163905
lcobucci/jwt,1,,11,3,6,34,45,0 days 00:00:00.089201
jupyterhub/jupyterhub,1,,19,2,11,20,39,0 days 00:00:00.505318
sindresorhus/fkill-cli,2, v,23,9,10,3,26,0 days 00:00:00.016524
ElemeFE/v-charts,1,v,14,9,2,72,86,0 days 00:00:00.047360
BoyceLig/Clash_Chinese_Patch,1,,7,1,3,57,64,0 days 00:00:00.026677
open-policy-agent/opa,1,v,40,22,6,80,120,0 days 00:00:00.403476
sindresorhus/np,1,v,42,24,10,34,76,0 days 00:00:00.043445
schollz/howmanypeoplearearound,1,v,4,2,1,11,15,0 days 00:00:00.016085
aheckmann/gm,2, v,31,13,12,35,66,0 days 00:00:00.156007
Rob--W/cors-anywhere,2, v,3,1,1,18,21,0 days 00:00:00.018005
lucas-clemente/quic-go,2,v v.,24,5,10,33,57,0 days 00:00:00.576846
aws/aws-sdk-js,1,v,1089,1078,5,301,1390,0 days 00:00:02.707588
grpc/grpc-web,1,,7,4,2,9,16,0 days 00:00:00.057300
kanboard/kanboard,1,v,3,1,1,71,74,0 days 00:00:00.454530
xojs/xo,1,v,43,24,8,43,86,0 days 00:00:00.058563
gregberge/loadable-components,1,v,30,19,6,35,65,0 days 00:00:00.050895
enquirer/enquirer,1,,6,2,3,27,33,0 days 00:00:00.041880
hugapi/hug,1,,18,11,5,44,62,0 days 00:00:00.141681
Laravel-Lang/lang,1,,20,12,6,174,194,0 days 00:00:00.496963
electron/fiddle,2, v,29,14,3,22,51,0 days 00:00:00.116641
visgl/react-map-gl,2, v,22,10,9,143,165,0 days 00:00:00.137294
jaredpalmer/tsdx,1,v,13,6,3,40,53,0 days 00:00:00.053815
Hacker0x01/react-datepicker,2, v,107,85,2,73,180,0 days 00:00:00.248732
migueldeicaza/gui.cs,1,v,13,6,4,9,22,0 days 00:00:00.169951
flyway/flyway,1,flyway-,40,20,13,101,141,0 days 00:00:00.238351
wasabeef/glide-transformations,1,,9,3,5,10,19,0 days 00:00:00.023198
wailsapp/wails,1,v,19,10,2,44,63,0 days 00:00:00.230257
QUANTAXIS/QUANTAXIS,2, V,15,4,5,44,59,0 days 00:00:00.370330
josdejong/jsoneditor,1,v,71,48,11,125,196,0 days 00:00:00.155971
eclipse/che,1,,100,95,2,126,226,0 days 00:00:00.947529
grpc/grpc-java,1,v,52,22,4,58,110,0 days 00:00:00.425494
svgdotjs/svg.js,1,,50,38,8,48,98,0 days 00:00:00.109017
Sylius/Sylius,1,v,30,4,16,151,181,0 days 00:00:02.311454
stylelint/stylelint,2, v,97,78,4,88,185,0 days 00:00:00.485439
TranslucentTB/TranslucentTB,1,,14,7,6,0,14,0 days 00:00:00.098047
snapappointments/bootstrap-select,2, v,13,3,7,52,65,0 days 00:00:00.114234
mdbootstrap/material-design-for-bootstrap,1,,18,11,5,46,64,0 days 00:00:00.031493
addyosmani/critical,2, v,17,4,9,44,61,0 days 00:00:00.055361
sindresorhus/pageres,2, v,24,8,7,23,47,0 days 00:00:00.035021
iterative/dvc,1,,92,83,3,258,350,0 days 00:00:00.807338
react-native-camera/react-native-camera,1,v,84,69,5,96,180,0 days 00:00:00.443155
meliorence/react-native-snap-carousel,2,v V,22,15,2,29,51,0 days 00:00:00.040352
pockethub/PocketHub,2, v,11,5,3,9,20,0 days 00:00:00.193283
TarsCloud/Tars,2, v,15,7,4,32,47,0 days 00:00:00.065651
lvgl/lvgl,2, v,26,10,7,20,46,0 days 00:00:00.570223
jhen0409/react-native-debugger,1,v,12,3,7,74,86,0 days 00:00:00.063747
FormidableLabs/victory,1,v,65,43,8,156,221,0 days 00:00:00.776535
mswjs/msw,2, v,38,31,1,90,128,0 days 00:00:00.103917
apidoc/apidoc,1,,27,7,10,19,46,0 days 00:00:00.075068
Automattic/kue,2, v,10,2,7,47,57,0 days 00:00:00.073811
BookStackApp/BookStack,3, v v.,36,10,9,113,149,0 days 00:00:00.279503
senchalabs/connect,1,,52,27,11,174,226,0 days 00:00:00.432187
charmbracelet/glow,1,v,7,4,1,10,17,0 days 00:00:00.053636
argoproj/argo-cd,1,v,25,9,4,115,140,0 days 00:00:00.337205
vnotex/vnote,2, v,47,34,4,13,60,0 days 00:00:00.100903
botpress/botpress,2, v,88,76,4,234,322,0 days 00:00:01.078943
deepmind/sonnet,1,v,35,24,1,0,35,0 days 00:00:00.055294
catboost/catboost,3, v v.,25,7,3,57,82,0 days 00:00:01.323260
pinojs/pino,2, v,90,69,7,150,240,0 days 00:00:00.202184
future-architect/vuls,1,v,19,4,6,64,83,0 days 00:00:00.090115
dingo/api,2, v,16,9,5,41,57,0 days 00:00:00.103165
r-spacex/SpaceX-API,2, v,15,9,3,8,23,0 days 00:00:00.112498
uncss/uncss,1,,9,2,5,9,18,0 days 00:00:00.050985
Atmosphere-NX/Atmosphere,1,,18,7,6,48,66,0 days 00:00:00.220017
upx/upx,1,v,31,7,18,0,31,0 days 00:00:00.262260
oblador/react-native-animatable,1,v,10,4,4,13,23,0 days 00:00:00.021034
reactjs/react-transition-group,1,v,19,9,7,19,38,0 days 00:00:00.041646
FormidableLabs/spectacle,2, v,35,12,11,77,112,0 days 00:00:00.198492
acaudwell/Gource,1,gource-,20,5,11,0,20,0 days 00:00:00.069951
deployphp/deployer,1,v,20,6,9,47,67,0 days 00:00:00.128434
squizlabs/PHP_CodeSniffer,1,,19,5,12,51,70,0 days 00:00:00.527971
arasatasaygin/is.js,1,v,8,5,2,13,21,0 days 00:00:00.037802
mongodb/node-mongodb-native,3,v V v.,25,4,18,387,412,0 days 00:00:00.875658
cheat/cheat,1,,18,10,4,67,85,0 days 00:00:00.089970
exceljs/exceljs,2, v,41,28,7,180,221,0 days 00:00:00.221038
docmirror/dev-sidecar,2, v,7,3,2,16,23,0 days 00:00:00.044242
hackware1993/MagicIndicator,1,,8,4,2,5,13,0 days 00:00:00.018924
coredns/coredns,1,v,20,7,7,42,62,0 days 00:00:00.196624
chimurai/http-proxy-middleware,1,v,26,19,6,30,56,0 days 00:00:00.037067
callstack/react-native-paper,2, v,53,40,5,61,114,0 days 00:00:00.125447
bulletphysics/bullet3,1,,18,5,9,6,24,0 days 00:00:00.670803
direnv/direnv,2, v,33,8,16,42,75,0 days 00:00:00.076117
boardgameio/boardgame.io,1,v,39,28,4,111,150,0 days 00:00:00.142350
phpDocumentor/ReflectionDocBlock,1,,14,4,8,24,38,0 days 00:00:00.060961
javascript-obfuscator/javascript-obfuscator,1,,63,47,4,122,185,0 days 00:00:00.188783
rough-stuff/wired-elements,1,v,9,2,4,26,35,0 days 00:00:00.033560
crimx/ext-saladict,3, v V,59,47,6,139,198,0 days 00:00:00.337294
ydataai/pandas-profiling,2,v v.,20,10,7,14,34,0 days 00:00:00.069252
coleifer/peewee,1,,35,12,13,139,174,0 days 00:00:00.386208
cure53/DOMPurify,2, v,12,3,8,68,80,0 days 00:00:00.112437
aksonov/react-native-router-flux,2, v,13,3,6,34,47,0 days 00:00:00.106105
Gallopsled/pwntools,1,,26,5,8,35,61,0 days 00:00:00.366211
didi/cube-ui,2, v,13,10,1,69,82,0 days 00:00:00.134279
react-dropzone/react-dropzone,2, v,55,34,12,120,175,0 days 00:00:00.091101
pyinstaller/pyinstaller,2, v,28,5,19,6,34,0 days 00:00:00.676204
sinonjs/sinon,2, v,57,27,18,121,178,0 days 00:00:00.266073
ginuerzh/gost,2, v,21,11,7,11,32,0 days 00:00:00.049391
symfony/console,1,v,26,4,21,466,492,0 days 00:00:00.613365
thumbor/thumbor,1,,61,33,14,178,239,0 days 00:00:00.210644
paulmillr/chokidar,1,,28,10,14,70,98,0 days 00:00:00.111702
helmetjs/helmet,1,v,51,23,8,34,85,0 days 00:00:00.088105
inversify/InversifyJS,2, v,25,15,7,22,47,0 days 00:00:00.095751
callstack/linaria,1,v,14,9,4,24,38,0 days 00:00:00.054822
mayswind/AriaNg,1,,9,1,6,14,23,0 days 00:00:00.046182
sonic-pi-net/sonic-pi,1,v,16,5,7,9,25,0 days 00:00:00.712375
dromara/Sa-Token,1,v,23,18,2,1,24,0 days 00:00:00.055066
capnproto/capnproto,1,v,9,1,6,12,21,0 days 00:00:00.259615
marmelab/gremlins.js,2, v,5,1,3,2,7,0 days 00:00:00.032576
didi/chameleon,2, v,4,1,1,19,23,0 days 00:00:00.088077
phpDocumentor/TypeResolver,1,,14,2,9,18,32,0 days 00:00:00.041455
gka/chroma.js,2, v,9,3,5,26,35,0 days 00:00:00.043359
aws/chalice,1,,38,17,8,43,81,0 days 00:00:00.157809
OWASP/owasp-mstg,2, v,5,1,3,7,12,0 days 00:00:00.569238
PrefectHQ/prefect,1,,17,5,6,102,119,0 days 00:00:00.919061
crawlab-team/crawlab,1,v,6,1,3,21,27,0 days 00:00:00.140237
fkhadra/react-toastify,1,v,33,16,8,60,93,0 days 00:00:00.200224
react-page/react-page,2, v,58,45,6,214,272,0 days 00:00:00.182303
heartexlabs/label-studio,2,v v.,14,4,2,24,38,0 days 00:00:00.139081
antvis/G6,1,,9,2,3,64,73,0 days 00:00:00.362061
TuSimple/naive-ui,2, v,26,23,1,70,96,0 days 00:00:00.529202
webtorrent/webtorrent-desktop,1,v,25,18,5,13,38,0 days 00:00:00.247002
facebook/chisel,1,,10,1,6,3,13,0 days 00:00:00.045245
facebookresearch/ParlAI,2, v,10,5,2,10,20,0 days 00:00:00.226862
remarkjs/react-markdown,2, v,22,7,11,46,68,0 days 00:00:00.057696
tinode/chat,1,v,6,1,4,45,51,0 days 00:00:00.270627
encode/httpx,1,,23,10,4,47,70,0 days 00:00:00.089926
golang-migrate/migrate,1,v,24,7,7,25,49,0 days 00:00:00.104883
tweepy/tweepy,2, v,40,17,15,4,44,0 days 00:00:00.204184
Aircoookie/WLED,1,v,8,1,6,15,23,0 days 00:00:00.118329
zerotier/ZeroTierOne,1,,15,4,6,68,83,0 days 00:00:00.330533
GoogleChromeLabs/comlink,1,v,15,8,4,23,38,0 days 00:00:00.068128
cert-manager/cert-manager,1,v,25,3,3,49,74,0 days 00:00:00.626341
OpenRefine/OpenRefine,2, v,13,1,10,9,22,0 days 00:00:00.498260
coursera-dl/coursera-dl,1,,8,1,5,12,20,0 days 00:00:00.081241
mementum/backtrader,1,,7,2,1,132,139,0 days 00:00:00.135672
desandro/imagesloaded,1,v,11,3,5,27,38,0 days 00:00:00.024049
gregberge/svgr,1,v,36,29,4,19,55,0 days 00:00:00.068684
ultralytics/yolov3,1,v,12,6,4,0,12,0 days 00:00:00.132444
libretro/RetroArch,2, v,15,3,7,77,92,0 days 00:00:03.625907
mapeditor/tiled,1,v,27,3,20,56,83,0 days 00:00:00.492266
caprover/caprover,2,v V,12,6,5,17,29,0 days 00:00:00.098851
pyodide/pyodide,2, v,20,11,6,25,45,0 days 00:00:00.125563
cefsharp/CefSharp,1,v,27,5,11,70,97,0 days 00:00:00.519685
piskelapp/piskel,1,v,14,2,9,16,30,0 days 00:00:00.121476
microsoft/Windows-universal-samples,2, v,438,13,9,171,609,0 days 00:00:00.455275
cyrus-and/gdb-dashboard,1,v,15,6,8,15,30,0 days 00:00:00.032133
questdb/questdb,2, v,12,1,8,39,51,0 days 00:00:00.191781
tweenjs/tween.js,3, v r,30,12,12,23,53,0 days 00:00:00.064019
spotDL/spotify-downloader,1,v,14,4,4,38,52,0 days 00:00:00.091826
EpistasisLab/tpot,2, v,9,1,5,15,24,0 days 00:00:00.139606
mailpile/Mailpile,1,,5,1,2,6,11,0 days 00:00:00.354654
openframeworks/openFrameworks,1,,10,1,6,16,26,0 days 00:00:01.357663
Automattic/node-canvas,2, v,30,11,13,88,118,0 days 00:00:00.225165
aws/serverless-application-model,2, v,42,25,6,9,51,0 days 00:00:00.076307
doctrine/dbal,2, v,18,2,14,79,97,0 days 00:00:00.805393
claudiodangelis/qrcp,1,,6,2,3,17,23,0 days 00:00:00.025712
XTLS/Xray-core,1,v,6,3,1,21,27,0 days 00:00:00.033026
muesli/duf,1,v,8,5,2,4,12,0 days 00:00:00.019636
Justson/AgentWeb,2, v,4,1,1,13,17,0 days 00:00:00.039116
google/go-github,1,v,59,43,6,35,94,0 days 00:00:00.165041
pytest-dev/pytest,1,,42,10,17,122,164,0 days 00:00:01.153446
nextapps-de/flexsearch,1,,4,2,1,13,17,0 days 00:00:00.024584
pmndrs/jotai,1,v,24,17,1,88,112,0 days 00:00:00.079836
jprichardson/node-fs-extra,2, v,43,18,12,42,85,0 days 00:00:00.082661
welldone-software/why-did-you-render,2,v v.,19,8,6,67,86,0 days 00:00:00.047457
Shopify/sarama,1,v,34,10,15,18,52,0 days 00:00:00.193845
listen1/listen1_chrome_extension,1,v,32,22,7,36,68,0 days 00:00:00.045005
MarshallOfSound/Google-Play-Music-Desktop-Player-UNOFFICIAL-,2, v,26,17,3,32,58,0 days 00:00:00.096755
wkentaro/labelme,1,v,50,38,9,125,175,0 days 00:00:00.145528
shipshapecode/tether,1,v,13,6,4,60,73,0 days 00:00:00.177339
gskinner/regexr,1,,5,2,1,6,11,0 days 00:00:00.024652
tsayen/dom-to-image,1,,13,7,3,23,36,0 days 00:00:00.031780
restsharp/RestSharp,2, v,30,14,11,29,59,0 days 00:00:00.176104
blevesearch/bleve,1,v,14,3,7,27,41,0 days 00:00:00.187708
chakra-core/ChakraCore,1,v,9,1,3,52,61,0 days 00:00:01.033292
OnsenUI/OnsenUI,1,,20,6,8,68,88,0 days 00:00:00.693517
nilaoda/N_m3u8DL-CLI,1,,18,9,3,65,83,0 days 00:00:00.038783
James-Yu/LaTeX-Workshop,1,v,89,74,1,126,215,0 days 00:00:00.357223
node-schedule/node-schedule,2, v,10,3,5,36,46,0 days 00:00:00.035524
jwtk/jjwt,1,,11,4,6,15,26,0 days 00:00:00.040247
nodejs/node-gyp,2, v,37,7,18,98,135,0 days 00:00:00.115657
giampaolo/psutil,1,release-,32,8,17,52,84,0 days 00:00:00.318985
rq/rq,2, v,24,2,15,44,68,0 days 00:00:00.112983
cesanta/mongoose,1,,43,12,22,1,44,0 days 00:00:00.311818
KurtBestor/Hitomi-Downloader,1,v,17,3,8,0,17,0 days 00:00:00.019047
projectdiscovery/nuclei,2,v v.,10,2,6,43,53,0 days 00:00:00.206616
junit-team/junit4,1,r,8,1,6,5,13,0 days 00:00:00.161267
cytoscape/cytoscape.js,1,v,29,10,13,198,227,0 days 00:00:00.534831
HabitRPG/habitica,2, v,351,348,2,612,963,0 days 00:00:02.792802
Nozbe/WatermelonDB,1,v,19,5,6,17,36,0 days 00:00:00.209162
panjf2000/ants,1,v,9,4,4,15,24,0 days 00:00:00.042471
chocolatey/choco,1,,5,1,2,38,43,0 days 00:00:00.222958
MonoGame/MonoGame,2, v,12,1,9,4,16,0 days 00:00:01.034703
uber/react-vis,2, v,22,14,3,77,99,0 days 00:00:00.096446
sebastianbergmann/php-code-coverage,1,,23,4,13,138,161,0 days 00:00:00.318503
borgbackup/borg,1,,22,13,5,36,58,0 days 00:00:00.599729
myclabs/DeepCopy,1,,12,1,10,18,30,0 days 00:00:00.026397
agenda/agenda,2, v,20,5,11,65,85,0 days 00:00:00.085007
dat-ecosystem-archive/dat,1,v,43,31,8,64,107,0 days 00:00:00.148165
benoitc/gunicorn,1,,31,12,14,51,82,0 days 00:00:00.188138
square/moshi,1,moshi-parent-,15,1,12,4,19,0 days 00:00:00.080373
protobufjs/protobuf.js,2, v,23,11,6,55,78,0 days 00:00:00.086163
stanfordnlp/CoreNLP,1,v,11,5,3,12,23,0 days 00:00:01.008957
libgit2/libgit2,1,v,29,7,16,48,77,0 days 00:00:01.267986
MahApps/MahApps.Metro,1,,21,5,11,33,54,0 days 00:00:00.455819
coil-kt/coil,1,,15,5,6,12,27,0 days 00:00:00.070260
NG-ZORRO/ng-zorro-antd,1,,41,30,5,65,106,0 days 00:00:00.162255
jopohl/urh,1,v,17,8,7,74,91,0 days 00:00:00.253362
devhubapp/devhub,2, v,55,47,3,61,116,0 days 00:00:00.213854
vector-im/element-web,1,v,27,9,9,172,199,0 days 00:00:01.024869
pre-commit/pre-commit,1,v,60,32,9,111,171,0 days 00:00:00.271007
bloomrpc/bloomrpc,2, v,6,2,3,9,15,0 days 00:00:00.018070
tidwall/tile38,1,,27,6,7,59,86,0 days 00:00:00.087201
lima-vm/lima,1,v,11,6,1,16,27,0 days 00:00:00.081912
hediet/vscode-drawio,1,v,10,6,2,13,23,0 days 00:00:00.028463
OpenFeign/feign,3, v release-,72,48,10,54,126,0 days 00:00:00.118999
googleapis/google-api-php-client,2, v,13,2,8,32,45,0 days 00:00:00.213497
ninja-build/ninja,2,release- v,14,1,10,12,26,0 days 00:00:00.201557
olivernn/lunr.js,1,v,12,1,6,46,58,0 days 00:00:00.057619
knadh/listmonk,1,v,4,1,2,0,4,0 days 00:00:00.064313
resilience4j/resilience4j,3, v v.,22,5,9,15,37,0 days 00:00:00.088895
dropwizard/dropwizard,1,v,15,1,11,119,134,0 days 00:00:00.661585
google/or-tools,1,v,32,7,8,3,35,0 days 00:00:00.698800
paragonie/random_compat,2, v,7,3,1,54,61,0 days 00:00:00.038587
apache/tvm,1,v,7,1,5,1,8,0 days 00:00:00.431405
symfony/http-foundation,1,v,26,4,21,464,490,0 days 00:00:00.544419
happyfish100/fastdfs,1,V,16,7,5,0,16,0 days 00:00:00.023600
PaddlePaddle/PaddleHub,2, v,12,3,1,10,22,0 days 00:00:00.120457
rofl0r/proxychains-ng,1,v,16,3,10,1,17,0 days 00:00:00.029250
symfony/event-dispatcher,1,v,26,4,21,436,462,0 days 00:00:00.432789
electron/electron-packager,1,v,53,30,10,42,95,0 days 00:00:00.200060
Koenkk/zigbee2mqtt,1,,28,16,5,33,61,0 days 00:00:00.235243
shwenzhang/AndResGuard,1,,3,1,1,35,38,0 days 00:00:00.043606
OpenIMSDK/Open-IM-Server,1,v,3,1,1,15,18,0 days 00:00:00.106355
VulcanJS/Vulcan,2, v,22,11,6,45,67,0 days 00:00:00.485141
sockjs/sockjs-client,1,v,11,1,7,20,31,0 days 00:00:00.062768
Stuk/jszip,1,v,19,5,11,14,33,0 days 00:00:00.055341
symfony/finder,1,v,26,4,20,440,466,0 days 00:00:00.331802
dotnet/machinelearning,1,v,18,12,4,5,23,0 days 00:00:00.322976
szimek/signature_pad,1,v,11,3,4,19,30,0 days 00:00:00.034061
sahat/satellizer,1,,14,7,4,41,55,0 days 00:00:00.244930
ng-bootstrap/ng-bootstrap,1,,27,12,6,49,76,0 days 00:00:00.154874
airbnb/epoxy,1,,41,26,5,22,63,0 days 00:00:00.050223
ag-grid/ag-grid,2, v,87,62,5,103,190,0 days 00:00:01.863684
smicallef/spiderfoot,1,v,8,1,6,1,9,0 days 00:00:00.242383
arrow-py/arrow,1,,17,3,11,37,54,0 days 00:00:00.096721
adrai/flowchart.js,1,v,17,4,9,31,48,0 days 00:00:00.027654
Jguer/yay,1,v,49,33,9,26,75,0 days 00:00:00.140318
ChrisRM/material-theme-jetbrains,2, v,83,68,2,163,246,0 days 00:00:00.283391
Pikaday/Pikaday,1,,9,1,7,6,15,0 days 00:00:00.037782
pypa/pip,1,,36,2,27,73,109,0 days 00:00:01.037652
grommet/grommet,2, v,41,18,8,76,117,0 days 00:00:00.352879
doitsujin/dxvk,1,v,40,30,5,32,72,0 days 00:00:00.269122
tiangolo/typer,1,,4,1,1,15,19,0 days 00:00:00.124253
mediaelement/mediaelement,1,,32,8,12,117,149,0 days 00:00:00.364721
mjmlio/mjml,3, v V,25,8,11,50,75,0 days 00:00:00.178244
abpframework/abp,2, v,43,33,3,60,103,0 days 00:00:01.745006
firefly-iii/firefly-iii,1,,41,19,8,201,242,0 days 00:00:01.169788
huggingface/datasets,1,,26,21,1,26,52,0 days 00:00:00.193073
wtfutil/wtf,2, v,41,26,1,26,67,0 days 00:00:00.303509
google/cadvisor,2, v,45,20,15,71,116,0 days 00:00:00.265678
justauth/JustAuth,3, v v.,14,9,2,25,39,0 days 00:00:00.046353
zalmoxisus/redux-devtools-extension,2, v,27,23,2,43,70,0 days 00:00:00.062419
d2l-ai/d2l-en,1,v,8,1,4,17,25,0 days 00:00:00.416460
videolan/vlc,1,,9,1,3,50,59,0 days 00:00:05.445205
grpc-ecosystem/grpc-gateway,1,v,28,10,10,43,71,0 days 00:00:00.126547
automerge/automerge,1,v,13,4,6,20,33,0 days 00:00:00.067544
openshift/origin,1,v,14,2,10,25,39,0 days 00:00:02.426843
orhanobut/logger,2, v,13,7,3,1,14,0 days 00:00:00.018560
JustArchiNET/ArchiSteamFarm,1,,167,154,10,431,598,0 days 00:00:01.222337
Tencent/APIJSON,1,,37,21,7,51,88,0 days 00:00:00.167167
android-hacker/VirtualXposed,2, v,12,3,3,55,67,0 days 00:00:00.112457
keybase/client,2, v,29,21,4,65,94,0 days 00:00:02.288371
powerline/powerline,1,,13,3,7,10,23,0 days 00:00:00.253873
fabric/fabric,1,,26,4,19,97,123,0 days 00:00:00.327102
liabru/matter-js,1,,10,1,7,8,18,0 days 00:00:00.062758
verdaccio/verdaccio,1,v,64,34,13,148,212,0 days 00:00:00.445862
microsoft/AirSim,2,v v.,3,1,1,15,18,0 days 00:00:00.099474
authelia/authelia,1,v,55,39,5,114,169,0 days 00:00:00.378522
qutebrowser/qutebrowser,1,v,32,4,16,49,81,0 days 00:00:01.599919
RaRe-Technologies/gensim,1,,23,6,11,36,59,0 days 00:00:00.271043
ahmetb/kubectx,1,v,9,2,5,11,20,0 days 00:00:00.026659
flipped-aurora/gin-vue-admin,3,v V v.,7,2,2,21,28,0 days 00:00:00.148696
mdx-js/mdx,2, v,26,19,5,140,166,0 days 00:00:00.157111
txthinking/brook,1,v,43,22,6,0,43,0 days 00:00:00.058064
getgrav/grav,1,,13,3,8,170,183,0 days 00:00:00.631301
brix/crypto-js,2, release-,4,2,1,10,14,0 days 00:00:00.021320
modood/Administrative-divisions-of-China,1,,9,1,7,7,16,0 days 00:00:00.015002
microsoft/recommenders,1,,9,3,3,2,11,0 days 00:00:00.595484
timescale/timescaledb,1,,28,8,8,33,61,0 days 00:00:00.367789
remotion-dev/remotion,1,v,14,8,1,81,95,0 days 00:00:00.362337
xtaci/kcptun,2, v,106,79,7,0,106,0 days 00:00:00.075196
termux/termux-app,1,v,89,73,7,0,89,0 days 00:00:00.099370
bcicen/ctop,2, v,5,2,2,11,16,0 days 00:00:00.038766
WerWolv/ImHex,1,v,19,14,2,12,31,0 days 00:00:00.087562
python/mypy,1,v,59,38,8,7,66,0 days 00:00:00.764094
selectize/selectize.js,1,v,12,5,2,64,76,0 days 00:00:00.068930
gionkunz/chartist-js,1,v,11,6,4,47,58,0 days 00:00:00.071594
redwoodjs/redwood,2, v,57,53,1,71,128,0 days 00:00:00.438193
http-party/node-http-proxy,2, v,27,11,13,70,97,0 days 00:00:00.118151
arduino/Arduino,1,,26,5,13,46,72,0 days 00:00:00.386499
xtermjs/xterm.js,1,,76,52,7,35,111,0 days 00:00:00.597697
filp/whoops,1,,18,6,8,50,68,0 days 00:00:00.154255
freebsd/freebsd-src,1,release/,62,3,58,16,78,0 days 00:00:20.040410
wechaty/wechaty,1,v,15,4,7,8,23,0 days 00:00:00.295479
you-dont-need/You-Dont-Need-Momentjs,1,v,6,3,2,5,11,0 days 00:00:00.019782
DIYgod/DPlayer,2, v,21,12,5,21,42,0 days 00:00:00.074903
umijs/qiankun,1,v,14,4,7,92,106,0 days 00:00:00.073783
mockito/mockito,1,v,58,32,10,409,467,0 days 00:00:00.877826
CachetHQ/Cachet,1,v,7,1,2,30,37,0 days 00:00:00.282610
faressoft/terminalizer,1,v,6,3,1,25,31,0 days 00:00:00.022047
rwaldron/johnny-five,2, v,14,3,7,73,87,0 days 00:00:00.254569
Semantic-Org/Semantic-UI-React,1,v,93,78,5,211,304,0 days 00:00:00.411147
Intervention/image,1,,15,3,8,93,108,0 days 00:00:00.071430
GoogleContainerTools/skaffold,1,v,80,76,1,29,109,0 days 00:00:00.851166
charmbracelet/bubbletea,1,v,20,14,4,27,47,0 days 00:00:00.049933
revel/revel,1,v,18,4,10,7,25,0 days 00:00:00.113564
showdownjs/showdown,2, v,14,3,7,42,56,0 days 00:00:00.054816
redux-form/redux-form,1,v,46,30,8,141,187,0 days 00:00:00.172238
onnx/onnx,1,v,13,1,10,9,22,0 days 00:00:00.130156
moment/luxon,1,,37,21,6,69,106,0 days 00:00:00.082597
Foundry376/Mailspring,1,,11,1,6,43,54,0 days 00:00:00.477521
psf/requests-html,1,v,8,6,1,22,30,0 days 00:00:00.034435
google/gvisor,1,release-,99,94,2,0,99,0 days 00:00:00.579960
bvaughn/react-window,1,,4,2,1,16,20,0 days 00:00:00.034220
pqina/filepond,1,,52,41,4,143,195,0 days 00:00:00.111465
horovod/horovod,1,v,16,3,10,53,69,0 days 00:00:00.090441
openstf/stf,1,v,12,4,7,16,28,0 days 00:00:00.135779
Budibase/budibase,1,v,10,5,3,479,489,0 days 00:00:01.743261
thephpleague/flysystem,1,,13,2,6,175,188,0 days 00:00:00.194040
surmon-china/vue-awesome-swiper,2, v,14,5,5,36,50,0 days 00:00:00.030124
uuidjs/uuid,1,v,16,6,8,21,37,0 days 00:00:00.043259
barryvdh/laravel-ide-helper,1,v,25,8,15,61,86,0 days 00:00:00.072458
danilowoz/react-content-loader,2, v,16,6,8,27,43,0 days 00:00:00.031852
OptimalBits/bull,2, v,49,26,13,84,133,0 days 00:00:00.257968
pyecharts/pyecharts,1,v,14,4,6,29,43,0 days 00:00:00.172315
liriliri/eruda,1,v,15,6,5,40,55,0 days 00:00:00.051526
wkhtmltopdf/wkhtmltopdf,1,,8,4,3,31,39,0 days 00:00:00.068296
scylladb/scylla,1,scylla-,33,11,10,130,163,0 days 00:00:02.903625
gaearon/react-hot-loader,2, v,25,13,6,107,132,0 days 00:00:00.141952
MaterialDesignInXAML/MaterialDesignInXamlToolkit,2, v,21,5,12,12,33,0 days 00:00:00.248258
aquasecurity/trivy,1,v,28,19,2,59,87,0 days 00:00:00.078169
josdejong/mathjs,1,v,109,83,4,118,227,0 days 00:00:00.418358
11ty/eleventy,1,v,13,2,7,41,54,0 days 00:00:00.128105
visionmedia/supertest,2, v,29,8,13,29,58,0 days 00:00:00.043689
rt2zz/redux-persist,1,v,36,27,6,76,112,0 days 00:00:00.075398
tensorflow/tensor2tensor,3, v v.,15,5,4,61,76,0 days 00:00:00.364989
systemjs/systemjs,2, v,40,18,10,187,227,0 days 00:00:00.185852
oliver-moran/jimp,2, v,15,8,4,71,86,0 days 00:00:00.067827
tabler/tabler-icons,1,v,69,65,2,15,84,0 days 00:00:00.078367
lra/mackup,1,,8,4,3,53,61,0 days 00:00:00.137950
casbin/casbin,1,v,68,52,5,118,186,0 days 00:00:00.151467
foambubble/foam,1,v,17,10,3,44,61,0 days 00:00:00.069243
Delgan/loguru,1,,6,1,4,12,18,0 days 00:00:00.041756
arut/nginx-rtmp-module,1,v,12,5,3,100,112,0 days 00:00:00.077427
carloscuesta/gitmoji,1,v,13,5,2,5,18,0 days 00:00:00.047319
webpack-contrib/webpack-bundle-analyzer,1,v,32,19,8,34,66,0 days 00:00:00.052709
http-party/http-server,2, v,15,2,10,30,45,0 days 00:00:00.054430
mlflow/mlflow,2, v,35,21,1,20,55,0 days 00:00:00.219592
Miserlou/Zappa,2, v,50,42,3,71,121,0 days 00:00:00.202327
aurelia/framework,1,,23,16,5,32,55,0 days 00:00:00.066094
react-dates/react-dates,1,v,78,74,1,81,159,0 days 00:00:00.173748
jaredreich/pell,1,v,6,4,1,6,12,0 days 00:00:00.014431
roots/sage,2, v,27,10,12,35,62,0 days 00:00:00.164710
FaridSafi/react-native-gifted-chat,2, v,16,6,7,46,62,0 days 00:00:00.082673
ramsey/uuid,1,,26,6,14,37,63,0 days 00:00:00.087997
Tamsiree/RxTool,2, v,15,7,4,177,192,0 days 00:00:00.103196
karma-runner/karma,2, v,35,14,12,198,233,0 days 00:00:00.240710
NodeBB/NodeBB,1,v,30,2,17,93,123,0 days 00:00:01.441447
ben-manes/caffeine,2, v,16,4,7,45,61,0 days 00:00:00.089535
Tonejs/Tone.js,2, r,12,1,8,4,16,0 days 00:00:00.364184
flairNLP/flair,1,v,11,1,6,12,23,0 days 00:00:00.256596
segmentio/evergreen,1,v,51,39,2,84,135,0 days 00:00:00.272736
emirpasic/gods,1,v,19,14,3,6,25,0 days 00:00:00.040056
NetEase/pomelo,2, v,9,1,4,84,93,0 days 00:00:00.071567
keycloak/keycloak,1,,16,3,7,21,37,0 days 00:00:01.293505
AdguardTeam/AdGuardHome,1,v,19,6,4,31,50,0 days 00:00:00.246161
LuckSiege/PictureSelector,2,v v.,12,6,5,91,103,0 days 00:00:00.188923
ranger/ranger,1,v,10,1,8,31,41,0 days 00:00:00.236479
PuerkitoBio/goquery,1,v,12,1,8,10,22,0 days 00:00:00.033768
QL-Win/QuickLook,2, v,4,1,1,38,42,0 days 00:00:00.050647
go-chi/chi,1,v,12,1,5,27,39,0 days 00:00:00.051707
OpenAPITools/openapi-generator,2, v,16,2,11,38,54,0 days 00:00:01.207369
mikepenz/MaterialDrawer,1,v,35,19,8,166,201,0 days 00:00:00.297503
microsoft/nni,1,v,27,9,2,16,43,0 days 00:00:00.209506
apexcharts/apexcharts.js,2, v,32,15,3,54,86,0 days 00:00:00.146341
koekeishiya/yabai,1,v,12,5,1,34,46,0 days 00:00:00.065562
rjsf-team/react-jsonschema-form,1,v,71,56,6,52,123,0 days 00:00:00.105901
thingsboard/thingsboard,1,v,15,2,7,33,48,0 days 00:00:00.665058
meolu/walle-web,1,v,13,8,1,6,19,0 days 00:00:00.067976
mifi/lossless-cut,1,v,70,52,9,67,137,0 days 00:00:00.137982
netchx/netch,2, v,6,1,3,47,53,0 days 00:00:00.113117
sindresorhus/got,1,v,70,49,11,71,141,0 days 00:00:00.155926
spicetify/spicetify-cli,2,v v.,23,14,5,52,75,0 days 00:00:00.157622
d2-projects/d2-admin,2, v,25,17,4,62,87,0 days 00:00:00.187792
hotwired/stimulus,1,v,12,5,4,14,26,0 days 00:00:00.069939
rizinorg/cutter,1,v,14,6,5,16,30,0 days 00:00:00.144026
nexe/nexe,1,v,5,2,1,14,19,0 days 00:00:00.048604
bettercap/bettercap,1,v,33,23,5,10,43,0 days 00:00:00.125509
apache/druid,1,druid-,18,1,13,366,384,0 days 00:00:01.028082
nock/nock,2, v,125,108,13,181,306,0 days 00:00:00.405982
graphile/postgraphile,1,v,35,20,7,60,95,0 days 00:00:00.164529
java-decompiler/jd-gui,1,v,7,5,1,11,18,0 days 00:00:00.023395
cloudwu/skynet,1,v,15,7,6,18,33,0 days 00:00:00.120539
wenzhixin/bootstrap-table,1,,18,3,9,39,57,0 days 00:00:00.279106
pagehelper/Mybatis-PageHelper,1,v,18,9,6,42,60,0 days 00:00:00.050067
searx/searx,2, v,14,1,12,3,17,0 days 00:00:00.294221
slimphp/Slim,1,,40,11,21,55,95,0 days 00:00:00.398188
conventional-changelog/commitlint,1,v,47,28,10,89,136,0 days 00:00:00.259495
kubernetes/dashboard,1,v,15,1,10,20,35,0 days 00:00:00.258918
single-spa/single-spa,2, v,29,15,10,85,114,0 days 00:00:00.071542
antvis/G2,2, v,13,2,8,144,157,0 days 00:00:00.365275
PHPOffice/PhpSpreadsheet,1,,24,6,7,10,34,0 days 00:00:00.311564
ccampbell/mousetrap,1,,7,1,5,21,28,0 days 00:00:00.029856
video-dev/hls.js,1,v,16,2,9,185,201,0 days 00:00:00.657791
google/brotli,1,v,6,1,4,10,16,0 days 00:00:00.067946
micro/micro,2, v,62,46,2,37,99,0 days 00:00:00.376386
nightwatchjs/nightwatch,1,v,16,1,9,207,223,0 days 00:00:00.254362
argoproj/argo-workflows,2, v,23,7,9,102,125,0 days 00:00:00.363806
mail-in-a-box/mailinabox,1,v,45,16,11,0,45,0 days 00:00:00.128925
RPCS3/rpcs3,1,v,5,1,3,21,26,0 days 00:00:00.829174
ajv-validator/ajv,2, v,71,54,6,89,160,0 days 00:00:00.206923
davisking/dlib,1,v,55,14,13,0,55,0 days 00:00:00.553739
SFTtech/openage,1,v,5,2,2,4,9,0 days 00:00:00.203702
allenai/allennlp,2, v,24,7,5,23,47,0 days 00:00:00.178784
FriendsOfPHP/PHP-CS-Fixer,1,v,48,26,14,148,196,0 days 00:00:00.587915
baidu/amis,1,,9,5,2,37,46,0 days 00:00:00.374330
jquery/jquery-ui,1,,8,1,6,38,46,0 days 00:00:00.587525
keeweb/keeweb,1,v,25,10,9,103,128,0 days 00:00:00.373617
tomnomnom/gron,2, v,7,2,2,27,34,0 days 00:00:00.027381
WickyNilliams/headroom.js,1,v,9,1,5,8,17,0 days 00:00:00.024717
stylus/stylus,1,,53,34,11,115,168,0 days 00:00:00.361409
containrrr/watchtower,1,v,8,1,5,24,32,0 days 00:00:00.054123
jonas/tig,1,tig-,27,6,19,22,49,0 days 00:00:00.180743
dgraph-io/badger,1,v,14,6,7,20,34,0 days 00:00:00.118763
doctrine/inflector,2, v,6,1,4,10,16,0 days 00:00:00.035100
nats-io/nats-server,1,v,17,2,12,49,66,0 days 00:00:00.529590
mobile-shell/mosh,1,mosh-,4,2,1,10,14,0 days 00:00:00.069560
ent/ent,1,v,10,3,4,21,31,0 days 00:00:00.117951
containerd/containerd,2, v,9,1,7,76,85,0 days 00:00:01.167294
SpartnerNL/Laravel-Excel,2, v,11,3,6,143,154,0 days 00:00:00.132381
GoogleChrome/workbox,1,v,24,10,7,38,62,0 days 00:00:00.111275
Kotlin/kotlinx.coroutines,1,,24,11,6,38,62,0 days 00:00:00.206512
lokesh/color-thief,2, v,5,1,2,6,11,0 days 00:00:00.021856
javve/list.js,2, v,11,4,5,10,21,0 days 00:00:00.054819
wbkd/react-flow,2, v,56,52,2,118,174,0 days 00:00:00.222321
summernote/summernote,1,v,8,2,2,52,60,0 days 00:00:00.195530
browserslist/browserslist,1,,49,24,11,119,168,0 days 00:00:00.122952
fengyuanchen/cropperjs,1,v,14,6,4,40,54,0 days 00:00:00.051116
Rapptz/discord.py,1,v,24,15,6,41,65,0 days 00:00:00.289255
networkx/networkx,1,networkx-,37,7,25,10,47,0 days 00:00:00.544552
jxnblk/mdx-deck,1,v,21,16,2,91,112,0 days 00:00:00.256394
casesandberg/react-color,2, v,14,8,5,23,37,0 days 00:00:00.167031
apache/pulsar,1,v,14,1,10,37,51,0 days 00:00:00.853110
lingochamp/FileDownloader,1,v,11,4,4,56,67,0 days 00:00:00.058876
downshift-js/downshift,1,v,49,38,4,179,228,0 days 00:00:00.119397
App-vNext/Polly,2, v,7,3,2,4,11,0 days 00:00:00.055626
tymondesigns/jwt-auth,1,,6,3,2,29,35,0 days 00:00:00.098603
polybar/polybar,1,,20,12,7,84,104,0 days 00:00:00.137845
mholt/PapaParse,1,,19,5,7,55,74,0 days 00:00:00.045766
ionic-team/stencil,1,v,53,40,2,189,242,0 days 00:00:00.575247
go-playground/validator,1,v,94,69,10,59,153,0 days 00:00:00.113532
star7th/showdoc,2, v,18,6,6,124,142,0 days 00:00:00.253489
spatie/laravel-permission,1,,87,61,11,71,158,0 days 00:00:00.127780
abseil/abseil-cpp,1,,17,5,9,0,17,0 days 00:00:00.078421
swaywm/sway,1,,22,7,8,7,29,0 days 00:00:00.516208
PatrickJS/angular-starter,2, v,6,4,1,5,11,0 days 00:00:00.087445
rqlite/rqlite,1,v,56,37,8,39,95,0 days 00:00:00.209834
restify/node-restify,2, v,44,27,13,96,140,0 days 00:00:00.150727
beetbox/beets,1,v,6,1,4,30,36,0 days 00:00:01.704210
VSCodeVim/Vim,2, v,38,19,6,187,225,0 days 00:00:00.494627
akiran/react-slick,2, v,13,3,8,27,40,0 days 00:00:00.073976
GoogleContainerTools/kaniko,1,v,33,19,4,4,37,0 days 00:00:00.134752
aws/aws-cli,1,,46,24,17,1642,1688,0 days 00:00:04.391693
peers/peerjs,2, v,6,1,4,30,36,0 days 00:00:00.064094
dbcli/mycli,1,v,26,8,10,20,46,0 days 00:00:00.120317
luin/ioredis,2, v,54,33,11,132,186,0 days 00:00:00.127883
dangrossman/daterangepicker,2, v,5,1,3,58,63,0 days 00:00:00.060941
dbcli/pgcli,2, v,39,16,10,47,86,0 days 00:00:00.259223
dotnet/AspNetCore.Docs,1,,40,33,1,0,40,0 days 00:00:00.838397
thanos-io/thanos,1,v,26,7,2,17,43,0 days 00:00:00.317037
avwo/whistle,1,v,31,12,10,342,373,0 days 00:00:00.717310
tidwall/gjson,1,v,15,5,6,42,57,0 days 00:00:00.032176
imakewebthings/waypoints,2, v,6,1,4,17,23,0 days 00:00:00.023465
TypeStrong/ts-node,1,v,52,29,9,83,135,0 days 00:00:00.087695
golangci/golangci-lint,1,v,47,31,1,63,110,0 days 00:00:00.144947
jina-ai/clip-as-service,1,v,15,11,2,92,107,0 days 00:00:00.106083
redis/redis-py,2, v,15,2,9,49,64,0 days 00:00:00.138357
reactstrap/reactstrap,2, v,61,45,7,54,115,0 days 00:00:00.098545
okonet/lint-staged,2, v,44,23,7,145,189,0 days 00:00:00.150405
styleguidist/react-styleguidist,2, v,47,30,7,215,262,0 days 00:00:00.352095
PrismJS/prism,2, v,29,8,11,11,40,0 days 00:00:00.216992
snabbdom/snabbdom,1,v,14,3,6,33,47,0 days 00:00:00.064790
ansible/awx,1,,36,18,3,20,56,0 days 00:00:02.465958
shipshapecode/shepherd,1,v,46,28,9,73,119,0 days 00:00:00.190688
netbox-community/netbox,2, v,24,6,13,173,197,0 days 00:00:00.652047
lucidrains/vit-pytorch,1,,32,27,1,105,137,0 days 00:00:00.070633
pagekit/vue-resource,1,,12,5,4,41,53,0 days 00:00:00.037153
AppIntro/AppIntro,2, v,10,1,8,8,18,0 days 00:00:00.080140
jantimon/html-webpack-plugin,2, v,47,34,10,36,83,0 days 00:00:00.069893
mailhog/MailHog,2, v,10,7,2,16,26,0 days 00:00:00.026998
plouc/nivo,1,v,67,56,7,45,112,0 days 00:00:00.166518
debug-js/debug,1,,22,7,8,47,69,0 days 00:00:00.189146
cyclejs/cyclejs,1,v,32,27,1,50,82,0 days 00:00:00.073828
react-static/react-static,1,v,28,20,5,162,190,0 days 00:00:00.174928
vercel/micro,2, v,21,13,5,34,55,0 days 00:00:00.139127
SpacehuhnTech/esp8266_deauther,3, v v.,10,5,3,3,13,0 days 00:00:00.063514
ant-design/ant-design-mobile,2, v,28,19,4,107,135,0 days 00:00:00.517939
git-lfs/git-lfs,2, v,29,3,19,60,89,0 days 00:00:00.665987
clauderic/react-sortable-hoc,1,v,20,14,3,52,72,0 days 00:00:00.054894
serbanghita/Mobile-Detect,1,,6,2,3,64,70,0 days 00:00:00.062704
haltu/muuri,1,,9,1,5,14,23,0 days 00:00:00.037414
samuelcolvin/pydantic,2,v V,42,30,6,37,79,0 days 00:00:00.100198
spencermountain/compromise,2, v,70,45,12,148,218,0 days 00:00:00.444514
apple/darwin-xnu,1,xnu-,19,16,2,104,123,0 days 00:00:00.060363
milvus-io/milvus,1,v,9,3,3,15,24,0 days 00:00:01.171337
atomiks/tippyjs,2, v,27,20,5,65,92,0 days 00:00:00.092371
tinygo-org/tinygo,1,v,23,9,3,4,27,0 days 00:00:00.175860
qrohlf/trianglify,1,v,12,1,8,8,20,0 days 00:00:00.025524
nhn/tui.calendar,1,v,21,13,3,42,63,0 days 00:00:00.145733
h2o/h2o,1,v,12,3,2,32,44,0 days 00:00:00.259239
typesense/typesense,2, v,16,5,5,8,24,0 days 00:00:00.102310
spotify/annoy,3, v v.,9,1,4,15,24,0 days 00:00:00.055272
jacomyal/sigma.js,1,v,7,1,3,8,15,0 days 00:00:00.192723
zricethezav/gitleaks,1,v,60,47,5,62,122,0 days 00:00:00.087427
FredrikNoren/ungit,2, v,16,9,6,126,142,0 days 00:00:00.342802
Ciphey/Ciphey,2, v,18,15,1,8,26,0 days 00:00:00.157423
bitwarden/server,2, v,49,31,4,58,107,0 days 00:00:00.276559
aspnetboilerplate/aspnetboilerplate,3, v v.,91,57,7,125,216,0 days 00:00:01.180337
kubernetes-sigs/kind,2, v,14,2,6,10,24,0 days 00:00:00.329470
NaturalNode/natural,2, v,6,2,3,44,50,0 days 00:00:00.082189
HandBrake/HandBrake,1,,8,1,6,35,43,0 days 00:00:00.782287
coryhouse/react-slingshot,2, v,8,3,2,7,15,0 days 00:00:00.042756
visgl/deck.gl,2, v,32,8,11,250,282,0 days 00:00:00.421223
socketio/socket.io-client,1,,28,2,16,97,125,0 days 00:00:00.127381
squidfunk/mkdocs-material,1,,52,34,6,192,244,0 days 00:00:00.300557
w7corp/easywechat,1,,47,25,16,241,288,0 days 00:00:00.378561
immerjs/immer,2, v,35,23,5,94,129,0 days 00:00:00.111065
jesseduffield/lazydocker,1,v,18,11,5,27,45,0 days 00:00:00.052447
tj/commander.js,2, v,50,19,18,38,88,0 days 00:00:00.096606
doczjs/docz,1,v,19,13,5,66,85,0 days 00:00:00.118651
vega/vega,1,v,45,20,15,73,118,0 days 00:00:00.373932
dask/dask,1,,97,59,9,141,238,0 days 00:00:00.849956
frappe/erpnext,2, v,153,136,7,763,916,0 days 00:00:04.237596
dromara/hutool,1,,11,1,6,102,113,0 days 00:00:00.367147
labstack/echo,2, v,20,3,10,75,95,0 days 00:00:00.200456
alibaba/nacos,2, v,16,9,6,15,31,0 days 00:00:00.355703
halo-dev/halo,1,v,10,2,5,42,52,0 days 00:00:00.128005
vuejs/devtools,1,v,10,4,4,36,46,0 days 00:00:00.122651
pure-css/pure,1,v,9,1,7,14,23,0 days 00:00:00.051868
dmlc/xgboost,2, v,21,1,14,12,33,0 days 00:00:00.460369
react-native-elements/react-native-elements,2, v,30,18,5,52,82,0 days 00:00:00.174907
lovell/sharp,1,v,30,4,16,88,118,0 days 00:00:00.125589
frida/frida,1,,54,30,10,579,633,0 days 00:00:00.810791
reduxjs/react-redux,1,v,26,17,6,59,85,0 days 00:00:00.088323
files-community/Files,1,v,23,18,4,38,61,0 days 00:00:00.202860
t4t5/sweetalert,2, v,9,2,3,23,32,0 days 00:00:00.033605
redux-saga/redux-saga,2, v,18,9,5,40,58,0 days 00:00:00.146363
ovity/octotree,1,v,5,1,3,26,31,0 days 00:00:00.044963
dimsemenov/PhotoSwipe,1,v,5,1,2,43,48,0 days 00:00:00.040571
sampotts/plyr,1,v,16,6,7,195,211,0 days 00:00:00.199102
seata/seata,3, v V,15,6,3,18,33,0 days 00:00:00.287422
python-pillow/Pillow,1,,39,1,35,35,74,0 days 00:00:01.042353
ramda/ramda,2, v,28,13,9,26,54,0 days 00:00:00.195950
inconshreveable/ngrok,1,,20,18,1,1,21,0 days 00:00:00.027335
facebook/draft-js,2, v,11,7,3,16,27,0 days 00:00:00.076997
guzzle/guzzle,2, v,37,16,14,96,133,0 days 00:00:00.233711
github/hub,1,v,29,14,10,59,88,0 days 00:00:00.226104
angular/components,1,,31,13,7,128,159,0 days 00:00:00.853314
feathericons/feather,1,v,39,28,3,12,51,0 days 00:00:00.045674
ehang-io/nps,3,v V v.,19,14,1,44,63,0 days 00:00:00.052710
fabricjs/fabric.js,2, v,34,10,14,69,103,0 days 00:00:00.282244
httpie/httpie,1,,19,2,12,28,47,0 days 00:00:00.124561
openfaas/faas,2, v,18,9,7,110,128,0 days 00:00:00.140303
usablica/intro.js,2, v,29,5,13,12,41,0 days 00:00:00.088962
vercel/pkg,1,,15,7,5,42,57,0 days 00:00:00.066818
swagger-api/swagger-ui,3, v v/,69,51,10,189,258,0 days 00:00:00.567549
bilibili/flv.js,1,v,7,1,4,8,15,0 days 00:00:00.030278
conwnet/github1s,1,v,7,4,1,19,26,0 days 00:00:00.036646
appwrite/appwrite,1,,13,1,3,30,43,0 days 00:00:00.816612
bevacqua/dragula,2, v,18,14,1,49,67,0 days 00:00:00.174105
paularmstrong/normalizr,2, v,16,7,5,18,34,0 days 00:00:00.044320
qishibo/AnotherRedisDesktopManager,2, v,6,1,3,34,40,0 days 00:00:00.041945
chenglou/react-motion,1,v,5,1,2,19,24,0 days 00:00:00.055831
jlmakes/scrollreveal,1,v,10,3,5,36,46,0 days 00:00:00.065555
docsifyjs/docsify,1,v,44,35,6,147,191,0 days 00:00:00.155117
rook/rook,1,v,19,1,16,103,122,0 days 00:00:01.065506
mochajs/mocha,2, v,65,28,15,110,175,0 days 00:00:00.437213
sirupsen/logrus,2, v,20,6,8,35,55,0 days 00:00:00.100901
yeasy/docker_practice,1,v,13,1,9,0,13,0 days 00:00:00.078397
slidevjs/slidev,1,v,31,27,1,143,174,0 days 00:00:00.195408
michalsnik/aos,2, v,11,4,4,24,35,0 days 00:00:00.025153
localForage/localForage,1,,19,10,7,43,62,0 days 00:00:00.081817
react-bootstrap/react-bootstrap,2, v,44,24,10,108,152,0 days 00:00:00.310112
vuejs/vuepress,1,v,24,14,5,50,74,0 days 00:00:00.146929
helm/helm,2, v,32,8,12,68,100,0 days 00:00:00.904372
microsoft/cascadia-code,1,v,18,8,3,0,18,0 days 00:00:00.027018
StevenBlack/hosts,2, v,24,10,7,405,429,0 days 00:00:00.465765
postcss/autoprefixer,1,,53,27,14,133,186,0 days 00:00:00.193944
nicolargo/glances,1,v,22,2,15,70,92,0 days 00:00:00.302285
homebridge/homebridge,2, v,6,1,4,51,57,0 days 00:00:00.094654
uglide/RedisDesktopManager,1,,33,19,4,38,71,0 days 00:00:00.211560
DrKLO/Telegram,1,release-,47,40,1,37,84,0 days 00:00:00.052553
rollup/rollup,1,v,169,157,3,411,580,0 days 00:00:00.768781
petkaantonov/bluebird,1,v,24,11,7,115,139,0 days 00:00:00.182842
python-poetry/poetry,1,,14,10,3,63,77,0 days 00:00:00.141924
open-mmlab/mmdetection,1,v,29,26,1,6,35,0 days 00:00:00.133550
avajs/ava,1,v,54,37,4,23,77,0 days 00:00:00.151721
electron-react-boilerplate/electron-react-boilerplate,1,v,32,13,10,31,63,0 days 00:00:00.090412
validatorjs/validator.js,2, v,107,79,8,43,150,0 days 00:00:00.167339
Seldaek/monolog,1,,36,9,21,26,62,0 days 00:00:00.256710
necolas/react-native-web,1,,17,6,7,242,259,0 days 00:00:00.386773
schollz/croc,1,v,31,15,6,106,137,0 days 00:00:00.126850
js-cookie/js-cookie,1,v,10,1,7,13,23,0 days 00:00:00.063004
eslint/eslint,1,v,164,153,3,103,267,0 days 00:00:00.782191
spf13/viper,1,v,13,2,8,13,26,0 days 00:00:00.046004
zyedidia/micro,1,v,6,1,3,22,28,0 days 00:00:00.155461
mozilla/DeepSpeech,1,v,9,1,6,13,22,0 days 00:00:00.395548
signalapp/Signal-Android,3, v v.,180,163,8,860,1040,0 days 00:00:01.836000
ShareX/ShareX,1,v,50,24,11,22,72,0 days 00:00:00.480513
benweet/stackedit,1,v,23,17,4,104,127,0 days 00:00:00.145960
felixrieseberg/windows95,1,v,11,4,5,3,14,0 days 00:00:00.024087
parse-community/parse-server,1,,34,15,12,111,145,0 days 00:00:00.345877
alibaba/Sentinel,2, v,8,2,3,16,24,0 days 00:00:00.061002
apache/skywalking,1,v,20,4,6,11,31,0 days 00:00:00.404378
segmentio/nightmare,1,,21,9,4,67,88,0 days 00:00:00.076964
afollestad/material-dialogs,3, v v.,20,12,3,98,118,0 days 00:00:00.156949
codex-team/editor.js,2, v,11,3,5,16,27,0 days 00:00:00.060256
eligrey/FileSaver.js,2, v,3,1,1,12,15,0 days 00:00:00.025588
streamlit/streamlit,2, v,83,79,1,46,129,0 days 00:00:00.509243
youzan/vant,1,v,33,13,6,377,410,0 days 00:00:00.870590
locustio/locust,2, v,27,9,10,56,83,0 days 00:00:00.331343
TeamNewPipe/NewPipe,2, v,17,3,10,100,117,0 days 00:00:00.702139
marmelab/react-admin,1,v,46,32,4,168,214,0 days 00:00:01.080467
winstonjs/winston,2, v,24,6,13,62,86,0 days 00:00:00.100894
celery/celery,2, v,22,3,17,143,165,0 days 00:00:00.834692
osquery/osquery,2, v,39,13,12,80,119,0 days 00:00:00.365398
emberjs/ember.js,1,v,68,20,4,184,252,0 days 00:00:02.206075
vuejs/vue-router,1,v,19,9,5,59,78,0 days 00:00:00.131061
zhongyang219/TrafficMonitor,1,V,18,8,6,4,22,0 days 00:00:00.050088
taichi-dev/taichi,2, v,7,1,3,96,103,0 days 00:00:00.532986
reduxjs/reselect,1,v,11,6,4,14,25,0 days 00:00:00.052290
google/ExoPlayer,1,r,20,1,14,84,104,0 days 00:00:00.874786
chalk/chalk,1,v,16,3,8,16,32,0 days 00:00:00.040717
python-telegram-bot/python-telegram-bot,3, v V,49,27,8,39,88,0 days 00:00:00.148106
vadimdemedes/ink,1,v,16,6,6,23,39,0 days 00:00:00.044830
Popmotion/popmotion,2, v,21,14,5,131,152,0 days 00:00:00.277646
sideway/joi,2, v,92,63,11,135,227,0 days 00:00:00.229185
graphql/graphql-js,2, v,34,12,13,88,122,0 days 00:00:00.312668
solidjs/solid,1,v,27,16,2,137,164,0 days 00:00:00.128535
pbatard/rufus,1,v,42,11,15,28,70,0 days 00:00:00.126907
mingrammer/diagrams,1,v,20,14,3,16,36,0 days 00:00:00.038578
urfave/cli,1,v,33,20,8,34,67,0 days 00:00:00.166552
Baseflow/PhotoView,2, v,8,2,4,12,20,0 days 00:00:00.032537
recharts/recharts,1,v,26,13,6,93,119,0 days 00:00:00.140532
OpenZeppelin/openzeppelin-contracts,1,v,30,10,5,22,52,0 days 00:00:00.190036
wenyan-lang/wenyan,1,v,3,1,1,12,15,0 days 00:00:00.051089
websockets/ws,2, v,40,13,11,114,154,0 days 00:00:00.140830
PyTorchLightning/pytorch-lightning,1,,16,3,4,98,114,0 days 00:00:00.482544
jumpserver/jumpserver,2, v,31,24,5,103,134,0 days 00:00:00.584268
vnpy/vnpy,2, v,22,6,7,28,50,0 days 00:00:00.511179
iawia002/lux,2, v,15,7,5,59,74,0 days 00:00:00.162588
lensapp/lens,1,v,19,6,6,56,75,0 days 00:00:00.237368
eggjs/egg,1,,70,51,10,43,113,0 days 00:00:00.101960
go-kratos/kratos,1,v,11,2,7,21,32,0 days 00:00:00.095520
dapr/dapr,1,v,19,9,1,23,42,0 days 00:00:00.338841
valyala/fasthttp,1,v,43,27,4,3,46,0 days 00:00:00.096178
telegramdesktop/tdesktop,1,v,34,11,15,542,576,0 days 00:00:01.053785
svg/svgo,2, v,20,8,11,66,86,0 days 00:00:00.112253
philc/vimium,2, v,11,2,5,17,28,0 days 00:00:00.277300
quii/learn-go-with-tests,2, v,22,13,5,27,49,0 days 00:00:00.078216
magenta/magenta,2, v,7,1,3,42,49,0 days 00:00:00.078662
typicode/lowdb,1,v,21,8,9,36,57,0 days 00:00:00.042201
dgraph-io/dgraph,1,v,13,1,9,60,73,0 days 00:00:00.488434
appsmithorg/appsmith,3, v v.,13,7,3,129,142,0 days 00:00:00.730188
NickeManarin/ScreenToGif,1,,37,16,7,43,80,0 days 00:00:00.085900
flameshot-org/flameshot,1,v,11,3,6,30,41,0 days 00:00:00.111559
react-dnd/react-dnd,2, v,45,25,10,100,145,0 days 00:00:00.244394
SortableJS/Vue.Draggable,2,v v.,24,13,6,25,49,0 days 00:00:00.043786
Redocly/redoc,1,v,39,33,1,56,95,0 days 00:00:00.119195
facebook/flux,1,,4,1,2,9,13,0 days 00:00:00.037914
nosir/cleave.js,1,v,9,2,5,57,66,0 days 00:00:00.040745
aseprite/aseprite,2, v,9,1,7,84,93,0 days 00:00:00.522565
jsdom/jsdom,2, v,98,67,9,144,242,0 days 00:00:00.270007
TanStack/table,1,v,36,24,6,86,122,0 days 00:00:00.132406
pubkey/rxdb,1,,58,43,2,55,113,0 days 00:00:00.509741
jquense/yup,1,v,27,12,8,67,94,0 days 00:00:00.064780
pmndrs/zustand,1,v,13,4,6,56,69,0 days 00:00:00.054241
mysqljs/mysql,1,v,28,10,9,26,54,0 days 00:00:00.225789
alibaba/ice,3, v V,23,17,1,57,80,0 days 00:00:00.239818
Molunerfinn/PicGo,1,v,11,4,5,21,32,0 days 00:00:00.034312
mybatis/mybatis-3,1,mybatis-,5,1,3,32,37,0 days 00:00:00.303805
linlinjava/litemall,1,v,19,10,2,3,22,0 days 00:00:00.071322
ai/nanoid,1,,12,5,4,73,85,0 days 00:00:00.086703
facebookresearch/fairseq,1,v,8,1,4,6,14,0 days 00:00:00.108874
oldj/SwitchHosts,1,v,9,2,5,36,45,0 days 00:00:00.116662
wekan/wekan,2, v,610,607,2,27,637,0 days 00:00:01.170033
bazelbuild/bazel,1,,47,30,8,56,103,0 days 00:00:02.032735
cookiecutter/cookiecutter,1,,14,3,7,15,29,0 days 00:00:00.185123
nostra13/Android-Universal-Image-Loader,1,v,3,1,1,12,15,0 days 00:00:00.053754
arendst/Tasmota,1,v,35,14,7,58,93,0 days 00:00:01.210116
remix-run/remix,1,v,27,22,1,61,88,0 days 00:00:00.185278
facebook/fresco,1,v,35,14,13,12,47,0 days 00:00:00.185273
restic/restic,1,v,13,2,7,18,31,0 days 00:00:00.356769
badges/shields,1,,8,3,4,3,11,0 days 00:00:00.469667
defunkt/jquery-pjax,2, v,12,6,3,15,27,0 days 00:00:00.038362
freqtrade/freqtrade,1,,44,35,3,14,58,0 days 00:00:01.260980
gorilla/mux,1,v,8,1,5,6,14,0 days 00:00:00.026536
fingerprintjs/fingerprintjs,2, v,23,11,7,50,73,0 days 00:00:00.074486
less/less.js,1,v,26,8,13,42,68,0 days 00:00:00.291170
eclipse-theia/theia,2, v,43,36,2,33,76,0 days 00:00:00.556459
jhipster/generator-jhipster,1,v,110,89,5,114,224,0 days 00:00:03.023917
brettwooldridge/HikariCP,1,HikariCP-,17,2,10,82,99,0 days 00:00:00.255091
handlebars-lang/handlebars.js,2, v,14,5,6,56,70,0 days 00:00:00.128638
monicahq/monica,1,v,47,32,4,39,86,0 days 00:00:00.251191
zloirock/core-js,2, v,41,26,7,156,197,0 days 00:00:00.300758
dropzone/dropzone,1,v,32,15,12,83,115,0 days 00:00:00.087089
testing-library/react-testing-library,1,v,57,43,2,110,167,0 days 00:00:00.084030
responsively-org/responsively-app,1,v,18,14,3,10,28,0 days 00:00:00.090462
twitter/typeahead.js,1,v,4,1,2,11,15,0 days 00:00:00.037849
GoogleChromeLabs/squoosh,1,v,10,4,5,17,27,0 days 00:00:00.069079
jamiebuilds/react-loadable,1,v,13,8,3,16,29,0 days 00:00:00.022305
grafana/k6,1,v,36,12,6,36,72,0 days 00:00:00.312425
Tencent/tinker,1,v,7,3,2,46,53,0 days 00:00:00.054681
derailed/k9s,2, v,25,17,2,155,180,0 days 00:00:00.248196
nfl/react-helmet,1,,15,5,4,18,33,0 days 00:00:00.031086
joewalnes/websocketd,1,v,11,3,2,15,26,0 days 00:00:00.026633
plotly/dash,1,v,42,29,3,33,75,0 days 00:00:00.458992
handsontable/handsontable,2, v,62,27,14,117,179,0 days 00:00:00.479724
aFarkas/lazysizes,1,,21,10,7,45,66,0 days 00:00:00.079002
framework7io/framework7,1,v,43,19,11,172,215,0 days 00:00:00.667828
hubotio/hubot,1,v,26,7,12,68,94,0 days 00:00:00.140367
gchq/CyberChef,1,v,119,106,4,273,392,0 days 00:00:00.492137
matryer/xbar,2, v,9,5,2,5,14,0 days 00:00:00.055177
ionic-team/ionicons,2, v,21,9,10,51,72,0 days 00:00:00.052719
sanic-org/sanic,2, v,21,2,13,49,70,0 days 00:00:00.334087
nondanee/UnblockNeteaseMusic,1,v,23,17,1,34,57,0 days 00:00:00.036739
mpv-player/mpv,1,v,34,10,8,46,80,0 days 00:00:03.220209
zadam/trilium,2, v,14,11,1,134,148,0 days 00:00:00.398590
visionmedia/superagent,2, v,50,23,13,84,134,0 days 00:00:00.148640
trojan-gfw/trojan,1,v,24,15,4,19,43,0 days 00:00:00.038300
grafana/loki,1,v,17,4,4,8,25,0 days 00:00:00.233049
nginx/nginx,1,release-,32,10,20,516,548,0 days 00:00:00.819653
notepad-plus-plus/notepad-plus-plus,2, v,42,8,11,159,201,0 days 00:00:00.335467
uber-go/zap,1,v,22,11,8,6,28,0 days 00:00:00.046027
EastWorld/wechat-app-mall,2, v,14,6,4,8,22,0 days 00:00:00.038413
filebrowser/filebrowser,1,v,34,23,6,62,96,0 days 00:00:00.152610
youzan/vant-weapp,1,v,16,7,4,91,107,0 days 00:00:00.178387
jaegertracing/jaeger,1,v,40,24,3,13,53,0 days 00:00:00.120854
react-grid-layout/react-grid-layout,2, v,22,9,8,86,108,0 days 00:00:00.075952
v2fly/v2ray-core,1,v,185,168,4,217,402,0 days 00:00:00.713110
wagerfield/parallax,1,v,6,2,2,5,11,0 days 00:00:00.020197
knex/knex,2, v,25,2,17,146,171,0 days 00:00:00.312884
bokeh/bokeh,1,,23,1,14,50,73,0 days 00:00:01.248164
oblador/react-native-vector-icons,1,v,37,14,10,42,79,0 days 00:00:00.066867
briannesbitt/Carbon,1,,99,80,7,79,178,0 days 00:00:00.352020
buger/goreplay,2, v,18,5,10,23,41,0 days 00:00:00.084110
simdjson/simdjson,1,v,12,1,5,26,38,0 days 00:00:00.157542
semantic-release/semantic-release,2, v,62,48,9,206,268,0 days 00:00:00.171659
nikic/PHP-Parser,1,v,24,7,12,41,65,0 days 00:00:00.094882
ustbhuangyi/better-scroll,3, v v.,17,6,4,41,58,0 days 00:00:00.215957
spotify/luigi,2, v,13,4,7,46,59,0 days 00:00:00.342599
motdotla/dotenv,1,v,33,17,11,26,59,0 days 00:00:00.056226
outline/outline,2, v,64,54,1,39,103,0 days 00:00:00.259291
JedWatson/classnames,1,v,4,1,2,16,20,0 days 00:00:00.030959
jhao104/proxy_pool,1,,10,1,6,2,12,0 days 00:00:00.042713
BabylonJS/Babylon.js,2, v,36,16,14,36,72,0 days 00:00:02.888141
wulkano/Kap,1,v,13,2,5,14,27,0 days 00:00:00.065954
radareorg/radare2,2, release-,42,22,6,43,85,0 days 00:00:01.710695
jasmine/jasmine,1,v,28,5,17,29,57,0 days 00:00:00.175790
auth0/node-jsonwebtoken,1,v,29,13,9,42,71,0 days 00:00:00.054723
KaTeX/KaTeX,1,v,15,3,10,41,56,0 days 00:00:00.139912
tailwindlabs/heroicons,1,v,4,1,2,15,19,0 days 00:00:00.018365
huiyadanli/RevokeMsgPatcher,1,,15,6,3,0,15,0 days 00:00:00.021777
infernojs/inferno,2, v,38,29,6,160,198,0 days 00:00:00.377550
janl/mustache.js,2, v,20,6,12,23,43,0 days 00:00:00.333237
cool-RR/PySnooper,1,,7,1,5,10,17,0 days 00:00:00.027988
airbnb/visx,1,v,29,25,1,200,229,0 days 00:00:00.277473
teambit/bit,1,v,18,7,5,121,139,0 days 00:00:00.342160
facebook/yoga,2, v,19,6,8,23,42,0 days 00:00:00.248791
lottie-react-native/lottie-react-native,1,v,16,2,9,37,53,0 days 00:00:00.053569
designmodo/Flat-UI,1,,5,1,3,5,10,0 days 00:00:00.020498
DapperLib/Dapper,1,,31,22,6,13,44,0 days 00:00:00.104356
bower/bower,2, v,18,8,4,83,101,0 days 00:00:00.257874
airbnb/react-sketchapp,2, v,20,11,5,27,47,0 days 00:00:00.074175
2dust/v2rayNG,1,,8,1,5,111,119,0 days 00:00:00.051878
catchorg/Catch2,3,v V v.,24,7,7,62,86,0 days 00:00:00.368632
qbittorrent/qBittorrent,1,release-,24,5,16,145,169,0 days 00:00:01.210951
pouchdb/pouchdb,2, v,24,7,8,47,71,0 days 00:00:00.267110
LMAX-Exchange/disruptor,1,,9,1,4,22,31,0 days 00:00:00.061501
matomo-org/matomo,1,,64,20,21,130,194,0 days 00:00:02.181606
flatpickr/flatpickr,2, v,23,10,4,121,144,0 days 00:00:00.186700
fullcalendar/fullcalendar,1,v,44,16,18,72,116,0 days 00:00:00.350051
cloudreve/Cloudreve,1,,7,1,5,14,21,0 days 00:00:00.056954
nodemailer/nodemailer,1,v,47,20,15,170,217,0 days 00:00:00.128409
ChainSafe/web3.js,2, v,25,16,7,54,79,0 days 00:00:00.428085
icsharpcode/ILSpy,2, v,16,2,11,9,25,0 days 00:00:00.668462
Tencent/ncnn,1,,32,9,3,0,32,0 days 00:00:00.139617
pyg-team/pytorch_geometric,1,,9,1,5,22,31,0 days 00:00:00.437101
riot/riot,1,v,44,16,10,155,199,0 days 00:00:00.314967
you-dont-need/You-Dont-Need-Lodash-Underscore,1,v,14,5,6,6,20,0 days 00:00:00.041787
Tencent/vConsole,2, v,24,13,7,34,58,0 days 00:00:00.063374
gabime/spdlog,1,v,19,4,10,15,34,0 days 00:00:00.273589
magic-wormhole/magic-wormhole,1,,12,2,6,22,34,0 days 00:00:00.087439
kovidgoyal/kitty,1,v,25,8,9,58,83,0 days 00:00:00.739719
pqrs-org/Karabiner-Elements,1,v,28,11,5,0,28,0 days 00:00:00.272266
browsh-org/browsh,1,v,5,2,2,45,50,0 days 00:00:00.034155
antonmedv/fx,1,,27,18,4,34,61,0 days 00:00:00.039187
frappe/charts,2, v,5,1,3,13,18,0 days 00:00:00.035681
mkdocs/mkdocs,1,,20,9,9,27,47,0 days 00:00:00.118760
framer/motion,1,v,60,51,3,243,303,0 days 00:00:00.447265
Anuken/Mindustry,1,v,136,129,4,0,136,0 days 00:00:01.006135
iovisor/bcc,1,v,24,1,6,9,33,0 days 00:00:00.389914
hdodenhof/CircleImageView,1,v,9,1,7,6,15,0 days 00:00:00.022102
cocos2d/cocos2d-x,1,cocos2d-x-,20,2,8,17,37,0 days 00:00:02.749556
jellyfin/jellyfin,1,v,8,2,4,30,38,0 days 00:00:01.256267
node-red/node-red,2, v,26,3,18,99,125,0 days 00:00:00.609714
checkly/headless-recorder,1,v,8,4,3,10,18,0 days 00:00:00.141200
localtunnel/localtunnel,1,v,13,3,6,20,33,0 days 00:00:00.021856
erusev/parsedown,2, v,17,10,5,51,68,0 days 00:00:00.054534
fmtlib/fmt,2, v,23,2,14,16,39,0 days 00:00:00.347846
krisk/Fuse,2, v,25,12,10,50,75,0 days 00:00:00.061586
InstaPy/InstaPy,2, v,6,2,1,37,43,0 days 00:00:00.350686
greensock/GSAP,1,,26,5,17,72,98,0 days 00:00:00.051981
hashcat/hashcat,1,v,17,4,9,8,25,0 days 00:00:00.578237
chrislusf/seaweedfs,2, v,218,211,2,0,218,0 days 00:00:00.588530
barryvdh/laravel-debugbar,2,v V,24,11,10,99,123,0 days 00:00:00.079943
iBotPeaches/Apktool,1,v,12,3,8,23,35,0 days 00:00:00.119166
joke2k/faker,1,v,95,84,9,138,233,0 days 00:00:00.252283
jarun/nnn,1,v,34,11,4,2,36,0 days 00:00:00.291101
Kr328/ClashForAndroid,2, v,18,10,1,94,112,0 days 00:00:00.165266
FormidableLabs/webpack-dashboard,2, v,12,3,8,31,43,0 days 00:00:00.030848
sweetalert2/sweetalert2,1,v,129,115,3,544,673,0 days 00:00:00.851376
google/filament,1,v,23,13,5,70,93,0 days 00:00:00.322581
browserify/browserify,2, v,149,129,7,264,413,0 days 00:00:00.416242
infinitered/ignite,2, v,52,42,6,94,146,0 days 00:00:00.162328
alibaba/ARouter,1,,4,1,2,16,20,0 days 00:00:00.027411
desktop/desktop,1,release-,22,6,8,136,158,0 days 00:00:01.982734
microsoft/LightGBM,1,v,9,1,6,19,28,0 days 00:00:00.158463
medcl/elasticsearch-analysis-ik,1,v,42,5,11,130,172,0 days 00:00:00.069357
janpaepke/ScrollMagic,1,v,5,2,2,21,26,0 days 00:00:00.046694
marcuswestin/store.js,1,v,4,1,2,31,35,0 days 00:00:00.029959
uNetworking/uWebSockets,1,v,66,52,5,26,92,0 days 00:00:00.116609
CopyTranslator/CopyTranslator,2, v,6,1,3,14,20,0 days 00:00:00.078577
be5invis/Iosevka,1,v,59,45,8,163,222,0 days 00:00:00.410919
gpujs/gpu.js,1,,21,15,3,55,76,0 days 00:00:00.090404
bootstrap-vue/bootstrap-vue,2, v,47,38,2,66,113,0 days 00:00:00.367566
koel/koel,1,v,18,6,6,38,56,0 days 00:00:00.135976
docker-slim/docker-slim,1,,38,21,10,17,55,0 days 00:00:00.071660
wting/autojump,1,release-v,31,14,8,22,53,0 days 00:00:00.061326
Qv2ray/Qv2ray,1,v,15,11,2,32,47,0 days 00:00:00.181718
commitizen/cz-cli,2, v,16,6,7,58,74,0 days 00:00:00.044584
plotly/plotly.js,1,v,72,54,3,133,205,0 days 00:00:01.805077
foreversd/forever,2, v,17,2,10,51,68,0 days 00:00:00.054312
infinitered/reactotron,1,v,46,36,3,40,86,0 days 00:00:00.105041
micropython/micropython,1,v,19,4,10,31,50,0 days 00:00:00.966495
kamranahmedse/driver.js,2, v,8,3,1,27,35,0 days 00:00:00.141589
markdown-it/markdown-it,1,,29,13,10,47,76,0 days 00:00:00.072569
thomaspark/bootswatch,1,v,15,1,11,34,49,0 days 00:00:00.228593
hapijs/hapi,2, v,129,106,11,194,323,0 days 00:00:00.535489
dogecoin/dogecoin,2, v,17,3,10,64,81,0 days 00:00:01.239406
vuejs/vue,2, v,15,4,7,145,160,0 days 00:00:00.425743
d3/d3,1,v,91,58,12,197,288,0 days 00:00:00.360596
axios/axios,2, v,27,10,10,30,57,0 days 00:00:00.086526
containers/podman,1,v,21,5,4,95,116,0 days 00:00:01.415103
vercel/next.js,2, v,33,11,8,122,155,0 days 00:00:00.859466
facebook/react,2, v,36,8,14,58,94,0 days 00:00:01.453943
puppeteer/puppeteer,1,v,61,49,1,33,94,0 days 00:00:00.266781
hashicorp/packer,2, v,21,5,15,82,103,0 days 00:00:01.626092
twbs/bootstrap,1,v,23,3,15,36,59,0 days 00:00:01.650972
iluwatar/java-design-patterns,1,,19,3,13,0,19,0 days 00:00:00.222479
nvbn/thefuck,1,,79,64,8,4,83,0 days 00:00:00.122431
FortAwesome/Font-Awesome,2, v,30,6,15,40,70,0 days 00:00:00.090718
Genymobile/scrcpy,1,v,25,9,5,2,27,0 days 00:00:00.235690
facebook/react-native,2, v,67,52,8,144,211,0 days 00:00:02.034087
RasaHQ/rasa,1,,33,15,7,233,266,0 days 00:00:02.562121
microsoft/PowerToys,2, v,28,19,3,31,59,0 days 00:00:00.509765
laravel/laravel,1,v,40,19,17,134,174,0 days 00:00:00.431303
tensorflow/models,2,v v.,19,3,9,6,25,0 days 00:00:00.902192
elastic/kibana,1,v,55,17,12,190,245,0 days 00:00:07.924225
typicode/json-server,2, v,17,4,10,106,123,0 days 00:00:00.098373
hakimel/reveal.js,1,,27,3,18,11,38,0 days 00:00:00.247389
huggingface/transformers,2, v,46,41,1,49,95,0 days 00:00:00.733527
gin-gonic/gin,1,v,13,3,8,13,26,0 days 00:00:00.124778
electron/electron,1,v,113,74,19,595,708,0 days 00:00:02.839773
ant-design/ant-design,1,,79,66,4,329,408,0 days 00:00:01.665434
microsoft/TypeScript,1,v,12,2,2,120,132,0 days 00:00:02.242420
reduxjs/redux,1,v,26,16,6,42,68,0 days 00:00:00.198357
mrdoob/three.js,1,r,132,107,6,0,132,0 days 00:00:03.015184
pallets/flask,1,,16,5,10,25,41,0 days 00:00:00.327777
fatedier/frp,1,v,42,23,11,30,72,0 days 00:00:00.080973
gohugoio/hugo,1,v,93,72,10,101,194,0 days 00:00:00.688275
tailwindlabs/tailwindcss,1,v,21,9,8,127,148,0 days 00:00:00.466185
socketio/socket.io,1,,30,5,15,118,148,0 days 00:00:00.162642
521xueweihan/HelloGitHub,1,vol.,19,16,1,0,19,0 days 00:00:00.018039
chartjs/Chart.js,2, v,21,7,10,31,52,0 days 00:00:00.471787
adam-p/markdown-here,1,v,15,8,6,34,49,0 days 00:00:00.056658
shadowsocks/shadowsocks-windows,1,,13,4,7,49,62,0 days 00:00:00.098383
jquery/jquery,1,,23,1,21,63,86,0 days 00:00:00.426063
expressjs/express,1,,61,40,12,185,246,0 days 00:00:00.599175
sveltejs/svelte,1,v,134,119,2,244,378,0 days 00:00:00.754132
webpack/webpack,1,v,152,134,8,224,376,0 days 00:00:01.422499
h5bp/html5-boilerplate,2, v,19,2,13,10,29,0 days 00:00:00.129051
coder/code-server,2, v,20,9,4,22,42,0 days 00:00:00.422199
lodash/lodash,1,,48,39,4,59,107,0 days 00:00:00.584643
azl397985856/leetcode,2, v,35,25,3,5,40,0 days 00:00:00.095521
protocolbuffers/protobuf,1,v,29,6,14,46,75,0 days 00:00:00.807303
apache/echarts,1,,29,5,14,64,93,0 days 00:00:00.589472
psf/requests,2, v,43,11,22,101,144,0 days 00:00:00.363348
remix-run/react-router,1,v,39,22,11,76,115,0 days 00:00:00.436685
django/django,1,,19,1,14,248,267,0 days 00:00:03.257459
storybookjs/storybook,1,v,107,90,13,323,430,0 days 00:00:03.879970
ionic-team/ionic-framework,2, v,43,27,10,140,183,0 days 00:00:01.108258
moment/moment,1,,40,15,12,46,86,0 days 00:00:00.334114
tiangolo/fastapi,2, v,77,68,3,52,129,0 days 00:00:00.154627
nestjs/nest,2, v,33,18,5,167,200,0 days 00:00:00.989314
junegunn/fzf,1,,27,8,13,76,103,0 days 00:00:00.279464
bitcoin/bitcoin,1,v,25,3,20,82,107,0 days 00:00:03.871100
3b1b/manim,2, v,8,1,1,10,18,0 days 00:00:00.462259
tesseract-ocr/tesseract,1,,15,1,10,8,23,0 days 00:00:00.669943
soimort/you-get,1,v,3,1,1,143,146,0 days 00:00:00.216972
juliangarnier/anime,2, v,8,2,5,6,14,0 days 00:00:00.058356
atom/atom,2, v,271,256,2,104,375,0 days 00:00:02.862644
ColorlibHQ/AdminLTE,2, v,13,4,6,47,60,0 days 00:00:00.238544
prettier/prettier,2, v,39,20,8,71,110,0 days 00:00:00.432592
caddyserver/caddy,1,v,14,2,10,49,63,0 days 00:00:00.239316
yarnpkg/yarn,2, v,50,38,1,114,164,0 days 00:00:00.252452
scrapy/scrapy,1,,32,7,17,58,90,0 days 00:00:00.817220
prometheus/prometheus,2, v,67,35,6,79,146,0 days 00:00:00.875264
nuxt/nuxt.js,1,v,30,17,7,112,142,0 days 00:00:00.454299
gogs/gogs,1,v,11,4,6,51,62,0 days 00:00:00.519379
iamkun/dayjs,1,v,11,5,4,99,110,0 days 00:00:00.109994
v2ray/v2ray-core,1,v,168,154,3,182,350,0 days 00:00:00.469105
strapi/strapi,1,v,16,7,3,79,95,0 days 00:00:01.741235
Dogfalo/materialize,2, v,17,10,4,20,37,0 days 00:00:00.221553
vercel/hyper,2, v,18,9,6,43,61,0 days 00:00:00.318570
impress/impress.js,1,,8,4,3,4,12,0 days 00:00:00.031067
FiloSottile/mkcert,1,v,6,3,2,8,14,0 days 00:00:00.020018
grafana/grafana,2, v,46,7,9,181,227,0 days 00:00:02.889635
PhilJay/MPAndroidChart,1,v,8,2,4,33,41,0 days 00:00:00.109586
ocornut/imgui,1,v,72,44,5,2,74,0 days 00:00:00.539478
commaai/openpilot,1,v,8,1,6,62,70,0 days 00:00:00.073873
facebook/jest,2, v,68,45,10,143,211,0 days 00:00:00.609095
hexojs/hexo,1,,38,15,12,101,139,0 days 00:00:00.236124
babel/babel,1,v,90,67,9,606,696,0 days 00:00:01.766253
facebook/docusaurus,1,v,14,8,1,37,51,0 days 00:00:00.228503
obsproject/obs-studio,1,,30,1,13,89,119,0 days 00:00:00.819618
Leaflet/Leaflet,1,v,16,1,13,27,43,0 days 00:00:00.538353
shadowsocks/shadowsocks,1,,4,1,2,14,18,0 days 00:00:00.043869
dcloudio/uni-app,2, v,8,2,1,8,16,0 days 00:00:00.725048
airbnb/lottie-android,2,v v.,21,8,9,42,63,0 days 00:00:00.096260
sahat/hackathon-starter,1,,8,2,4,6,14,0 days 00:00:00.205851
TryGhost/Ghost,2, v,170,154,8,318,488,0 days 00:00:01.529919
videojs/video.js,2, v,70,38,15,220,290,0 days 00:00:00.362668
lerna/lerna,1,v,39,26,6,70,109,0 days 00:00:00.174679
vuetifyjs/vuetify,1,v,23,7,8,284,307,0 days 00:00:00.857255
quilljs/quill,1,v,23,12,5,99,122,0 days 00:00:00.263280
rclone/rclone,1,v,69,36,11,21,90,0 days 00:00:00.401374
gulpjs/gulp,2, v,6,2,3,13,19,0 days 00:00:00.073138
ansible/ansible,2, v,26,4,13,174,200,0 days 00:00:04.812668
bumptech/glide,1,v,21,6,11,15,36,0 days 00:00:00.173374
zenorocha/clipboard.js,1,v,9,5,3,33,42,0 days 00:00:00.033650
wg/wrk,1,,10,1,6,11,21,0 days 00:00:00.014159
d2l-ai/d2l-zh,1,v,9,5,3,0,9,0 days 00:00:00.286741
koajs/koa,1,,43,23,13,44,87,0 days 00:00:00.236157
wagoodman/dive,1,v,10,5,2,15,25,0 days 00:00:00.034924
marktext/marktext,1,v,7,2,4,20,27,0 days 00:00:00.100576
shadowsocks/shadowsocks-android,1,v,24,8,11,156,180,0 days 00:00:00.273224
immutable-js/immutable-js,2, v,16,11,3,39,55,0 days 00:00:00.113294
ant-design/ant-design-pro,2, v,18,6,6,12,30,0 days 00:00:00.144394
google/zx,1,,23,21,1,19,42,0 days 00:00:00.034558
evanw/esbuild,1,v,12,5,2,284,296,0 days 00:00:00.268252
Blankj/AndroidUtilCode,1,,27,12,7,89,116,0 days 00:00:00.092119
XX-net/XX-Net,1,,51,36,5,285,336,0 days 00:00:00.269448
nolimits4web/swiper,1,v,49,14,12,139,188,0 days 00:00:00.326114
nativefier/nativefier,2, v,56,42,9,90,146,0 days 00:00:00.110199
carbon-app/carbon,1,,24,14,4,194,218,0 days 00:00:00.180339
nlohmann/json,2, v,15,2,8,36,51,0 days 00:00:00.381187
NervJS/taro,1,v,12,2,5,272,284,0 days 00:00:00.884174
microsoft/monaco-editor,2, v,28,11,10,36,64,0 days 00:00:00.172717
google/leveldb,2, v,21,7,7,0,21,0 days 00:00:00.033585
streamich/react-use,1,v,134,130,3,117,251,0 days 00:00:00.246685
pandas-dev/pandas,2, v,28,1,22,56,84,0 days 00:00:02.133364
2dust/v2rayN,1,,117,111,1,2,119,0 days 00:00:00.069527
date-fns/date-fns,2,v v.,77,62,7,42,119,0 days 00:00:00.158832
fxsjy/jieba,1,v,23,17,5,5,28,0 days 00:00:00.149514
photonstorm/phaser,2, v,39,20,11,59,98,0 days 00:00:01.432175
react-boilerplate/react-boilerplate,1,v,17,6,6,13,30,0 days 00:00:00.107692
jashkenas/backbone,2, v,10,2,7,22,32,0 days 00:00:00.205683
tastejs/todomvc,2, v,7,1,3,6,13,0 days 00:00:00.164980
beego/beego,1,v,16,3,10,24,40,0 days 00:00:00.269371
openai/gym,2, v,15,7,6,34,49,0 days 00:00:00.100064
certbot/certbot,1,v,68,54,2,31,99,0 days 00:00:00.825381
nocodb/nocodb,2, v,9,5,2,86,95,0 days 00:00:00.183123
RocketChat/Rocket.Chat,1,,103,94,1,245,348,0 days 00:00:01.866367
vuejs/vuex,1,v,21,7,7,24,45,0 days 00:00:00.079122
Dreamacro/clash,1,v,28,10,3,14,42,0 days 00:00:00.048815
istio/istio,1,,22,3,12,143,165,0 days 00:00:01.523882
caolan/async,2, v,25,13,10,52,77,0 days 00:00:00.122865
markedjs/marked,2, v,16,2,11,94,110,0 days 00:00:00.171758
square/leakcanary,1,v,14,4,9,10,24,0 days 00:00:00.130108
atlassian/react-beautiful-dnd,2, v,24,15,4,46,70,0 days 00:00:00.062869
kenwheeler/slick,2, v,8,3,3,43,51,0 days 00:00:00.186616
naptha/tesseract.js,2, v,4,1,2,28,32,0 days 00:00:00.045964
hashicorp/terraform,2, v,18,2,12,158,176,0 days 00:00:02.347019
jesseduffield/lazygit,2, v,33,21,5,151,184,0 days 00:00:00.359175
standard/standard,1,v,66,55,8,87,153,0 days 00:00:00.235758
apolloconfig/apollo,2, v,19,2,9,16,35,0 days 00:00:00.173709
tannerlinsley/react-query,1,v,77,73,2,294,371,0 days 00:00:00.392123
typicode/husky,1,v,34,16,11,88,122,0 days 00:00:00.085533
airbnb/lottie-web,2,v v.,24,9,9,144,168,0 days 00:00:00.169809
ReactiveX/rxjs,1,,19,7,6,45,64,0 days 00:00:00.434812
denysdovhan/wtfjs,1,v,23,13,6,16,39,0 days 00:00:00.042473
jashkenas/underscore,1,,20,5,13,54,74,0 days 00:00:00.175276
mitmproxy/mitmproxy,2, v,30,4,17,35,65,0 days 00:00:00.881591
layui/layui,2, v,7,1,4,41,48,0 days 00:00:00.031153
aria2/aria2,1,release-,53,22,18,87,140,0 days 00:00:00.307804
niklasvh/html2canvas,2, v,7,3,3,17,24,0 days 00:00:00.062228
hankcs/HanLP,1,v,9,2,5,44,53,0 days 00:00:00.072976
postcss/postcss,1,,20,4,10,207,227,0 days 00:00:00.271438
github/fetch,1,v,21,10,9,19,40,0 days 00:00:00.051046
webtorrent/webtorrent,1,v,125,112,9,284,409,0 days 00:00:00.523766
select2/select2,1,,9,2,5,27,36,0 days 00:00:00.150873
request/request,1,v,73,55,6,71,144,0 days 00:00:00.295419
cheeriojs/cheerio,2, v,22,7,7,30,52,0 days 00:00:00.076076
Modernizr/Modernizr,1,v,20,4,12,23,43,0 days 00:00:00.174623
SortableJS/Sortable,1,,17,3,10,18,35,0 days 00:00:00.170215
harness/drone,1,v,31,17,9,44,75,0 days 00:00:00.250292
composer/composer,1,,15,1,11,110,125,0 days 00:00:00.908573
GitbookIO/gitbook,1,,22,17,2,68,90,0 days 00:00:00.145453
docker/compose,2, v,41,12,15,67,108,0 days 00:00:00.886277
parallax/jsPDF,3, v v.,9,1,7,26,35,0 days 00:00:00.135096
remy/nodemon,1,v,20,7,9,101,121,0 days 00:00:00.098876
Binaryify/NeteaseCloudMusicApi,2, v,52,36,7,102,154,0 days 00:00:00.126116
lenve/vhr,1,v,12,9,1,0,12,0 days 00:00:00.014882
sequelize/sequelize,2, v,137,107,19,334,471,0 days 00:00:00.923794
GoogleChrome/lighthouse,2, v,56,40,4,42,98,0 days 00:00:00.395620
tmux/tmux,1,,25,1,19,0,25,0 days 00:00:00.571440
YMFE/yapi,2, v,9,2,3,68,77,0 days 00:00:00.351021
bvaughn/react-virtualized,2, v,71,65,3,129,200,0 days 00:00:00.171116
getsentry/sentry,2, v,102,90,9,294,396,0 days 00:00:03.252400
akveo/ngx-admin,1,v,19,2,9,8,27,0 days 00:00:00.090909
ggreer/the_silver_searcher,1,,37,17,8,12,49,0 days 00:00:00.125492
CodeHubApp/CodeHub,1,,15,10,3,13,28,0 days 00:00:00.040210
pmndrs/react-spring,1,v,22,15,3,150,172,0 days 00:00:00.243217
fastify/fastify,1,v,104,96,1,90,194,0 days 00:00:00.305001
elastic/elasticsearch,1,v,67,22,16,231,298,0 days 00:00:09.241341
encode/django-rest-framework,1,,22,1,17,106,128,0 days 00:00:00.635364
explosion/spaCy,2, v,28,14,11,72,100,0 days 00:00:01.199634
Automattic/mongoose,2, v,58,15,20,646,704,0 days 00:00:01.405175
kubernetes/kubernetes,1,v,45,20,19,329,374,0 days 00:00:12.600870
kubernetes/minikube,1,v,61,43,1,45,106,0 days 00:00:01.637791
laravel/framework,2, v,163,148,13,630,793,0 days 00:00:03.317834
influxdata/influxdb,2, v,26,6,14,133,159,0 days 00:00:03.377428
